AACCGAAA	CAACCGAA
AACCGAAC	CAACCGAA
AACCGAAG	CAACCGAA
AACCGAAT	CAACCGAA
AACCGAAN	CAACCGAA
AAATCACC	AATCACCC
AAAAAAGC	GAAAAAGC
AAATCACT	AAATCGCT
AAATCAGC	AAATCGCT
AAATCCCT	AAATCGCT
AAATCCGC	AAATCGCT
AAAAAGCA	GAAAAAGC
AAAAAGCC	GAAAAAGC
AAAAAGCG	GAAAAAGC
AAAAAGCT	GAAAAAGC
AAATCCTA	AAATCGCT
AAAAAGCN	GAAAAAGC
AAATCCTC	AAATCGCT
AAATCCTG	AAATCGCT
AAATCCTN	AAATCGCT
AAAAAGTC	ATAAAGTC
AACTAATT	ACTAATTT
AAATCGAC	AAATCGCT
AAACTCAG	TAACTCAG
AAATCGCA	AAATCGCT
AAATCGCC	AAATCGCT
AAATCGCG	AAATCGCT
AAATCGCT	AAATCGCT
AAATCGCN	AAATCGCT
AAGCCCTA	ACGCCCTA
AACCGCAT	AACGCATG
AAATCGGC	AAATCGCT
AAATCGGT	AAATCGCT
AAATCGTA	AAATCGCT
AAACTCGC	AAATCGCT
AAATCGTC	AAATCGCT
AAATCGTG	AAATCGCT
AAATCGTT	AAATCGCT
AAATCGTN	AAATCGCT
AAATCGNC	AAATCGCT
AAATCGNT	AAATCGCT
AAGCCGCC	AGGCCGCC
AAATCTGC	AAATCGCT
AAACTGGG	AACTGGGA
AACNTGGG	AACTGGGA
AAAACGCT	AAATCGCT
AAATCNCT	AAATCGCT
AAATCNGC	AAATCGCT
AACCGGGA	AACTGGGA
AACCGGTT	ACCGGTTG
AACTAGGA	AACTGGGA
AACTAGGG	AACTGGGA
AAATGCGC	AAATCGCT
AAATGCTA	AAATCGCT
AAATGCTC	AAATCGCT
AAGCGAGT	AAGGAGTG
AAATGCTT	AAATCGCT
AAATGCTN	AAATCGCT
AAATGGCT	AAATCGCT
AAATGGGA	AACTGGGA
AAGCGCAT	AACGCATG
AACTATGT	GACTATGT
AAATGGTG	AAGTGGTG
AAAAGTAC	GAAAGTAC
AAAAGTCA	ATAAAGTC
AAAAGTCC	ATAAAGTC
AAAAGTCG	ATAAAGTC
AAAAGTCT	ATAAAGTC
AAAAGTCN	ATAAAGTC
AACTCACC	AATCACCC
AACTCAGA	TAACTCAG
AACTCAGC	TAACTCAG
AACTCAGG	TAACTCAG
AACTCAGT	TAACTCAG
AACTCAGN	TAACTCAG
AACTCATG	AACGCATG
AAGCGCTG	AAGTGCTG
AAGCGGAC	AAGGGGAC
AAGCGGGA	AAGGGGAC
AAGCGGTG	AAGTGGTG
AACCTGGC	ATCCTGGC
AACCTGGG	AACTGGGA
AAGAAAAC	AAGAATAA
AAGAAAAG	AAGAATAA
AAGAAAAT	AAGAATAA
AAGAAAAN	AAGAATAA
AAGAAACT	ACGAAACT
AACTCGCT	AAATCGCT
AAGAAATA	AAGAATAA
AACTCGGA	AACTGGGA
AACTCGGG	AACTGGGA
AAGAACAA	AAGAATAA
AAAATAAC	AAGAATAA
AAAATAAG	AAGAATAA
AACAAGTA	ACACAAGT
AAAATAAT	AAGAATAA
AACAAGTC	ACACAAGT
AAAATAAN	AAGAATAA
AACAAGTG	ACACAAGT
AACAAGTT	ACACAAGT
AAGAACTA	AAGAATAA
AACAAGTN	ACACAAGT
AAAGAATA	AAGAATAA
AAAATAGG	GAAATAGG
AAAATCGC	AAATCGCT
AACAATAA	AAGAATAA
AAATTCGC	AAATCGCT
AAGAAGAA	AAGAATAA
AAAGAGTG	AAGGAGTG
AAGAAGAG	TAGAAGAG
AAATTGCT	AAATCGCT
AAGAAGTA	AAGAATAA
AAGAAGTG	AAGGAGTG
AAGCTGCT	AAGTGCTG
AAGAATAA	AAGAATAA
AAATTTTC	GAATTTTC
AAGAATAC	AAGAATAA
AAGAATAG	AAGAATAA
AAGAATAT	AAGAATAA
AAGCTGGG	AACTGGGA
AAGAATAN	AAGAATAA
AAGCTGGT	AAGTGGTG
AAGAATCA	AAGAATAA
AAGAATGA	AAGAATAA
AACTGAGA	AACTGGGA
AACTGAGC	ATCTGAGC
AACTGAGG	AACTGGGA
AACACAAG	ACACAAGT
AACTGCAT	AACGCATG
AAGAATTA	AAGAATAA
AAGAATNA	AAGAATAA
AACTGCGA	AACTGGGA
AACTGCGG	AACTGGGA
AAGAANAA	AAGAATAA
AACTGCTG	AAGTGCTG
AAAGCATG	AACGCATG
AACTGGAA	AACTGGGA
AACTGGAC	AACTGGGA
AACTGGAG	AACTGGGA
AACTGGAT	AACTGGGA
AAGCTTGC	CAGCTTGC
AACTGGAN	AACTGGGA
AACTGGCA	AACTGGGA
AACTGGCG	AACTGGGA
AACTGGGA	AACTGGGA
AACTGGGC	AACTGGGA
AACTGGGG	AACTGGGA
AACTGGGT	AACTGGGA
AACTGGGN	AACTGGGA
AACACATG	AACGCATG
AAGAANTA	AAGAATAA
AACTGGTA	AACTGGGA
AACTGGNA	AACTGGGA
AACTGGNG	AACTGGGA
AACACCCA	AATCACCC
AAATNCGC	AAATCGCT
AAAGCGCT	AAATCGCT
AACTGTGA	AACTGGGA
AACACCCC	AATCACCC
AACACCCG	AATCACCC
AACTGTGG	AACTGGGA
AACACCCT	AATCACCC
AACACCCN	AATCACCC
AAGACATA	AAGAATAA
AAGACATT	AGGACATT
AACTGNGA	AACTGGGA
AACGAAAC	ACGAAACT
AACTGNGG	AACTGGGA
AACGAATA	AAGAATAA
AAATNGCT	AAATCGCT
AACGAATG	AACGCATG
AACGACAT	AACGCATG
AAGACTAA	AAGAATAA
AACTTGGA	AACTGGGA
AACTTGGG	AACTGGGA
AAAGGAGT	AAGGAGTG
AAACAAGT	ACACAAGT
AAACACCC	AATCACCC
AACGAGTG	AAGGAGTG
AAGAGAGT	AAGGAGTG
AAGAGATA	AAGAATAA
AACAGCAT	AACGCATG
AAAGGGAC	AAGGGGAC
AAAGGGGA	AAGGGGAC
AACGATCT	ACGATCTG
AACGATGA	AACGCATG
AACGATGC	AACGCATG
AACGATGG	AACGCATG
AACGATGT	AACGCATG
AACGATGN	AACGCATG
AACAGGGA	AACTGGGA
AACTNGGA	AACTGGGA
AACTNGGG	AACTGGGA
AAGGAAGT	AAGGAGTG
AAGGAATA	AAGAATAA
AAGGAATG	AAGGAGTG
AAGAGCTG	AAGTGCTG
AAGAGGAC	AAGGGGAC
AAAGTACA	GAAAGTAC
AAAGTACC	GAAAGTAC
AAAGTACG	GAAAGTAC
AAAGTACT	GAAAGTAC
AAAGTACN	GAAAGTAC
AAGAGGGA	AAGGGGAC
AAGAGGTG	AAGTGGTG
AAGAGGTT	TAGAGGTT
AAGGACAT	AGGACATT
AACGCAAG	AACGCATG
AACGCAAT	AACGCATG
AACGCACG	AACGCATG
AACGCACT	AACGCATG
AAAGTCGC	AAATCGCT
AACAGTTA	GACAGTTA
AAGGACGT	AAGGAGTG
AAGGACTG	AAGGAGTG
AAGAGTAA	AAGAATAA
AAGGAGAC	AAGGGGAC
AAGGAGAG	AAGGAGTG
AAGGAGAT	AAGGAGTG
AACGCAGA	AACGCATG
AAGAGTGA	AAGGAGTG
AACGCAGG	AACGCATG
AAGAGTGC	AAGGAGTG
AACGCAGT	AACGCATG
AAGAGTGG	AAGGAGTG
AACGCAGN	AACGCATG
AAGAGTGT	AAGGAGTG
AACGCATA	AACGCATG
AAGAGTGN	AAGGAGTG
AACGCATC	AACGCATG
AACGCATG	AACGCATG
AACGCATT	AACGCATG
AACGCATN	AACGCATG
AACGCANG	AACGCATG
AACGCANT	AACGCATG
AACGCCAT	AACGCATG
AAAGTGCT	AAGTGCTG
AAGGAGCG	AAGGAGTG
AAGGAGCT	AAGGAGTG
AAGGAGGC	AAGGAGTG
AAGGAGGG	AAGGAGTG
AAAGTGGT	AAGTGGTG
AAGGAGGT	AAGGAGTG
AAGGAGGN	AAGGAGTG
AAGGAGTA	AAGGAGTG
AAGGAGTC	AAGGAGTG
AAGGAGTG	AAGGAGTG
AAGGAGTT	AAGGAGTG
AAGGAGTN	AAGGAGTG
AAGGAGNG	AAGGAGTG
AACGCCCT	ACGCCCTA
AAGGAGNT	AAGGAGTG
AAGGATAA	AAGAATAA
AACGCCTG	AACGCATG
AAACCGAA	CAACCGAA
AAACCGCT	AAATCGCT
AACGCGAT	AACGCATG
AAGATAAA	AAGAATAA
AAGATAAC	AAGAATAA
AAGATAAG	AAGAATAA
AAGATAAT	AAGAATAA
AAGATAAN	AAGAATAA
AAGGATGA	AAGGAGTG
AAGGATGC	AAGGAGTG
AAGGATGG	AAGGAGTG
AAGGATGT	AAGGAGTG
AAGGATGN	AAGGAGTG
AAGGATTG	AAGGAGTG
AACGCGCT	CACGCGCT
AACGCGTG	AACGCATG
AAGGANGT	AAGGAGTG
AAGGANTG	AAGGAGTG
AAANCGCT	AAATCGCT
AAGATATA	AAGAATAA
AACNCATG	AACGCATG
AAGGCAGT	AAGGAGTG
AACGCTAT	AACGCATG
AAGGCATG	AACGCATG
AACGCTGA	AACGCATG
AACGCTGC	AACGCATG
AACGCTGG	AACGCATG
AACGCTGT	AACGCATG
AAGGCCAG	ACGGCCAG
AACGCTGN	AACGCATG
AACGCTTG	AACGCATG
AAGGCCGC	AGGCCGCC
AACATCCT	ACATCCTT
AACATCGC	AAATCGCT
AAGATCGC	AAATCGCT
AAACGCAT	AACGCATG
AAGATCTG	ACGATCTG
AAACGCTA	AAATCGCT
AAACGCTC	AAATCGCT
AAACGCTG	AAATCGCT
AAACGCTT	AAATCGCT
AAACGCTN	AAATCGCT
AACGCNAT	AACGCATG
AAGGCGAC	AAGGGGAC
AAGATGCT	AAGTGCTG
AAGATGGT	AAGTGGTG
AAGGCGGA	AAGGGGAC
AACATGGG	AACTGGGA
AACGCNTG	AACGCATG
AAGGCGTG	AAGGAGTG
AAGATTAA	AAGAATAA
AACGGAGT	AAGGAGTG
AAGGCTGA	AAGTGCTG
AAGGCTGC	AAGTGCTG
AACGGATG	AACGCATG
AAGGCTGG	AAGTGCTG
AAGGCTGT	AAGTGCTG
AAGGCTGN	AAGTGCTG
AACGGCAT	AACGCATG
AACGGCCA	ACGGCCAG
AAGGGAAC	AAGGGGAC
AAGGGACA	AAGGGGAC
AAGGGACC	AAGGGGAC
AAGGGACG	AAGGGGAC
AAGGGACT	AAGGGGAC
AAGGGACN	AAGGGGAC
AAGGGAGA	AAGGGGAC
AACGGGAA	AACTGGGA
AAGGGAGT	AAGGAGTG
AACGGGAG	AACTGGGA
AACGGGAT	AACTGGGA
AACGGGAN	AACTGGGA
AAGANATA	AAGAATAA
AAGGGCAC	AAGGGGAC
AAGGGCGA	AAGGGGAC
AAGGNAGT	AAGGAGTG
AAGGGCTG	AAGTGCTG
AAATACGC	AAATCGCT
AAGGGGAA	AAGGGGAC
AAGGGGAC	AAGGGGAC
AAGGGGAG	AAGGGGAC
AAGGGGAT	AAGGGGAC
AAGGGGAN	AAGGGGAC
AAGGGGCA	AAGGGGAC
AAGGGGCC	AAGGGGAC
AAGGGGCG	AAGGGGAC
AAGGGGCT	AAGGGGAC
AAGGGGCN	AAGGGGAC
AAGGGGGA	AAGGGGAC
AAGGGGGC	AAGGGGAC
AAATAGCT	AAATCGCT
AAGGGGTA	AAGGGGAC
AAATAGGA	GAAATAGG
AAGGGGTC	AAGGGGAC
AAATAGGC	GAAATAGG
AAATAGGG	GAAATAGG
AAATAGGT	GAAATAGG
AAATAGGN	GAAATAGG
AAGGGGNA	AAGGGGAC
AAGGGGNC	AAGGGGAC
AAGGGTAC	AAGGGGAC
AAGGNGAC	AAGGGGAC
AAGGNGGA	AAGGGGAC
AAGGGNAC	AAGGGGAC
AAGGNGTG	AAGGAGTG
AAGGGNGA	AAGGGGAC
AAGANTAA	AAGAATAA
AACGGTTG	ACCGGTTG
AACNGCAT	AACGCATG
AAANTCGC	AAATCGCT
AAGNGAGT	AAGGAGTG
AACNGGGA	AACTGGGA
AAGGTAGT	AAGGAGTG
AACGTATG	AACGCATG
AACGTATT	ACGTATTA
AAGGTCCG	ATGGTCCG
AACGTCAT	AACGCATG
AAGCAATA	AAGAATAA
AAGNGCTG	AAGTGCTG
AAGNGGAC	AAGGGGAC
AAGGTGAC	AAGGGGAC
AAGCACCC	AATCACCC
AAGGTGCT	AAGTGCTG
AAGGTGGA	AAGGGGAC
AAGNGGGA	AAGGGGAC
AAGGTGGT	AAGTGGTG
AAGTAATA	AAGAATAA
AAGGTGTG	AAGGAGTG
AAGNGGTG	AAGTGGTG
AACGTGCT	AAGTGCTG
AAGCAGCC	ACGCAGCC
AACGTGGT	AAGTGGTG
AAGCAGTG	AAGGAGTG
AAGCATAA	AAGAATAA
AAGCATGA	AACGCATG
AAGCATGC	AACGCATG
AAGTACTG	AAGTGCTG
AAGCATGT	AACGCATG
AAGCATGN	AACGCATG
AATCAACC	AATCACCC
AAGTAGCT	AAGTGCTG
AANGGAGT	AAGGAGTG
AAGTAGGT	AAGTGGTG
AATCACAC	AATCACCC
AATCACCA	AATCACCC
AACCACCC	AATCACCC
AATCACCC	AATCACCC
AATCACCG	AATCACCC
AATCACCT	AATCACCC
AAGTATAA	AAGAATAA
AATCACCN	AATCACCC
AATCACGC	AATCACCC
AATCACTC	AATCACCC
AATCACNC	AATCACCC
AACGNATG	AACGCATG
AATCAGCC	AATCACCC
AAGTATTA	ACGTATTA
AANGGGAC	AAGGGGAC
AANGGGGA	AAGGGGAC
AAGNTGCT	AAGTGCTG
AAGNTGGT	AAGTGGTG
AACCATGA	AACGCATG
AACCATGC	AACGCATG
AACCATGG	AACGCATG
AACCATGT	AACGCATG
AACCATGN	AACGCATG
AAGTCACC	AATCACCC
AACGNCAT	AACGCATG
AATCATCC	AATCACCC
AAGTCCTG	AAGTGCTG
AAGTCGGT	AAGTGGTG
AANGTGCT	AAGTGCTG
AANCACCC	AATCACCC
AAGTCGTG	AAGTGGTG
AANGTGGT	AAGTGGTG
AATCANCC	AATCACCC
AAGTCTGA	AAGTGCTG
AAGTCTGC	AAGTGCTG
AAGTCTGG	AAGTGCTG
AAGTCTGT	AAGTGCTG
AAGTCTGN	AAGTGCTG
AATCCACC	AATCACCC
AACCCATG	AACGCATG
AATCCCCA	AATCACCC
AATCCCCC	AATCACCC
AATCCCCG	AATCACCC
AAGTGACT	AAGTGCTG
AATCCCCT	AATCACCC
AATCCCCN	AATCACCC
AATCCCTC	ATCCCTCT
AATNCACC	AATCACCC
AAGTGCAG	AAGTGCTG
AAGTGCAT	AAGTGCTG
AAGTGCCG	AAGTGCTG
AAGTGCCT	AAGTGCTG
AAGTGCGA	AAGTGCTG
AAGTGCGC	AAGTGCTG
AAGTGCGG	AAGTGCTG
AATCCTGG	ATCCTGGC
AAGTGCGN	AAGTGCTG
AAGTGCTA	AAGTGCTG
AAGTGCTC	AAGTGCTG
AATCCTTA	ACATCCTT
AAGTGCTG	AAGTGCTG
AATCCTTC	ACATCCTT
AAGTGCTT	AAGTGCTG
AATCCTTG	ACATCCTT
AAGTGCTN	AAGTGCTG
AATCCTTT	ACATCCTT
AATCCTTN	ACATCCTT
AACCCGCA	TACCCGCA
AAGTGCNG	AAGTGCTG
AATCGACC	AATCACCC
AAGTGCNT	AAGTGCTG
AAGTGGAC	AAGGGGAC
AAGTGGAG	AAGTGGTG
AAGTGGAT	AAGTGGTG
AAGTGGCG	AAGTGGTG
AAGTGGGC	AAGTGGTG
AAGTGGGG	AAGTGGTG
AAGTGGGT	AAGTGGTG
AAGTGGGN	AAGTGGTG
AAGTGGTA	AAGTGGTG
AAGTGGTC	AAGTGGTG
AAGTGGTG	AAGTGGTG
AAGTGGTT	AAGTGGTG
AAGTGGTN	AAGTGGTG
AACCCTCT	ATCCCTCT
AATCGATA	TAATCGAT
AATCGATC	TAATCGAT
AATCGATG	TAATCGAT
AATCGATT	TAATCGAT
AATCGATN	TAATCGAT
AAGTGGNG	AAGTGGTG
AATAAAGT	ATAAAGTC
AAGTGGNT	AAGTGGTG
AAGTGTCT	AAGTGCTG
AATCGCAT	AACGCATG
AATCGCCC	AATCACCC
AATAACCC	AATCACCC
AATCGCTA	AAATCGCT
AATCGCTC	AAATCGCT
AATCGCTG	AAATCGCT
AATCGCTT	AAATCGCT
AATCGCTN	AAATCGCT
AAGTGNCT	AAGTGCTG
AAGTGNGT	AAGTGGTG
AATAATAA	AAGAATAA
AATGTGCT	AAGTGCTG
AATGTGGT	AAGTGGTG
AATAATTT	ACTAATTT
AAGTTCTG	AAGTGCTG
AATACACC	AATCACCC
AANTCACC	AATCACCC
AATCTACC	AATCACCC
AATACCCA	AATCACCC
AATACCCC	AATCACCC
AAGTTGCT	AAGTGCTG
AATACCCG	AATCACCC
AATACCCT	AATCACCC
AATACCCN	AATCACCC
AAGTTGGT	AAGTGGTG
AAGTTGTG	AAGTGGTG
AANTCGCT	AAATCGCT
AATCTCCC	AATCACCC
AATCTCTA	ATATCTCT
AANCGCAT	AACGCATG
AATCTCTC	ATATCTCT
AATCTCTG	ATATCTCT
AATCTCTT	ATATCTCT
AATCTCTN	ATATCTCT
AATCTGAG	ATCTGAGC
AATCTGGG	AACTGGGA
AAGTNCTG	AAGTGCTG
AANTGCTG	AAGTGCTG
AANTGGGA	AACTGGGA
AANTGGTG	AAGTGGTG
AAGTNGCT	AAGTGCTG
AAGTNGGT	AAGTGGTG
AAGTNGTG	AAGTGGTG
AATCNACC	AATCACCC
AANCTGGG	AACTGGGA
AATTACCC	AATCACCC
ACAAAACT	ACGAAACT
AATCNCCC	AATCACCC
ACAAAAGT	ACACAAGT
ACAAACTA	ACGAAACT
ACAAACTC	ACGAAACT
ACAAACTG	ACGAAACT
AAGNAATA	AAGAATAA
AATATCAT	GATATCAT
AATATCGC	AAATCGCT
AATATCGG	CATATCGG
AATATCTC	ATATCTCT
ACAAACTT	ACGAAACT
ACAAACTN	ACGAAACT
AATGAATA	AAGAATAA
AATTCACC	AATCACCC
AAGNAGTG	AAGGAGTG
ACAAAGTA	ACACAAGT
ACAAAGTG	ACACAAGT
AAGNATAA	AAGAATAA
ACAAAGTT	ACACAAGT
ACAAAGTN	ACACAAGT
AATGACCC	AATCACCC
AANAATAA	AAGAATAA
AATGACGC	CATGACGC
ACAAATGC	CCAAATGC
AATTCCCT	CATTCCCT
ACAAATTT	ACTAATTT
AATTCGCT	AAATCGCT
AATGAGTG	AAGGAGTG
ACAACAAG	ACACAAGT
ACAACCGA	CAACCGAA
ACAACCTT	ACATCCTT
AATTGCTG	AAGTGCTG
ACAGCAAG	ACACAAGT
AATGCACC	AATCACCC
AATTGGGA	AACTGGGA
AATTGGTG	AAGTGGTG
ACAGCAGC	ACGCAGCC
ACAACTTC	TCAACTTC
ACAGCCAG	ACGGCCAG
ACAATCCT	ACATCCTT
ACAGCCCT	ACGCCCTA
ACAATCGC	AAATCGCT
ACAAGACG	TCAAGACG
ACAATCTG	ACGATCTG
ACAGCCTT	ACATCCTT
ACGACAAC	ACGAAACT
ACGACAAG	ACACAAGT
ACAATTTA	ACTAATTT
ACAATTTC	ACTAATTT
AANATCGC	AAATCGCT
ACGACACT	ACGAAACT
ACAATTTG	ACTAATTT
ACAATTTT	ACTAATTT
ACAATTTN	ACTAATTT
ACGACAGC	ACGCAGCC
AATGCTGA	AAGTGCTG
AATGCTGC	AAGTGCTG
AATGCTGG	AAGTGCTG
AATGCTGT	AAGTGCTG
AATGCTGN	AAGTGCTG
ACGACATT	AGGACATT
ACGACCAG	ACGGCCAG
ACGACCCT	ACGCCCTA
ACGACCTA	ACGCCCTA
ACGACCTG	ACGATCTG
AANGAATA	AAGAATAA
ACAGCTTG	CAGCTTGC
ACGACGCT	CGACGCTG
ACGCNAGC	ACGCAGCC
ACAGGAGT	AAGGAGTG
ACGACTCT	ACGATCTG
ACGACTGA	ACGATCTG
ACGACTGC	ACGATCTG
ACGACTGG	ACGATCTG
AATGGAGT	AAGGAGTG
ACGACTGT	ACGATCTG
ACGACTGN	ACGATCTG
ACAGGCCA	ACGGCCAG
ACCGAAAC	ACGAAACT
ACCGAACA	CCGAACAT
AATTTTCA	GAATTTTC
AANGAGTG	AAGGAGTG
AATTTTCC	GAATTTTC
AATTTTCG	GAATTTTC
AATTTTCT	GAATTTTC
AATTTTCN	GAATTTTC
AATTTTTT	CATTTTTT
ACGCNCCT	ACGCCCTA
ACGAGAAC	ACGAAACT
ACGCNCTA	ACGCCCTA
AATGGGAA	AACTGGGA
AATGGGAG	AACTGGGA
AATGGGAT	AACTGGGA
ACGAGACT	ACGAAACT
AATGGGAN	AACTGGGA
AATGGGGA	AAGGGGAC
ACACAAAG	ACACAAGT
ACACAAAT	ACACAAGT
ACGCNGCC	ACGCAGCC
ACACAACG	ACACAAGT
ACACAACT	ACACAAGT
ACACAAGA	ACACAAGT
ACACAAGC	ACACAAGT
ACACAAGG	ACACAAGT
ACGAGCCC	ACGCAGCC
ACACAAGT	ACACAAGT
ACACAAGN	ACACAAGT
ACACAATA	ACACAAGT
ACACAATC	ACACAAGT
ACACAATG	ACACAAGT
ACACAATT	ACACAAGT
ACACAATN	ACACAAGT
ACGAGCCG	ACGCAGCC
ACGAGCCT	ACGCAGCC
ACGAGCCN	ACGCAGCC
ACACAANG	ACACAAGT
ACACAANT	ACACAAGT
AATGGTCC	ATGGTCCG
ACGAGCTG	ACGATCTG
ACACACAG	ACACAAGT
ACCGAGTT	ACCGGTTG
ACACACGT	ACACAAGT
AANGCATG	AACGCATG
ACAGGGGA	AAGGGGAC
ACCGATCT	ACGATCTG
AATGGTGA	AAGTGGTG
AATGGTGC	AAGTGGTG
ACACAGAG	ACACAAGT
AATGGTGG	AAGTGGTG
AATGGTGT	AAGTGGTG
AATGGTGN	AAGTGGTG
ACCGATTA	CCGATTAA
ACACAGCC	ACGCAGCC
ACCGATTG	ACCGGTTG
ACGAGTCT	ACGATCTG
ACAGGTTG	ACCGGTTG
ACGGAAAC	ACGAAACT
ACACAGGT	ACACAAGT
ACACAGTA	ACACAAGT
ACACAGTC	ACACAAGT
ACACAGTG	ACACAAGT
ACACAGTT	ACACAAGT
ACACAGTN	ACACAAGT
ACGGAACT	ACGAAACT
ACACATAG	ACACAAGT
ACCGCAGC	ACGCAGCC
ACGATAAC	ACGAAACT
ACCGCATG	AACGCATG
ACGATATG	ACGATCTG
ACCGCCAG	ACGGCCAG
ACGATATT	ACGTATTA
ACACATGT	ACACAAGT
ACCGCCCT	ACGCCCTA
ACGATCAG	ACGATCTG
ACGATCAT	ACGATCTG
ACAGTATT	ACGTATTA
ACGATCCG	ACGATCTG
ACGGACAG	ACGGCCAG
ACGGACAT	AGGACATT
ACGATCGA	ACGATCTG
ACGGACCA	ACGGCCAG
ACGATCGC	ACGATCTG
ACGATCGG	ACGATCTG
ACGATCGT	ACGATCTG
ACGATCGN	ACGATCTG
ACGATCTA	ACGATCTG
ACGATCTC	ACGATCTG
ACGATCTG	ACGATCTG
ACGATCTT	ACGATCTG
ACGATCTN	ACGATCTG
ACGATCNG	ACGATCTG
ACACANAG	ACACAAGT
ACGATCNT	ACGATCTG
ACAGTCCT	ACATCCTT
ACGATGCT	ACGATCTG
ACATNCCT	ACATCCTT
ACCGCGTT	ACCGGTTG
ACGATGTG	ACGATCTG
ACATNCTT	ACATCCTT
ACACANGT	ACACAAGT
ACGGAGCC	ACGCAGCC
ACACCAAG	ACACAAGT
ACGATTAC	ACGTATTA
ACCGCTTG	ACCGGTTG
ACGATTAG	ACGTATTA
ACGATTAT	ACGTATTA
ACGATTAN	ACGTATTA
ACGATTCT	ACGATCTG
ACGATTGA	ACGATCTG
ACAGTGCT	AAGTGCTG
ACACCAGT	ACACAAGT
ACGATTGC	ACGATCTG
ACGATTGG	ACGATCTG
ACGATTGT	ACGATCTG
ACGATTGN	ACGATCTG
ACGATTTG	ACGATCTG
ACAGTGGT	AAGTGGTG
ACGGAGTG	AAGGAGTG
ACGATNCT	ACGATCTG
ACAGTTAA	GACAGTTA
ACAGTTAC	GACAGTTA
ACAGTTAG	GACAGTTA
ACAGTTAT	GACAGTTA
ACAGTTAN	GACAGTTA
ACCGGATG	ACCGGTTG
ACCGGATT	ACCGGTTG
ACGGATCT	ACGATCTG
ACGGATTA	ACGTATTA
ACCGGCCA	ACGGCCAG
ACANAAGT	ACACAAGT
ACACCCTA	ACGCCCTA
ACCGGCTG	ACCGGTTG
ACCGGCTT	ACCGGTTG
ACACCCTT	ACATCCTT
ACCGGGAC	TCCGGGAC
ACGATNTG	ACGATCTG
ACGGCAAG	ACGGCCAG
ACCGGGTG	ACCGGTTG
ACCGGGTT	ACCGGTTG
ACGANAAC	ACGAAACT
ACGGCACA	ACGGCCAG
ACGGCAGA	ACGGCCAG
ACGGCAGG	ACGGCCAG
ACGGCAGT	ACGGCCAG
ACGGCAGN	ACGGCCAG
AATNACCC	AATCACCC
ACGGCCAA	ACGGCCAG
ACGGCCAC	ACGGCCAG
ACCGGTAG	ACCGGTTG
ACCGGTAT	ACCGGTTG
ACGANACT	ACGAAACT
ACCGGTCG	ACCGGTTG
ACCGGTCT	ACCGGTTG
ACCGGTGA	ACCGGTTG
ACCGGTGC	ACCGGTTG
ACCGGTGG	ACCGGTTG
ACCGGTGT	ACCGGTTG
ACCGGTGN	ACCGGTTG
ACCGGTTA	ACCGGTTG
ACCGGTTC	ACCGGTTG
ACCGGTTG	ACCGGTTG
ACCGGTTT	ACCGGTTG
ACCGGTTN	ACCGGTTG
ACGGCCAG	ACGGCCAG
ACGGCCAT	ACGGCCAG
ACCGGTNG	ACCGGTTG
ACCGGTNT	ACCGGTTG
ACGGCCAN	ACGGCCAG
ACGGCCCA	ACGGCCAG
ACGGCCCG	ACGGCCAG
ACGGCCCT	ACGCCCTA
ACGGCCGA	ACGGCCAG
ACGGCCGG	ACGGCCAG
ACGGCCGT	ACGGCCAG
ACGGCCGN	ACGGCCAG
ACGGCCTG	ACGGCCAG
ACGGCCNA	ACGGCCAG
ACGGCCNG	ACGGCCAG
ACGGCGAG	ACGGCCAG
ACGGCGCA	ACGGCCAG
ACANCAAG	ACACAAGT
ACCGGNTG	ACCGGTTG
ACCGGNTT	ACCGGTTG
ACACCTTA	ACATCCTT
ACACCTTC	ACATCCTT
ACGANCTG	ACGATCTG
ACCGTATT	ACGTATTA
ACACCTTG	ACATCCTT
ACACCTTT	ACATCCTT
ACACCTTN	ACATCCTT
ACGGCTAG	ACGGCCAG
ACGGCTCA	ACGGCCAG
ACACGAAG	ACACAAGT
ACGGCNAG	ACGGCCAG
ACCGTGTT	ACCGGTTG
ACGGCNCA	ACGGCCAG
ACGANTCT	ACGATCTG
ACCGTTGA	ACCGGTTG
ACANCCTT	ACATCCTT
ACCGTTGC	ACCGGTTG
ACCGTTGG	ACCGGTTG
ACCGTTGT	ACCGGTTG
ACCGTTGN	ACCGGTTG
ACCGTTTG	ACCGGTTG
ACCAGAGT	CCAGAGTC
ACACGAGT	ACACAAGT
ACATAAGT	ACACAAGT
ACGCAAAC	ACGAAACT
ACATAATT	ACTAATTT
ACACGCAT	AACGCATG
ACGCAACC	ACGCAGCC
ACGCAACT	ACGAAACT
ACGCAAGC	ACGCAGCC
ACGCAAGT	ACACAAGT
ACGGGCAG	ACGGCCAG
ACGGGCCA	ACGGCCAG
ACCAGCCA	ACGCAGCC
ACCAGCCC	ACGCAGCC
ACCAGCCG	ACGCAGCC
ACCAGCCT	ACGCAGCC
ACCAGCCN	ACGCAGCC
ACACGCGC	CACGCGCT
ACATACCT	ACATCCTT
ACGCACCA	ACGCAGCC
ACGGGGAC	AAGGGGAC
ACATACTT	ACATCCTT
ACGCACCC	ACGCAGCC
ACGCACCG	ACGCAGCC
ACCAGGTT	ACCGGTTG
ACGCACCN	ACGCAGCC
ACGCACGC	ACGCAGCC
ACGGGGGA	TCGGGGGA
ACGCACTA	ACGCCCTA
ACCAGTTG	ACCGGTTG
ACATATCG	CATATCGG
ACATATTA	ACGTATTA
ACGCAGAC	ACGCAGCC
ACGCAGCA	ACGCAGCC
ACGCAGCC	ACGCAGCC
ACGCAGCG	ACGCAGCC
ACGCAGCT	ACGCAGCC
ACCGNGTT	ACCGGTTG
ACACGGTT	ACCGGTTG
ACGCAGCN	ACGCAGCC
ACGCAGGC	ACGCAGCC
ACGCAGTC	ACGCAGCC
ACGCAGNC	ACGCAGCC
ACCGNTTG	ACCGGTTG
ACGCATCC	ACGCAGCC
ACACGTGG	CACGTGGG
ACATCAAG	ACACAAGT
ACGCATCT	ACGATCTG
ACGGGTTC	CGGGTTCG
ACGCATGA	AACGCATG
ACGGGTTG	ACCGGTTG
ACATCACC	AATCACCC
ACATCACT	ACATCCTT
ACGCATGT	AACGCATG
ACGCATGN	AACGCATG
ACGCATTA	ACGTATTA
ACATCATT	ACATCCTT
ACATCCAT	ACATCCTT
ACATCCCT	ACATCCTT
ACCTAATT	ACTAATTT
ACCATCCT	ACATCCTT
ACATCCGT	ACATCCTT
ACATCCTA	ACATCCTT
ACATCCTC	ACATCCTT
ACATCCTG	ACATCCTT
ACATCCTT	ACATCCTT
ACATCCTN	ACATCCTT
ACCATCTG	ACGATCTG
ACATCCNT	ACATCCTT
ACCTACGG	CCTACGGT
ACGCANCC	ACGCAGCC
ACACTAAG	ACACAAGT
ACATCGTT	ACATCCTT
ACGCANGC	ACGCAGCC
ACACTAGT	ACACAAGT
ACATCTGA	ACGATCTG
ACATCTGC	ACGATCTG
ACATCTGG	ACGATCTG
ACATCTGT	ACGATCTG
ACATCTGN	ACGATCTG
ACATCTTA	ACATCCTT
ACATCTTC	ACATCCTT
ACATCTTG	ACATCCTT
ACATCTTT	ACATCCTT
ACATCTTN	ACATCCTT
ACACTCCT	ACATCCTT
ACATCNCT	ACATCCTT
ACGGTATT	ACGTATTA
ACATCNTT	ACATCCTT
ACATGACG	CATGACGC
ACACTGGG	AACTGGGA
ACATGCCT	ACATCCTT
ACCTATTA	ACGTATTA
ACGGTCAG	ACGGCCAG
ACATGCTT	ACATCCTT
ACGGTCCA	ACGGCCAG
ACGGTCCG	ATGGTCCG
ACCNGGTT	ACCGGTTG
ACGGTCTG	ACGATCTG
ACCNGTTG	ACCGGTTG
ACGCCACT	ACGCCCTA
ACGCCAGA	ACGGCCAG
ACGCCAGG	ACGGCCAG
ACGCCAGT	ACGGCCAG
ACACNAAG	ACACAAGT
ACGCCAGN	ACGGCCAG
ACACNAGT	ACACAAGT
ACGCCATA	ACGCCCTA
ACATTCCC	CATTCCCT
ACATTCCT	ACATCCTT
ACGCCCAA	ACGCCCTA
ACGCCCAC	ACGCCCTA
ACCTCCTT	ACATCCTT
ACGCCCAT	ACGCCCTA
ACGCCCAN	ACGCCCTA
ACGCCCCA	ACGCCCTA
ACATTCTT	ACATCCTT
ACGGTTGA	ACCGGTTG
ACGGTTGC	ACCGGTTG
ACGCCCCT	ACGCCCTA
ACGGTTGG	ACCGGTTG
ACGCCCGA	ACGCCCTA
ACCCAAGT	ACACAAGT
ACGGTTGT	ACCGGTTG
ACGGTTGN	ACCGGTTG
ACGCCCGT	ACGCCCTA
ACGCCCTA	ACGCCCTA
ACGCCCTC	ACGCCCTA
ACGCCCTG	ACGCCCTA
ACGCCCTT	ACGCCCTA
ACGCCCTN	ACGCCCTA
ACGCCCNA	ACGCCCTA
ACGCCCNT	ACGCCCTA
ACGCCGCT	ACGCCCTA
ACGCCGTA	ACGCCCTA
ACATTTTT	CATTTTTT
ACGCCTAA	ACGCCCTA
ACGCCTAC	ACGCCCTA
ACGCCTAG	ACGCCCTA
ACGCCTAT	ACGCCCTA
ACGCCTAN	ACGCCCTA
ACGCCTCT	ACGCCCTA
ACANTCCT	ACATCCTT
ACGCCTTA	ACGCCCTA
ACCCAGCC	ACGCAGCC
ACTAAACT	ACGAAACT
ACTAAAGT	ATAAAGTC
ACTAAATT	ACTAATTT
ACGCCNCT	ACGCCCTA
ACGCCNTA	ACGCCCTA
ACCCAGTC	GCCCAGTC
ACTAACTT	ACTAATTT
ACGCGAGC	ACGCAGCC
ACGGNCAG	ACGGCCAG
ACAGAAAC	ACGAAACT
ACGGNCCA	ACGGCCAG
ACAGAAGT	ACACAAGT
ACAGAATA	AAGAATAA
ACTAAGTT	ACTAATTT
ACTAATAT	ACTAATTT
ACTAATCT	ACTAATTT
ACTAATGT	ACTAATTT
ACTAATTA	ACTAATTT
ACTAATTC	ACTAATTT
ACTAATTG	ACTAATTT
ACTAATTT	ACTAATTT
ACGCGCCC	ACGCAGCC
ACTAATTN	ACTAATTT
ACCTGAGC	ATCTGAGC
ACGCGCCG	ACGCAGCC
ACGCGCCN	ACGCAGCC
ACTAATNT	ACTAATTT
ACGCGCTC	CACGCGCT
ACGCGCTG	CACGCGCT
ACGCGCTT	CACGCGCT
ACGCGCTN	CACGCGCT
ACAGAGTC	CCAGAGTC
ACTAANTT	ACTAATTT
ACGCGGCC	ACGCAGCC
ACTACAAG	ACACAAGT
ACGCGGTT	ACCGGTTG
ACAGATCT	ACGATCTG
ACTACATT	ACTAATTT
ACCTGGCA	ATCCTGGC
ACCTGGCC	ATCCTGGC
ACCTGGCG	ATCCTGGC
ACCTGGCT	ATCCTGGC
ACCTGGCN	ATCCTGGC
ACCTGGGA	AACTGGGA
ACCTGGTT	ACCGGTTG
ACGTGATT	ACGTATTA
ACTACGGT	CCTACGGT
ACGCTAGC	ACGCAGCC
ACGTAAAC	ACGAAACT
ACGTAAAT	GCGTAAAT
ACGTGCCA	ACGGCCAG
ACGCTATT	ACGTATTA
ACGTAACT	ACGAAACT
ACCTGTTG	ACCGGTTG
ACCCCCTA	ACGCCCTA
ACGTAATA	ACGTATTA
ACGTGCTG	AAGTGCTG
ACGCTCCT	ACGCCCTA
ACTACTTT	ACTAATTT
ACGTACTA	ACGTATTA
ACGTACTT	ACGTATTA
ACGCTCTA	ACGCCCTA
ACGCTCTG	ACGATCTG
ACGTGGGA	CACGTGGG
ACGTAGCC	ACGCAGCC
ACGTGGGC	CACGTGGG
ACGTGGGG	CACGTGGG
ACGAAAAC	ACGAAACT
ACGCTGCC	ACGCAGCC
ACGTGGGT	CACGTGGG
ACGTAGTA	ACGTATTA
ACGAAAAT	ACGAAACT
ACGTGGGN	CACGTGGG
ACGTAGTT	ACGTATTA
ACGAAACA	ACGAAACT
ACGAAACC	ACGAAACT
ACGAAACG	ACGAAACT
ACGAAACT	ACGAAACT
ACGTATAA	ACGTATTA
ACGAAACN	ACGAAACT
ACGTATAC	ACGTATTA
ACGTATAG	ACGTATTA
ACGAAAGC	ACGAAACT
ACGTATAT	ACGTATTA
ACGTATAN	ACGTATTA
ACGTATCA	ACGTATTA
ACGAAAGT	ACGAAACT
ACGTGGTG	AAGTGGTG
ACGAAATA	ACGAAACT
ACCCCTAA	ACGCCCTA
ACGAAATC	ACGAAACT
ACGTATGA	ACGTATTA
ACCCCTAC	ACGCCCTA
ACGAAATG	ACGAAACT
ACCCCTAG	ACGCCCTA
ACGAAATT	ACGAAACT
ACGAAATN	ACGAAACT
ACGTATGT	ACGTATTA
ACCCCTAT	ACGCCCTA
ACCCCTAN	ACGCCCTA
ACGTATTA	ACGTATTA
ACGAAANC	ACGAAACT
ACGTATTC	ACGTATTA
ACGTATTG	ACGTATTA
ACGTATTT	ACGTATTA
ACGAAANT	ACGAAACT
ACGTATTN	ACGTATTA
ACGTATNA	ACGTATTA
ACCCCTCT	ATCCCTCT
ACGAACAC	ACGAAACT
ACCCCTTC	CCCCTTCA
ACGTGTCC	CGTGTCCA
ACGTATNT	ACGTATTA
ACGAACAT	CCGAACAT
ACGTGTTA	ACGTATTA
ACGAACCT	ACGAAACT
ACTAGATT	ACTAATTT
ACGAACTA	ACGAAACT
ACGAACTC	ACGAAACT
ACGTANTA	ACGTATTA
ACGAACTT	ACGAAACT
ACGAACTN	ACGAAACT
ACGTANTT	ACGTATTA
ACGAAGAC	ACGAAACT
ACGTCAGC	ACGCAGCC
ACGAAGCC	ACGCAGCC
ACGAAGCT	ACGAAACT
ACCCGCAA	TACCCGCA
ACCCGCAC	TACCCGCA
ACCCGCAG	TACCCGCA
ACGTCATT	ACGTATTA
ACCCGCAT	TACCCGCA
ACCCGCAN	TACCCGCA
ACTAGCGA	CTAGCGAC
ACGTTAAC	GCGTTAAC
ACGTCCAG	ACGGCCAG
ACGTCCCT	ACGCCCTA
ACGTCCTA	ACGCCCTA
ACGTCCTT	ACATCCTT
ACGAATAA	AAGAATAA
ACGAATAC	ACGAAACT
ACGTTATT	ACGTATTA
ACCCGGTT	ACCGGTTG
ACCAAACT	ACGAAACT
ACNTAATT	ACTAATTT
ACGTTCCA	CGTTCCAA
ACGAATTA	ACGTATTA
ACGAATTT	ACTAATTT
ACCAAATG	CCAAATGC
ACCCGTTG	ACCGGTTG
ACTAGTTT	ACTAATTT
ACGTTCTG	ACGATCTG
ACGAANAC	ACGAAACT
ACGTCTGA	ACGATCTG
ACGTCTGC	ACGATCTG
ACGAANCT	ACGAAACT
ACGTCTGG	ACGATCTG
ACGTCTGT	ACGATCTG
ACGTCTGN	ACGATCTG
ACGTCTTA	ACGTATTA
ACGTTTAA	ACGTATTA
ACGTTTAC	ACGTATTA
ACGTTTAG	ACGTATTA
ACGTTTAT	ACGTATTA
ACGTTTAN	ACGTATTA
ACGTTTTA	ACGTATTA
ACCAAGTA	ACACAAGT
ACCAAGTC	ACACAAGT
ACCAAGTG	ACACAAGT
ACCAAGTT	ACACAAGT
ACCAAGTN	ACACAAGT
ACNAAACT	ACGAAACT
ACTATATT	ACTAATTT
ACCCTCTA	ATCCCTCT
ACCCTCTC	ATCCCTCT
ACCCTCTG	ATCCCTCT
ACCCTCTT	ATCCCTCT
ACCCTCTN	ATCCCTCT
ACCAATTT	ACTAATTT
ACCCTGGC	ATCCTGGC
ACNTATTA	ACGTATTA
ACTATCCT	ACATCCTT
ACNCGGTT	ACCGGTTG
ACTATCTC	ATATCTCT
ACTATCTG	ACGATCTG
ACCCTTCA	CCCCTTCA
ACGTNATT	ACGTATTA
ACCACAAG	ACACAAGT
ACNAATTT	ACTAATTT
ACTATGTA	GACTATGT
ACTATGTC	GACTATGT
ACTATGTG	GACTATGT
ACTATGTT	GACTATGT
ACTATGTN	GACTATGT
ACTATTAA	ACGTATTA
ACTATTAC	ACGTATTA
ACTATTAG	ACGTATTA
ACTATTAT	ACGTATTA
ACTATTAN	ACGTATTA
ACTATTTA	ACTAATTT
ACTATTTC	ACTAATTT
ACTATTTG	ACTAATTT
ACTATTTT	ACTAATTT
ACTATTTN	ACTAATTT
ACGTNTTA	ACGTATTA
ACNACAAG	ACACAAGT
ACGNAAAC	ACGAAACT
ACGNAACT	ACGAAACT
ACNTCCTT	ACATCCTT
ACTANATT	ACTAATTT
ACTTCCCA	CTTCCCAG
ACTCTGAG	ATCTGAGC
ACTTCCTT	ACATCCTT
AGAAAAAG	GAAAAAGC
AGAAAAGA	GGAAAAGA
ACGNAGCC	ACGCAGCC
AGAAACTA	ACGAAACT
AGAAACTC	ACGAAACT
AGAAACTG	ACGAAACT
AGAAACTT	ACGAAACT
AGAAACTN	ACGAAACT
AGAAAGTA	GAAAGTAC
AGAAAGTC	ATAAAGTC
ACGNATCT	ACGATCTG
ACGNATTA	ACGTATTA
AGAAATAG	GAAATAGG
ACTANTTT	ACTAATTT
ACTCAAGT	ACACAAGT
ACTCAATT	ACTAATTT
ACTGAAAC	ACGAAACT
ACTCACCC	AATCACCC
AGAACATT	AGGACATT
ACTCACTA	CTCACTAC
ACGNCAGC	ACGCAGCC
ACTGAATT	ACTAATTT
ACNATCCT	ACATCCTT
ACGNCCAG	ACGGCCAG
ACNATCTG	ACGATCTG
ACGNCCCT	ACGCCCTA
ACGNCCTA	ACGCCCTA
ACTCAGCC	ACGCAGCC
ACTGAGCA	ATCTGAGC
ACTGAGCC	ATCTGAGC
ACTGAGCG	ATCTGAGC
ACTGAGCT	ATCTGAGC
ACTGAGCN	ATCTGAGC
ACTGATAA	CTGATAAA
ACTCATTT	ACTAATTT
ACTGATCT	ACGATCTG
ACTTTACC	GCTTTACC
ACTGATTT	ACTAATTT
ACTGCAGC	ACGCAGCC
ACTCCCTA	ACGCCCTA
ACTCCCTC	ATCCCTCT
ACTGCATG	ATGCATGG
ACNGAAAC	ACGAAACT
ACTGCCAG	ACGGCCAG
ACTGCCCT	ACGCCCTA
ACTGCCTT	CTGCCTTT
ACTCCTGG	ATCCTGGC
ACTCCTTA	ACATCCTT
ACGNGCCA	ACGGCCAG
ACTCCTTC	ACATCCTT
ACTCCTTG	ACATCCTT
ACTCCTTT	ACATCCTT
ACTCCTTN	ACATCCTT
ACTTTGTA	TCTTTGTA
AGAAGAGA	TAGAAGAG
AGAAGAGC	TAGAAGAG
AGAAGAGG	TAGAAGAG
AGAAGAGT	TAGAAGAG
AGAAGAGN	TAGAAGAG
ACNGATCT	ACGATCTG
ACNGCAGC	ACGCAGCC
ACTCGGTT	ACCGGTTG
ACTGGCCA	ACGGCCAG
ACNGCCAG	ACGGCCAG
ACGNTATT	ACGTATTA
ACNGCCCT	ACGCCCTA
ACTCGTTC	GCTCGTTC
ACTGGGAA	AACTGGGA
ACTGGGAC	AACTGGGA
ACTGGGAG	AACTGGGA
ACTGGGAT	AACTGGGA
ACGNTCTG	ACGATCTG
ACTGGGAN	AACTGGGA
ACNCAAGT	ACACAAGT
ACTGGTCC	ATGGTCCG
ACTGGTTG	ACCGGTTG
ACNCAGCC	ACGCAGCC
ACTNAATT	ACTAATTT
AGAATAAA	AAGAATAA
AGAATAAC	AAGAATAA
AGAATAAG	AAGAATAA
AGAATAAT	AAGAATAA
AGAATAAN	AAGAATAA
ACTGTATT	ACGTATTA
AGAATCGC	AAATCGCT
ACNGGCCA	ACGGCCAG
ACTNATTT	ACTAATTT
AGAATTTT	GAATTTTC
ACNCCCTA	ACGCCCTA
AGACCGCC	AGGCCGCC
ACNGGTTG	ACCGGTTG
AGATATCA	GATATCAT
AGCGTAAA	GCGTAAAT
ACNGTATT	ACGTATTA
AGCGTATT	ACGTATTA
AGATCACC	AATCACCC
AGACAAGT	ACACAAGT
AGCGTTAA	GCGTTAAC
ACTTAATT	ACTAATTT
ACTTACGG	GCTTACGG
AGACGCAT	AACGCATG
AGACAGTT	GACAGTTA
AGACGCTG	CGACGCTG
AGACATTA	AGGACATT
AGACATTC	AGGACATT
AGACATTG	AGGACATT
AGACATTT	AGGACATT
ACTTATTA	ACGTATTA
AGACATTN	AGGACATT
ACTTATTT	ACTAATTT
AGATCCTT	ACATCCTT
AGATCGCT	AAATCGCT
AGGGGACA	AAGGGGAC
AGGGGACC	AAGGGGAC
AGGGGACG	AAGGGGAC
AGGGGACT	AAGGGGAC
AGGGGACN	AAGGGGAC
AGATCTCT	ATATCTCT
AGATCTGA	ACGATCTG
AGATCTGC	ACGATCTG
AGATCTGG	ACGATCTG
AGATCTGT	ACGATCTG
AGATCTGN	ACGATCTG
AGATGAAC	GGATGAAC
AGGGGGAC	AAGGGGAC
AGGANATT	AGGACATT
AGGANCAT	AGGACATT
AGCTAATT	ACTAATTT
AGACTATG	GACTATGT
AGGCAAAA	GGCAAAAT
AGGCACAT	AGGACATT
AGGCACGC	AGGCCGCC
AGACTGGG	AACTGGGA
AGGCATGG	ATGCATGG
AGCCACCG	TGCCACCG
AGGCATTA	AGGACATT
AGGCATTC	AGGACATT
AGGCATTG	AGGACATT
AGGCATTT	AGGACATT
AGGCATTN	AGGACATT
AGGGTCCG	ATGGTCCG
AGCAAAAT	GGCAAAAT
AGGCCACC	AGGCCGCC
AGGCCAGA	ACGGCCAG
AGGCCAGG	ACGGCCAG
AGGCCAGT	ACGGCCAG
AGGCCAGN	ACGGCCAG
AGGCCATT	AGGACATT
AGGCCCCA	AGGCCGCC
AGGCCCCC	AGGCCGCC
AGGCCCCG	AGGCCGCC
AGGCCCCT	AGGCCGCC
AGGCCCCN	AGGCCGCC
AGGCCCGC	AGGCCGCC
AGGGTTCG	CGGGTTCG
AGGCCCTA	ACGCCCTA
AGGCCGAC	AGGCCGCC
AGGCCGCA	AGGCCGCC
AGGCCGCC	AGGCCGCC
AGGCCGCG	AGGCCGCC
AGGCCGCT	AGGCCGCC
AGGCCGCN	AGGCCGCC
AGGCCGGC	AGGCCGCC
AGGCCGTC	AGGCCGCC
AGGCCGNC	AGGCCGCC
AGCTCGTT	GCTCGTTC
AGCCCAGT	GCCCAGTC
AGGCCTCC	AGGCCGCC
AGGCCTGC	AGGCCGCC
AGGCCNCC	AGGCCGCC
AGGCCNGC	AGGCCGCC
AGCCCGCC	AGGCCGCC
AGCACAAG	ACACAAGT
AGCACATT	AGGACATT
AGCCCTAA	ACGCCCTA
AGCCCTAC	ACGCCCTA
AGCCCTAG	ACGCCCTA
AGCCCTAT	ACGCCCTA
AGGCGACT	TGGCGACT
AGCCCTAN	ACGCCCTA
AGCCCTCT	ATCCCTCT
AGGCGCCA	AGGCCGCC
AGGCGCCC	AGGCCGCC
AGGCGCCG	AGGCCGCC
AGGCGCCT	AGGCCGCC
AGGCGCCN	AGGCCGCC
AGGCGCGC	AGGCCGCC
AGGCGGCC	AGGCCGCC
AGCCGCCA	AGGCCGCC
AGCCGCCC	AGGCCGCC
AGCCGCCG	AGGCCGCC
AGCTGAGC	ATCTGAGC
AGCCGCCT	AGGCCGCC
AGCCGCCN	AGGCCGCC
AGCTGGGA	AACTGGGA
AGCAGCCA	ACGCAGCC
AGCAGCCC	ACGCAGCC
AGCAGCCG	ACGCAGCC
AGCAGCCT	ACGCAGCC
AGCAGCCN	ACGCAGCC
AGCCGGTT	ACCGGTTG
AGGTACAT	AGGACATT
AGCTTACG	GCTTACGG
AGGCTCGC	AGGCCGCC
AGCTTGCA	CAGCTTGC
AGCTTGCC	CAGCTTGC
AGCTTGCG	CAGCTTGC
AGCTTGCT	CAGCTTGC
AGCTTGCN	CAGCTTGC
AGTATACG	GTATACGA
AGCTTTAC	GCTTTACC
AGTATCTC	ATATCTCT
AGGCTGCC	AGGCCGCC
AGAGAATA	AAGAATAA
AGAGACAT	AGGACATT
AGGTATTA	ACGTATTA
AGCCTGGC	ATCCTGGC
AGTATTAA	ACGTATTA
AGTATTAC	ACGTATTA
AGTATTAG	ACGTATTA
AGTATTAT	ACGTATTA
AGTATTAN	ACGTATTA
AGCATCCT	ACATCCTT
AGCATGGA	ATGCATGG
AGCATGGC	ATGCATGG
AGCATGGG	ATGCATGG
AGCATGGT	ATGCATGG
AGCATGGN	ATGCATGG
AGGTCATT	AGGACATT
AGGTCCGA	ATGGTCCG
AGGTCCGG	ATGGTCCG
AGGTCCGT	ATGGTCCG
AGGTCCGN	ATGGTCCG
AGGTCGCC	AGGCCGCC
AGAGCCGC	AGGCCGCC
AGGAAAAG	GGAAAAGA
AGGAAACT	ACGAAACT
AGGAAATT	AGGACATT
AGGAACAT	AGGACATT
AGCGAAAC	ACGAAACT
AGGCNCGC	AGGCCGCC
AGGTGCTG	AAGTGCTG
AGGAATAA	AAGAATAA
AGAGGAGT	AAGGAGTG
AGCGACAT	AGGACATT
AGGTGGTG	AAGTGGTG
AGTGCATG	ATGCATGG
AGGCNGCC	AGGCCGCC
AGGAATTA	AGGACATT
AGGAATTC	AGGACATT
AGGAATTG	AGGACATT
AGGAATTT	AGGACATT
AGGAATTN	AGGACATT
AGTGCCGC	AGGCCGCC
AGTCACCC	AATCACCC
AGGTGTTT	GGTGTTTC
AGAGGGGA	AAGGGGAC
AGTGCTGA	AAGTGCTG
AGTGCTGC	AAGTGCTG
AGTGCTGG	AAGTGCTG
AGTGCTGT	AAGTGCTG
AGTGCTGN	AAGTGCTG
AGAGGTTA	TAGAGGTT
AGGGACAT	AGGACATT
AGAGGTTC	TAGAGGTT
AGAGGTTG	TAGAGGTT
AGGACAAT	AGGACATT
AGGGACCC	GGGACCCG
AGAGGTTT	TAGAGGTT
AGAGGTTN	TAGAGGTT
AGGACACT	AGGACATT
AGGACAGT	AGGACATT
AGGACATA	AGGACATT
AGGACATC	AGGACATT
AGGACATG	AGGACATT
AGGACATT	AGGACATT
AGGACATN	AGGACATT
AGCGATCT	ACGATCTG
AGGACANT	AGGACATT
AGGACCAT	AGGACATT
AGGACCCG	GGGACCCG
AGGACCGC	AGGCCGCC
AGGACCTT	AGGACATT
AGGGAGTG	AAGGAGTG
AGGACGAT	AGGACATT
AGGACGCC	AGGCCGCC
AGGACGTT	AGGACATT
AGGACTAT	AGGACATT
AGTGGTCC	ATGGTCCG
AGTGGTGA	AAGTGGTG
AGTGGTGC	AAGTGGTG
AGTGGTGG	AAGTGGTG
AGGACTTA	AGGACATT
AGTGGTGT	AAGTGGTG
AGGACTTC	AGGACATT
AGTGGTGN	AAGTGGTG
AGGACTTG	AGGACATT
AGGACTTT	AGGACATT
AGGACTTN	AGGACATT
AGGACNAT	AGGACATT
AGGGCATT	AGGACATT
AGGGCCAG	ACGGCCAG
AGAGTGCT	AAGTGCTG
AGAGTGGT	AAGTGGTG
AGGACNTT	AGGACATT
AGGGCCGC	AGGCCGCC
AGTCCCTC	ATCCCTCT
AGGAGATT	AGGACATT
AGTGTCCA	CGTGTCCA
AGGGCGCC	AGGCCGCC
AGGAGCAT	AGGACATT
AGCGCAGC	ACGCAGCC
ATAACAGT	ATAAAGTC
AGTCCGCC	AGGCCGCC
AGCGCATG	AACGCATG
AGTGTTTC	GGTGTTTC
ATAACGTC	ATAAAGTC
AGCGCCCT	ACGCCCTA
AGCGCCGC	AGGCCGCC
AGTCCTGG	ATCCTGGC
ATAACTCA	TAACTCAG
AGGAGTGA	AAGGAGTG
AGGAGTGC	AAGGAGTG
AGGAGTGG	AAGGAGTG
AGGAGTGT	AAGGAGTG
AGGAGTGN	AAGGAGTG
ATAACTCT	ATATCTCT
AGGNACAT	AGGACATT
AGGATATT	AGGACATT
AGTCGACA	TGTCGACA
ATAAGAGT	ATAAAGTC
AGGATCAT	AGGACATT
AGGATCTG	ACGATCTG
AGGATGAA	GGATGAAC
ATAAGGTC	ATAAAGTC
ATAAGTCA	ATAAAGTC
ATAAGTCC	ATAAAGTC
ATAAGTCG	ATAAAGTC
ATAAGTCT	ATAAAGTC
AGTTAGCA	GTTAGCAA
ATAAGTCN	ATAAAGTC
AGGNCATT	AGGACATT
AGGNCCGC	AGGCCGCC
AGNCCGCC	AGGCCGCC
AGGNCGCC	AGGCCGCC
ATAATAGT	ATAAAGTC
AGTCTAGC	TGTCTAGC
ATAATCGA	TAATCGAT
ATAATCGC	AAATCGCT
AGCGGCCA	ACGGCCAG
ATAATCTC	ATATCTCT
AGTTCCAA	CGTTCCAA
AGNGACAT	AGGACATT
AGCGGGTT	TGCGGGTT
AGTTCGGC	TGTTCGGC
AGTCTGAG	ATCTGAGC
ATAATGTC	ATAAAGTC
AGCGGTTG	ACCGGTTG
ATAATTTA	ACTAATTT
ATAATTTC	ACTAATTT
ATAATTTG	ACTAATTT
ATAATTTT	ACTAATTT
ATAATTTN	ACTAATTT
AGTTGTAT	GTTGTATT
ATAANAGT	ATAAAGTC
AGNGCCGC	AGGCCGCC
ATCAAAGT	ATAAAGTC
ATAANGTC	ATAAAGTC
AGTGACAT	AGGACATT
ATCAACTT	TCAACTTC
ATCAAGAC	TCAAGACG
ATCAAGTC	ATAAAGTC
ATCACAAG	ACACAAGT
ATCACCCA	AATCACCC
ATCACCCC	AATCACCC
ATCACCCG	AATCACCC
ATCACCCT	AATCACCC
ATCACCCN	AATCACCC
ATATGAGC	ATCTGAGC
ATCACCTC	ATCCCTCT
AGTAAAGT	ATAAAGTC
ATACAGTC	ATAAAGTC
ATATGCTC	ATATCTCT
ATACATGG	ATGCATGG
ATCTCAGC	ATCTGAGC
ATCACTAC	CTCACTAC
ATATGTCT	ATATCTCT
ATCACTCT	ATCCCTCT
ATCACTGG	ATCCTGGC
ATCTCCTC	ATCCCTCT
ATCAGAGC	ATCTGAGC
ATCTCGAG	ATCTGAGC
ATCAGATA	TTCAGATA
AGTAATTT	ACTAATTT
ATACCCGC	TACCCGCA
ATACCCGG	GTACCCGG
ATACCCTC	ATCCCTCT
ATCTCTGG	ATCCTGGC
ATATTCTA	ATATCTCT
ATATTCTC	ATATCTCT
ATATTCTG	ATATCTCT
ATATTCTT	ATATCTCT
ATATTCTN	ATATCTCT
ATACCTGG	ATCCTGGC
ATCTGAAC	ATCTGAGC
ATCTGAAG	ATCTGAGC
ATCTGACA	ATCTGAGC
ATCTGACC	ATCTGAGC
ATCTGACG	ATCTGAGC
ATCTGACT	ATCTGAGC
ATCTGACN	ATCTGAGC
ATCTGAGA	ATCTGAGC
ATCTGAGC	ATCTGAGC
ATCTGAGG	ATCTGAGC
ATCTGAGT	ATCTGAGC
ATCTGAGN	ATCTGAGC
ATCTGATC	ATCTGAGC
ATCTGATG	ATCTGAGC
ATCTGANC	ATCTGAGC
ATCTGANG	ATCTGAGC
ATATTTCT	ATATCTCT
ATCTGCAG	ATCTGAGC
AGTACATT	AGGACATT
ATCATCCT	ACATCCTT
AGTACCCG	GTACCCGG
ATCTGCGC	ATCTGAGC
ATCATCTC	ATATCTCT
ATCATGAG	ATCTGAGC
ATACGCAT	AACGCATG
ATCATGGA	ATGCATGG
ATCATGGG	ATGCATGG
ATCATGGT	ATGCATGG
ATCATGGN	ATGCATGG
ATCTGGAG	ATCTGAGC
ATCTGGGA	AACTGGGA
ATCTGGGC	ATCTGAGC
ATCTGTAG	ATCTGAGC
ATCTGTGC	ATCTGAGC
ATCTGNAG	ATCTGAGC
ATCTGNGC	ATCTGAGC
ATATNCTC	ATATCTCT
ATCTTAGC	ATCTGAGC
ATATNTCT	ATATCTCT
AGTAGAAC	GTAGAACC
ATAAAAGT	ATAAAGTC
ATAAAATC	ATAAAGTC
ATCTTGAG	ATCTGAGC
ATAAACGT	ATAAAGTC
ATAAACTC	ATAAAGTC
ATAAAGAC	ATAAAGTC
ATAAAGAT	ATAAAGTC
ATAAAGCA	ATAAAGTC
ATAAAGCC	ATAAAGTC
ATAAAGCG	ATAAAGTC
ATAAAGCT	ATAAAGTC
ATAAAGCN	ATAAAGTC
ATAAAGGC	ATAAAGTC
ATAAAGGT	ATAAAGTC
ATAAAGTA	ATAAAGTC
ATAAAGTC	ATAAAGTC
ATAAAGTG	ATAAAGTC
ATAAAGTT	ATAAAGTC
ATAAAGTN	ATAAAGTC
ATCTTGGC	ATCCTGGC
ATAAAGNC	ATAAAGTC
ATAAAGNT	ATAAAGTC
ATAAATCA	ATAAAGTC
ATAAATCC	ATAAAGTC
ATAAATCG	ATAAAGTC
ATAAATCT	ATAAAGTC
ATAAATCN	ATAAAGTC
ATAAATGT	ATAAAGTC
ATANAAGT	ATAAAGTC
ATAAATTC	ATAAAGTC
ATACTCTA	ATATCTCT
ATACTCTC	ATATCTCT
ATACTCTG	ATATCTCT
ATACTCTT	ATATCTCT
ATACTCTN	ATATCTCT
ATAAANGT	ATAAAGTC
ATACTGAG	ATCTGAGC
ATAAANTC	ATAAAGTC
ATACTGGC	ATCCTGGC
ATACTGGG	AACTGGGA
ATGCGATG	ATGCATGG
ATCTTTGT	TCTTTGTA
ATGCGGGT	TGCGGGTT
ATANAGTC	ATAAAGTC
ATGCGTCC	ATGGTCCG
ATGCGTGG	ATGCATGG
ATGCTATG	ATGCATGG
ATGCTCCG	ATGGTCCG
ATCTNAGC	ATCTGAGC
ATGCTGAG	ATCTGAGC
ATGCTGGA	ATGCATGG
ATCTNGAG	ATCTGAGC
ATCCACTC	ATCCCTCT
ATCCAGGC	ATCCTGGC
ATGCTGGG	ATGCATGG
ATGCTGGT	ATGCATGG
ATGCTGGN	ATGCATGG
ATGCTTGG	ATGCATGG
ATCCATCT	ATCCCTCT
ATANCTCT	ATATCTCT
ATAGAACC	GTAGAACC
ATAGAAGA	TAGAAGAG
ATAGAAGT	ATAAAGTC
ATAGAATA	AAGAATAA
ATGTATGG	ATGCATGG
ATGTATTA	ACGTATTA
ATGCNATG	ATGCATGG
ATCCCACT	ATCCCTCT
ATCCCATC	ATCCCTCT
ATAGAGGT	TAGAGGTT
ATAGAGTC	ATAAAGTC
ATCCCCCT	ATCCCTCT
ATCCCCTA	ATCCCTCT
ATCCCCTC	ATCCCTCT
ATCCCCTG	ATCCCTCT
ATCCCCTT	ATCCCTCT
ATCCCCTN	ATCCCTCT
ATCCCGCT	ATCCCTCT
ATGTCATG	ATGCATGG
ATCCCGGC	ATCCTGGC
ATCCCGTC	ATCCCTCT
ATCCCTAC	ATCCCTCT
ATGTCCGA	ATGGTCCG
ATCCCTAT	ATCCCTCT
ATGTCCGC	ATGGTCCG
ATCCCTCA	ATCCCTCT
ATGTCCGG	ATGGTCCG
ATCCCTCC	ATCCCTCT
ATGTCCGT	ATGGTCCG
ATGTCCGN	ATGGTCCG
ATCCCTCG	ATCCCTCT
ATCCCTCT	ATCCCTCT
ATCCCTCN	ATCCCTCT
ATCCCTGC	ATCCCTCT
ATCCCTGG	ATCCTGGC
ATCCCTGT	ATCCCTCT
ATCCCTTA	ATCCCTCT
ATCCCTTC	ATCCCTCT
ATCCCTTG	ATCCCTCT
ATGTCGAC	TGTCGACA
ATCCCTTT	ATCCCTCT
ATCCCTTN	ATCCCTCT
AGNACATT	AGGACATT
ATCCCTNC	ATCCCTCT
ATCCCTNT	ATCCCTCT
ATCCCNCT	ATCCCTCT
ATAGCATG	ATGCATGG
ATCCCNTC	ATCCCTCT
ATGTCTAG	TGTCTAGC
ATGTCTCT	ATATCTCT
ATCNCCTC	ATCCCTCT
ATCCGAGC	ATCTGAGC
ATGCNTGG	ATGCATGG
ATAGCGAC	CTAGCGAC
ATCCGCTC	ATCCCTCT
ATCCGGCA	ATCCTGGC
ATAGCTCT	ATATCTCT
ATCCGGCC	ATCCTGGC
ATCCGGCG	ATCCTGGC
ATCNCTCT	ATCCCTCT
ATCCGGCT	ATCCTGGC
ATCCGGCN	ATCCTGGC
ATCCGGGA	TCCGGGAC
ATCCGGGC	ATCCTGGC
ATCNCTGG	ATCCTGGC
ATCCGGTT	ACCGGTTG
ATCCGTCT	ATCCCTCT
ATCCGTGG	ATCCTGGC
ATCCTAGC	ATCCTGGC
ATCCTAGG	ATCCTGGC
ATGTGAGC	ATCTGAGC
ATGGACAT	AGGACATT
ATANTCTC	ATATCTCT
ATCCTCGC	ATCCTGGC
ATCCTCGG	ATCCTGGC
ATGGACCG	ATGGTCCG
ATCCTCTA	ATCCCTCT
ATCCTCTC	ATCCCTCT
ATCCTCTG	ATCCCTCT
ATCCTCTT	ATCCCTCT
ATCCTCTN	ATCCCTCT
ATGAAACT	ACGAAACT
ATGTGCTG	AAGTGCTG
ATGAAAGT	ATAAAGTC
ATCCTGAC	ATCCTGGC
ATCNGAGC	ATCTGAGC
ATAGGAGT	AAGGAGTG
ATCCTGCA	ATCCTGGC
ATCCTGCC	ATCCTGGC
ATCCTGCG	ATCCTGGC
ATCCTGCT	ATCCTGGC
ATCCTGCN	ATCCTGGC
ATCCTGGA	ATCCTGGC
ATCCTGGC	ATCCTGGC
ATCCTGGG	ATCCTGGC
ATCCTGGT	ATCCTGGC
ATCCTGGN	ATCCTGGC
ATCCTGTC	ATCCTGGC
ATCCTGTG	ATCCTGGC
ATCCTGNC	ATCCTGGC
ATCCTGNG	ATCCTGGC
ATGTGGTG	AAGTGGTG
ATGGAGTG	AAGGAGTG
ATGTGTCC	ATGGTCCG
ATAGGGGA	AAGGGGAC
ATCCTTCT	ATCCCTCT
ATGGATCC	ATGGTCCG
ATGGATGG	ATGCATGG
ATCCTTGC	ATCCTGGC
ATCCTTGG	ATCCTGGC
ATAGGTCC	ATGGTCCG
ATCCTNGC	ATCCTGGC
ATCCTNGG	ATCCTGGC
ATGGCATG	ATGCATGG
ATGGCCAG	ACGGCCAG
ATGGCCCG	ATGGTCCG
ATGGCCGA	ATGGTCCG
ATGGCCGG	ATGGTCCG
ATGGCCGT	ATGGTCCG
ATGGCCGN	ATGGTCCG
ATGAAGTC	ATAAAGTC
ATGGCGAC	TGGCGACT
ATGAATAA	AAGAATAA
ATGGCGTA	TTGGCGTA
ATGAATGG	ATGCATGG
ATGTTCCG	ATGGTCCG
ATGGCTCC	ATGGTCCG
ATGTTCGG	TGTTCGGC
ATTTAGAC	TTTAGACA
ATTTAGCC	TTTTAGCC
ATGACATG	ATGCATGG
ATGACATT	AGGACATT
ATGTTTAA	TTGTTTAA
ATCCNCTC	ATCCCTCT
ATGACGCA	CATGACGC
ATGACGCC	CATGACGC
ATGACGCG	CATGACGC
ATGACGCT	CATGACGC
ATGACGCN	CATGACGC
ATTCCCAG	CTTCCCAG
ATCCNGGC	ATCCTGGC
ATGGGCCG	ATGGTCCG
ATTCCCTA	CATTCCCT
ATTCCCTG	CATTCCCT
ATTCCCTT	CATTCCCT
ATTCCCTN	CATTCCCT
ATGGGGAC	AAGGGGAC
ATCCNTCT	ATCCCTCT
ATCCNTGG	ATCCTGGC
ATGAGAAC	TTGAGAAC
ATTCCTCT	ATCCCTCT
ATAGTCCG	ATGGTCCG
ATTCCTGG	ATCCTGGC
ATCNTGAG	ATCTGAGC
ATGGGTCC	ATGGTCCG
ATAGTCTC	ATATCTCT
ATCNTGGC	ATCCTGGC
ATCGAAAC	ACGAAACT
ATAGTGCT	AAGTGCTG
ATAGTGGT	AAGTGGTG
ATTCGATG	TTCGATGG
ATGGTACC	ATGGTCCG
ATGGTACG	ATGGTCCG
ATGGTCAC	ATGGTCCG
ATGGTCAG	ATGGTCCG
ATGGTCCA	ATGGTCCG
ATGGTCCC	ATGGTCCG
ATGGTCCG	ATGGTCCG
ATGGTCCT	ATGGTCCG
ATGGTCCN	ATGGTCCG
ATGGTCGA	ATGGTCCG
ATGGTCGC	ATGGTCCG
ATGGTCGG	ATGGTCCG
ATGGTCGT	ATGGTCCG
ATGGTCGN	ATGGTCCG
ATGGTCTC	ATGGTCCG
ATGGTCTG	ATGGTCCG
ATGGTCNC	ATGGTCCG
ATGGTCNG	ATGGTCCG
ATGGTGCC	ATGGTCCG
ATGGTGCG	ATGGTCCG
ATTTCTCT	ATATCTCT
ATGGTTCC	ATGGTCCG
ATGGTTCG	ATGGTCCG
ATCGAGCA	ATCTGAGC
ATCGAGCC	ATCTGAGC
ATCGAGCG	ATCTGAGC
ATCGAGCT	ATCTGAGC
ATCGAGCN	ATCTGAGC
ATGGTNCC	ATGGTCCG
ATGGTNCG	ATGGTCCG
ATGAGTCC	ATGGTCCG
ATTTGAGC	ATCTGAGC
ATTCTATA	TTCTATAC
ATCGATCT	ACGATCTG
ATGGNCCG	ATGGTCCG
ATCGATGG	TTCGATGG
ATTCTCTA	ATATCTCT
ATTCTCTC	ATATCTCT
ATTCTCTG	ATATCTCT
ATTCTCTT	ATATCTCT
ATTCTCTN	ATATCTCT
ATNCATGG	ATGCATGG
ATTCTGAG	ATCTGAGC
ATTCTGGC	ATCCTGGC
ATGGNTCC	ATGGTCCG
ATTTGCGT	TTTGCGTC
ATTTGCTG	TTTGCTGA
ATGATAAA	CTGATAAA
ATGNATGG	ATGCATGG
ATGATCCG	ATGGTCCG
ATGATCTC	ATATCTCT
ATGATCTG	ACGATCTG
ATCGCAGC	ACGCAGCC
ATATAAGT	ATAAAGTC
ATGATGGA	ATGCATGG
ATGATGGC	ATGCATGG
ATGATGGG	ATGCATGG
ATCGCCCT	ACGCCCTA
ATGATGGT	ATGCATGG
ATGATGGN	ATGCATGG
ATATACGA	GTATACGA
ATATACTC	ATATCTCT
ATNCCCTC	ATCCCTCT
ATCGCCTC	ATCCCTCT
ATATAGTC	ATAAAGTC
ATGNCATG	ATGCATGG
ATATATCT	ATATCTCT
ATNCCTCT	ATCCCTCT
ATATCACC	AATCACCC
ATCGCTCT	ATCCCTCT
ATTTTAGC	TTTTAGCC
ATATCACT	ATATCTCT
ATCGCTGG	ATCCTGGC
ATNCCTGG	ATCCTGGC
ATATCATA	GATATCAT
ATATCATG	GATATCAT
ATATCATT	GATATCAT
ATATCATN	GATATCAT
ATATCCCT	ATATCTCT
ATATCCTA	ATATCTCT
ATTGAGAA	TTGAGAAC
ATATCCTC	ATATCTCT
ATATCCTG	ATATCTCT
ATTGAGCA	ATCTGAGC
ATTGAGCC	ATCTGAGC
ATATCCTN	ATATCTCT
ATTGAGCG	ATCTGAGC
ATTGAGCT	ATCTGAGC
ATTGAGCN	ATCTGAGC
ATATCGGA	CATATCGG
ATATCGGC	CATATCGG
ATATCGGG	CATATCGG
ATATCGGT	CATATCGG
ATATCGGN	CATATCGG
ATATCGTC	ATATCTCT
ATCGGAGC	ATCTGAGC
ATGCAAGG	ATGCATGG
ATATCTAC	ATATCTCT
ATATCTAT	ATATCTCT
ATGCAATG	ATGCATGG
ATATCTCA	ATATCTCT
ATCGGCCA	ACGGCCAG
ATATCTCC	ATATCTCT
ATATCTCG	ATATCTCT
ATATCTCT	ATATCTCT
ATATCTCN	ATATCTCT
ATATCTGC	ATATCTCT
ATATCTGT	ATATCTCT
ATATCTTA	ATATCTCT
ATATCTTC	ATATCTCT
ATATCTTG	ATATCTCT
ATGCACGG	ATGCATGG
ATATCTTT	ATATCTCT
ATATCTTN	ATATCTCT
ATATCTNC	ATATCTCT
ATGCACTG	ATGCATGG
ATATCTNT	ATATCTCT
ATCGGGGG	TCGGGGGA
ATTTTTTA	CATTTTTT
ATTTTTTC	CATTTTTT
ATTTTTTG	CATTTTTT
ATGCAGCC	ACGCAGCC
ATGCAGGA	ATGCATGG
ATGCAGGC	ATGCATGG
ATGCAGGG	ATGCATGG
ATGCAGGT	ATGCATGG
ATTTTTTN	CATTTTTT
ATGCAGGN	ATGCATGG
ATGCAGTG	ATGCATGG
ATGNGTCC	ATGGTCCG
ATATCNCT	ATATCTCT
ATGCATAG	ATGCATGG
ATATCNTC	ATATCTCT
ATCGGTCC	ATGGTCCG
ATGCATCG	ATGCATGG
ATGCATGA	ATGCATGG
ATCGGTTG	ACCGGTTG
ATGCATGC	ATGCATGG
ATGCATGG	ATGCATGG
ATGCATGT	ATGCATGG
ATGCATGN	ATGCATGG
ATGCATTG	ATGCATGG
ATGCATNG	ATGCATGG
ATGNTCCG	ATGGTCCG
ATGCANGG	ATGCATGG
ATTGCATG	ATGCATGG
ATGCANTG	ATGCATGG
ATNCTGAG	ATCTGAGC
ATNCTGGC	ATCCTGGC
ATTGCGTC	TTTGCGTC
ATGCCACC	TGCCACCG
ATTGCTGA	TTTGCTGA
ATCGTATT	ACGTATTA
ATGCCATG	ATGCATGG
ATCGTCCG	ATGGTCCG
ATGCCCTA	ACGCCCTA
ATGCCCTC	ATCCCTCT
ATCGTGAG	ATCTGAGC
ATGCCGCC	AGGCCGCC
ATCGTGGC	ATCCTGGC
ATGCCTCT	ATCCCTCT
ATGCCTTT	CTGCCTTT
ANAAAGTC	ATAAAGTC
ANACAAGT	ACACAAGT
ATTGGCGT	TTGGCGTA
ATNGTCCG	ATGGTCCG
ATTGGTCC	ATGGTCCG
ATTGTATT	GTTGTATT
ATTGTCCG	ATGGTCCG
ATTAAAGT	ATAAAGTC
ATNGCATG	ATGCATGG
ATTAAGTC	ATAAAGTC
ATTGTTTA	TTGTTTAA
ATTAATTT	ACTAATTT
ATCTAAGC	ATCTGAGC
ANACGCAT	AACGCATG
ATCTAATT	ACTAATTT
ATNGGTCC	ATGGTCCG
ATCTAGAG	ATCTGAGC
ATCTAGCA	ATCTGAGC
ATCTAGCC	ATCTGAGC
ATCTAGCG	ATCTGAGC
ATCTAGCT	ATCTGAGC
ATCTAGCN	ATCTGAGC
ATCTATAC	TTCTATAC
ATNTCTCT	ATATCTCT
ANAATCGC	AAATCGCT
ANCATCCT	ACATCCTT
ATNTGAGC	ATCTGAGC
ATTAGACA	TTTAGACA
ANACTGGG	AACTGGGA
ANGGACAT	AGGACATT
ANGGAGTG	AAGGAGTG
ATTAGCAA	GTTAGCAA
ANGGCCAG	ACGGCCAG
ANGGCCGC	AGGCCGCC
ANGGGGAC	AAGGGGAC
ATTATCTC	ATATCTCT
ANAGAATA	AAGAATAA
ATNAAAGT	ATAAAGTC
ATNAAGTC	ATAAAGTC
ANGGTCCG	ATGGTCCG
ANCACAAG	ACACAAGT
ANCCCTCT	ATCCCTCT
ATTCACCC	AATCACCC
ATTCAGAT	TTCAGATA
ANGTATTA	ACGTATTA
ATTCATGG	ATGCATGG
ANCCGGTT	ACCGGTTG
ANGAAACT	ACGAAACT
ANAGGAGT	AAGGAGTG
ANGAATAA	AAGAATAA
ANGATCTG	ACGATCTG
ANAGGGGA	AAGGGGAC
ANGTGCTG	AAGTGCTG
ANGTGGTG	AAGTGGTG
ANGACATT	AGGACATT
ANCCTGGC	ATCCTGGC
ANAGTGCT	AAGTGCTG
ANAGTGGT	AAGTGGTG
ATNATCTC	ATATCTCT
CAAAAAGC	GAAAAAGC
ANCGAAAC	ACGAAACT
CAAAATGC	CCAAATGC
ANTGCATG	ATGCATGG
CAAACCGA	CAACCGAA
CAAACGAA	CAACCGAA
ANGCAGCC	ACGCAGCC
ANCGATCT	ACGATCTG
ANGCATGG	ATGCATGG
ANCGCAGC	ACGCAGCC
ANCGCATG	AACGCATG
ANTGGTCC	ATGGTCCG
ANCGCCCT	ACGCCCTA
ANGCCCTA	ACGCCCTA
CAAAGTAC	GAAAGTAC
ANGCCGCC	AGGCCGCC
ANATCACC	AATCACCC
CAAATAGG	GAAATAGG
CAAATCGC	AAATCGCT
CAAATCGG	CATATCGG
ANATCCTT	ACATCCTT
CAAATGCA	CCAAATGC
CAAATGCC	CCAAATGC
CAAATGCG	CCAAATGC
CAAATGCT	CCAAATGC
CAAATGCN	CCAAATGC
ANATCGCT	AAATCGCT
ANCGGCCA	ACGGCCAG
ANATCTCT	ATATCTCT
ANCGGTTG	ACCGGTTG
ANCGTATT	ACGTATTA
CAACACGA	CAACCGAA
CAACAGAA	CAACCGAA
ANTAAAGT	ATAAAGTC
CAACCAAA	CAACCGAA
CAACCAAC	CAACCGAA
CAACCAAG	CAACCGAA
CAACCAAT	CAACCGAA
CAACCAAN	CAACCGAA
CAACCAGA	CAACCGAA
CAACCCAA	CAACCGAA
CAACCCGA	CAACCGAA
ANCTAATT	ACTAATTT
CAACCGAA	CAACCGAA
CAACCGAC	CAACCGAA
CAACCGAG	CAACCGAA
CAACCGAT	CAACCGAA
CAACCGAN	CAACCGAA
CAACCGCA	CAACCGAA
CAACCGGA	CAACCGAA
ANTAATTT	ACTAATTT
CAACCGTA	CAACCGAA
CAACCGNA	CAACCGAA
CAACCTAA	CAACCGAA
CAACCTGA	CAACCGAA
CAACCNAA	CAACCGAA
CAACGAAA	CAACCGAA
CAACGAAC	CAACCGAA
CAACGAAG	CAACCGAA
CAACGAAT	CAACCGAA
CAACCNGA	CAACCGAA
CAACGAAN	CAACCGAA
CAACGCAT	AACGCATG
CAACGCGA	CAACCGAA
CAACGCGC	CACGCGCT
CAACGCTG	CGACGCTG
CAGGTGGG	CACGTGGG
CAACGGAA	CAACCGAA
CAGGTTCG	CGGGTTCG
CAGGTTGC	CAGCTTGC
CAACGTGG	CACGTGGG
CAACTCAG	TAACTCAG
ANCTGAGC	ATCTGAGC
CAACTCGA	CAACCGAA
CAACTGAA	CAACCGAA
CAACTGGG	AACTGGGA
CAACTTCA	TCAACTTC
CAACTTCC	TCAACTTC
CAACTTCG	TCAACTTC
ANCTGGGA	AACTGGGA
CAACTTCT	TCAACTTC
CAACTTCN	TCAACTTC
CAACTTGC	CAGCTTGC
CAACNCGA	CAACCGAA
CACNGCGC	CACGCGCT
CAACNGAA	CAACCGAA
CACAAATG	CCAAATGC
CAGTATCG	CATATCGG
CAGTCCCT	CATTCCCT
CACNGTGG	CACGTGGG
CAAGAATA	AAGAATAA
CACAAGTA	ACACAAGT
CACAAGTC	ACACAAGT
CACAAGTG	ACACAAGT
CACAAGTT	ACACAAGT
CACAAGTN	ACACAAGT
CAAGACGA	TCAAGACG
CAAGACGG	TCAAGACG
CAAGACGT	TCAAGACG
CAAGACGN	TCAAGACG
CAGTCTTG	CAGCTTGC
CAAGAGTC	CCAGAGTC
CACACAAG	ACACAAGT
CACCCGAA	CAACCGAA
CACCCGCA	TACCCGCA
CACCCGCT	CACGCGCT
ANTATCTC	ATATCTCT
CAGTGACG	CATGACGC
CACCCTTC	CCCCTTCA
CAAGCCGA	CAACCGAA
CACCGAAA	CAACCGAA
CACCGAAC	CAACCGAA
CACCGAAG	CAACCGAA
CACCGAAT	CAACCGAA
CACCGAAN	CAACCGAA
CAAGCGAA	CAACCGAA
CAAGCGAC	CTAGCGAC
CACNTGGG	CACGTGGG
CAAGCGCT	CACGCGCT
CAGTGCTG	AAGTGCTG
CACCGCGC	CACGCGCT
CACCGCTA	CACGCGCT
CACCGCTC	CACGCGCT
CACCGCTG	CACGCGCT
CACCGCTT	CACGCGCT
CACCGCTN	CACGCGCT
CAAGCTTG	CAGCTTGC
CACACCGA	CAACCGAA
CACCGGTT	ACCGGTTG
CAGTGGGA	CACGTGGG
CAGTGGGC	CACGTGGG
CACACGCT	CACGCGCT
CAGTGGGG	CACGTGGG
CAGTGGGT	CACGTGGG
CAGTGGGN	CACGTGGG
CAGTGGTG	AAGTGGTG
CAAGGAGT	AAGGAGTG
CAGTGTCC	CGTGTCCA
CACCGTGG	CACGTGGG
CACACTAC	CTCACTAC
CAAGGGGA	AAGGGGAC
CACCTGGG	CACGTGGG
CAGTTCCA	CGTTCCAA
CAGTTCCC	CATTCCCT
CACCTTCA	CCCCTTCA
CACCTTGC	CAGCTTGC
CACAGAGT	CCAGAGTC
CAGTTGCA	CAGCTTGC
CAGTTGCC	CAGCTTGC
CAGTTGCG	CAGCTTGC
CAGTTGCT	CAGCTTGC
CAGTTGCN	CAGCTTGC
CACAGCGC	CACGCGCT
CAGTTTGC	CAGCTTGC
CAGAACAT	CCGAACAT
CAGTTTTT	CATTTTTT
CAGAAGAG	TAGAAGAG
CACAGTGG	CACGTGGG
CACAGTTA	GACAGTTA
CAAGTGCT	AAGTGCTG
CAGAATAA	AAGAATAA
CAAGTGGG	CACGTGGG
CAAGTGGT	AAGTGGTG
CACATCCT	ACATCCTT
ANTCACCC	AATCACCC
CACATCGG	CATATCGG
CAGACCGA	CAACCGAA
CACGAAAC	ACGAAACT
CACATGGG	CACGTGGG
CACGAACA	CCGAACAT
CAGACGCA	CATGACGC
CAGACGCC	CATGACGC
CAGACGCG	CATGACGC
CAGACGCN	CATGACGC
CAGACTTG	CAGCTTGC
CACGAGCT	CACGCGCT
CACGAGGG	CACGTGGG
CACGATCT	ACGATCTG
CACGATGG	CACGTGGG
CACGATTA	CCGATTAA
CACGCACT	CACGCGCT
CAGAGGTT	TAGAGGTT
CACGCATG	AACGCATG
CAGAGTCA	CCAGAGTC
CAGAGTCC	CCAGAGTC
CAGAGTCG	CCAGAGTC
CAGAGTCT	CCAGAGTC
CAGAGTCN	CCAGAGTC
CAGATAAA	CTGATAAA
CACGCCGC	CACGCGCT
CACGCCTA	CACGCGCT
CACGCCTC	CACGCGCT
CACGCCTG	CACGCGCT
CACGCCTT	CACGCGCT
CACGCCTN	CACGCGCT
ANTCCCTC	ATCCCTCT
CACGCGAC	CACGCGCT
CACGCGAT	CACGCGCT
CACGCGCA	CACGCGCT
CACGCGCC	CACGCGCT
CACGCGCG	CACGCGCT
CACGCGCT	CACGCGCT
CACGCGCN	CACGCGCT
CACGCGGC	CACGCGCT
CACGCGGG	CACGTGGG
CACGCGGT	CACGCGCT
CACGCGTA	CACGCGCT
CACGCGTC	CACGCGCT
CACGCGTG	CACGCGCT
CACGCGTT	CACGCGCT
CACGCGTN	CACGCGCT
CACGCGNC	CACGCGCT
CACGCGNT	CACGCGCT
ANTCCTGG	ATCCTGGC
CAGATCGG	CATATCGG
CACGCTCT	CACGCGCT
CACGCTGA	CGACGCTG
CACGCTGT	CGACGCTG
CACGCTGN	CGACGCTG
CACGCTTG	CAGCTTGC
CAGNCTTG	CAGCTTGC
CACGCNCT	CACGCGCT
CACGCNGC	CACGCGCT
CCAAGACG	TCAAGACG
CAGATTAA	CCGATTAA
CAGATTGC	CAGCTTGC
CCAAGAGT	CCAGAGTC
CCAAGATG	CCAAATGC
CACGGCCA	ACGGCCAG
CACGGCGC	CACGCGCT
CACGGCTA	CACGCGCT
CACGGCTC	CACGCGCT
CACGGCTG	CACGCGCT
CACGGCTT	CACGCGCT
CACGGCTN	CACGCGCT
CACGGGCT	CACGCGCT
CACGGGGA	CACGTGGG
CACGGGGC	CACGTGGG
CACGGGGG	CACGTGGG
CACGGGGT	CACGTGGG
CACGGGGN	CACGTGGG
CACGGTGG	CACGTGGG
CACGTAGG	CACGTGGG
CACGTATT	ACGTATTA
CCAAGTCA	CCAGAGTC
CCAAGTCC	CCAGAGTC
CCAAGTCG	CCAGAGTC
CCAAGTCT	CCAGAGTC
CCAAGTCN	CCAGAGTC
CCAAGTGC	CCAAATGC
CACGTCGC	CACGCGCT
CACGTCGG	CACGTGGG
CACGTGAG	CACGTGGG
CACGTGCG	CACGTGGG
CACGTGCT	CACGCGCT
CACGTGGA	CACGTGGG
CACGTGGC	CACGTGGG
CACGTGGG	CACGTGGG
CACGTGGT	CACGTGGG
CACGTGGN	CACGTGGG
CACGTGTG	CACGTGGG
CACGTGNG	CACGTGGG
ANTCTGAG	ATCTGAGC
CACGTTGG	CACGTGGG
CATGGACG	CATGACGC
CCAATATG	CCAAATGC
CACGTNGG	CACGTGGG
CANGCGCT	CACGCGCT
CATGGCGC	CATGACGC
CCAATGCA	CCAAATGC
CCAATGCC	CCAAATGC
CCAATGCG	CCAAATGC
CCAATGCT	CCAAATGC
CCAATGCN	CCAAATGC
CCAATTAA	CCGATTAA
CATNACGC	CATGACGC
CCAATTGC	CCAAATGC
CATGGTCC	ATGGTCCG
CANGCTTG	CAGCTTGC
CATNATCG	CATATCGG
CCAANATG	CCAAATGC
CATGTACG	CATGACGC
CATGTCCA	CGTGTCCA
CATGTCCC	CATTCCCT
CATGTCGC	CATGACGC
CATGTCGG	CATATCGG
CATNCCCT	CATTCCCT
CCAANTGC	CCAAATGC
CAGNTTGC	CAGCTTGC
CATGTGGG	CACGTGGG
CAATATCG	CATATCGG
CCACAAGT	ACACAAGT
CCACAATG	CCAAATGC
CAGCATGC	CAGCTTGC
CATGTTTT	CATTTTTT
CATNGACG	CATGACGC
CAGCATTG	CAGCTTGC
CCACAGTC	CCAGAGTC
CCACATGC	CCAAATGC
CATGNACG	CATGACGC
CAATCACC	AATCACCC
CATGNCGC	CATGACGC
CANGTGGG	CACGTGGG
CCACCGAA	CAACCGAA
CAGCCGAA	CAACCGAA
CAATCCCT	CATTCCCT
CAATCCGA	CAACCGAA
CAATCGAA	CAACCGAA
CAATCGAT	TAATCGAT
CAGCCTGC	CAGCTTGC
CCACCTTC	CCCCTTCA
CAATCGCT	AAATCGCT
CAGCCTTG	CAGCTTGC
CAATCGGA	CATATCGG
CAGCCTTT	CTGCCTTT
CAATCGGC	CATATCGG
CAATCGGG	CATATCGG
CAATCGGT	CATATCGG
CAATCGGN	CATATCGG
CATNTCCC	CATTCCCT
CATNTCGG	CATATCGG
CAGCGACA	CTAGCGAC
CAGCGACC	CTAGCGAC
CAGCGACG	CTAGCGAC
CAGCGACT	CTAGCGAC
CAGCGACN	CTAGCGAC
CCACGAGT	CCAGAGTC
CAGCGCGC	CACGCGCT
CCACGCGC	CACGCGCT
CAGCGCTA	CACGCGCT
CAGCGCTC	CACGCGCT
CAGCGCTG	CACGCGCT
CAGCGCTT	CACGCGCT
CAGCGCTN	CACGCGCT
CCACGCTG	CGACGCTG
CAATGACG	CATGACGC
CATNTTTT	CATTTTTT
CCACGGTA	CCTACGGT
CCACGGTC	CCTACGGT
CCACGGTG	CCTACGGT
CCACGGTT	CCTACGGT
CCACGGTN	CCTACGGT
CATTACCC	CATTCCCT
CATTACCT	CATTCCCT
CATTACGC	CATGACGC
CATAAAGT	ATAAAGTC
CAGCGTGC	CAGCTTGC
CAGCGTGG	CACGTGGG
CCACGTGG	CACGTGGG
CAGCGTTG	CAGCTTGC
CCACTACA	CTCACTAC
CCACTACC	CTCACTAC
CCACTACG	CTCACTAC
CCACTACT	CTCACTAC
CCACTACN	CTCACTAC
CATTATCG	CATATCGG
CACGNCGC	CACGCGCT
CATAACGC	CATGACGC
CATAACGG	CATATCGG
CATTATTT	CATTTTTT
CACGNGCT	CACGCGCT
CACGNGGG	CACGTGGG
CACGNTGG	CACGTGGG
CCACTTCA	CCCCTTCA
CAGCTAGC	CAGCTTGC
CATTCACC	CATTCCCT
CATTCACT	CATTCCCT
CAGCTATG	CAGCTTGC
CACTAATT	ACTAATTT
CAGCTCGC	CAGCTTGC
CACTACGG	CCTACGGT
CAGCTCTG	CAGCTTGC
CATAATCG	CATATCGG
CANTATCG	CATATCGG
CAGCTGCA	CAGCTTGC
CAGCTGCC	CAGCTTGC
CAGCTGCG	CAGCTTGC
CACTATCG	CATATCGG
CAGCTGCT	CAGCTTGC
CATTCCAA	CGTTCCAA
CAGCTGCN	CAGCTTGC
CATTCCAC	CATTCCCT
CAGCTGGC	CAGCTTGC
CATTCCAT	CATTCCCT
CACTATGT	GACTATGT
CATTCCCC	CATTCCCT
CAGCTGTG	CAGCTTGC
CATTCCCG	CATTCCCT
CATTCCCT	CATTCCCT
CATTCCCN	CATTCCCT
CATTCCGC	CATTCCCT
CAGCTTAC	CAGCTTGC
CAGCTTAG	CAGCTTGC
CAGCTTCA	CAGCTTGC
CATTCCGT	CATTCCCT
CATTCCTA	CATTCCCT
CATTCCTC	CATTCCCT
CATTCCTG	CATTCCCT
CATTCCTT	CATTCCCT
CATTCCTN	CATTCCCT
CATTCCNC	CATTCCCT
CAGCTTCC	CAGCTTGC
CAGCTTCG	CAGCTTGC
CAGCTTCT	CAGCTTGC
CAGCTTCN	CAGCTTGC
CAGCTTGA	CAGCTTGC
CAGCTTGC	CAGCTTGC
CAGCTTGG	CAGCTTGC
CAGCTTGT	CAGCTTGC
CAGCTTGN	CAGCTTGC
CAGCTTTC	CAGCTTGC
CATTCCNT	CATTCCCT
CAGCTTTG	CAGCTTGC
CAGCTTNC	CAGCTTGC
CAGCTTNG	CAGCTTGC
CANTCCCT	CATTCCCT
CATTCGCC	CATTCCCT
CATTCGCT	CATTCCCT
CATTCGGA	CATATCGG
CAGCTNGC	CAGCTTGC
CATACCCT	CATTCCCT
CATACCGA	CAACCGAA
CATTCGGC	CATATCGG
CATTCGGG	CATATCGG
CATACCGG	CATATCGG
CATTCGGT	CATATCGG
CATTCGGN	CATATCGG
CAATTCCC	CATTCCCT
CAGCTNTG	CAGCTTGC
CACTCCCT	CATTCCCT
CATACGCA	CATGACGC
CATACGCC	CATGACGC
CATACGCG	CATGACGC
CATACGCT	CATGACGC
CATACGCN	CATGACGC
CATTCTCC	CATTCCCT
CATTCTCT	CATTCCCT
CATACGGA	CATATCGG
CATACGGC	CATATCGG
CATACGGG	CATATCGG
CATACGGN	CATATCGG
CACTCGCT	CACGCGCT
CATTCTTT	CATTTTTT
CATTCNCC	CATTCCCT
CATTCNCT	CATTCCCT
CATACTCG	CATATCGG
CACTGACG	CATGACGC
CAATTTTC	GAATTTTC
CAATTTTT	CATTTTTT
CATTGACG	CATGACGC
CANTGACG	CATGACGC
CATTGCCC	CATTCCCT
CATTGCCT	CATTCCCT
CACTGCGC	CACGCGCT
CATAGACG	CATGACGC
CAGCNTGC	CAGCTTGC
CAGCNTTG	CAGCTTGC
CATAGCGA	CTAGCGAC
CANACCGA	CAACCGAA
CACTGGGC	CACGTGGG
CACTGGGG	CACGTGGG
CACTGGGT	CACGTGGG
CACTGGGN	CACGTGGG
CATAGCGG	CATATCGG
CACTGTGG	CACGTGGG
CAGGACAT	AGGACATT
CATTGTTT	CATTTTTT
CAGGACGC	CATGACGC
CAGGAGTG	AAGGAGTG
CCGTGGGA	CACGTGGG
CCGTGGGC	CACGTGGG
CCGTGGGG	CACGTGGG
CCGTGGGT	CACGTGGG
CCGTGGGN	CACGTGGG
CATAGTCG	CATATCGG
CACTTCCC	CATTCCCT
CCGTGTCC	CGTGTCCA
CATTTATT	CATTTTTT
CACTTGCA	CAGCTTGC
CACTTGCC	CAGCTTGC
CACTTGCG	CAGCTTGC
CAGGCCGC	AGGCCGCC
CACTTGCT	CAGCTTGC
CACTTGCN	CAGCTTGC
CACTTGGG	CACGTGGG
CATTTCCC	CATTCCCT
CATTTCCT	CATTCCCT
CAGGCGCT	CACGCGCT
CATTTCGG	CATATCGG
CATTTCTT	CATTTTTT
CCGTTAAA	CCGATTAA
CATATACG	CATATCGG
CCGTTAAG	CCGATTAA
CCGTTAAT	CCGATTAA
CCGTTAAN	CCGATTAA
CATATAGG	CATATCGG
CANTTCCC	CATTCCCT
CAGGCTTG	CAGCTTGC
CATATCAG	CATATCGG
CATATCAT	GATATCAT
CATATCCC	CATTCCCT
CATATCCG	CATATCGG
CATATCGA	CATATCGG
CCGTTCCA	CGTTCCAA
CATATCGC	CATATCGG
CATATCGG	CATATCGG
CATATCGT	CATATCGG
CACTTTTT	CATTTTTT
CATTTGTT	CATTTTTT
CATATCGN	CATATCGG
CATATCTC	ATATCTCT
CATATCTG	CATATCGG
CATATCNG	CATATCGG
CATTTTAT	CATTTTTT
CATATGCG	CATATCGG
CATATGGA	CATATCGG
CCGTTTAA	CCGATTAA
CATATGGC	CATATCGG
CATATGGG	CATATCGG
CATATGGT	CATATCGG
CATATGGN	CATATCGG
CATATTCG	CATATCGG
CATTTTCT	CATTTTTT
CATATTGG	CATATCGG
CATTTTGT	CATTTTTT
CATATTTT	CATTTTTT
CATTTTTA	CATTTTTT
CATTTTTC	CATTTTTT
CAGGGGAC	AAGGGGAC
CATTTTTG	CATTTTTT
CATTTTTT	CATTTTTT
CATTTTTN	CATTTTTT
CATTTTNT	CATTTTTT
CATATNCG	CATATCGG
CATATNGG	CATATCGG
CAGGGTTC	CGGGTTCG
CATTTNTT	CATTTTTT
CCAGAACA	CCGAACAT
CCAGAAGT	CCAGAGTC
CCAGAATC	CCAGAGTC
CCAGAATG	CCAAATGC
CANTTTTT	CATTTTTT
CCCCNTCA	CCCCTTCA
CCAGACGT	CCAGAGTC
CCCCNTTC	CCCCTTCA
CCAGACTC	CCAGAGTC
CATTNCCC	CATTCCCT
CCAGAGAC	CCAGAGTC
CATTNCCT	CATTCCCT
CCAGAGAT	CCAGAGTC
CCAGAGCA	CCAGAGTC
CCAGAGCC	CCAGAGTC
CCAGAGCG	CCAGAGTC
CCAGAGCT	CCAGAGTC
CCAGAGCN	CCAGAGTC
CCAGAGGC	CCAGAGTC
CCAGAGGT	CCAGAGTC
CCAGAGTA	CCAGAGTC
CCAGAGTC	CCAGAGTC
CCAGAGTG	CCAGAGTC
CCAGAGTT	CCAGAGTC
CCAGAGTN	CCAGAGTC
CCGAAAAT	CCGAACAT
CCGNAACA	CCGAACAT
CCGAAACA	CCGAACAT
CCCGAACA	CCGAACAT
CCAGAGNC	CCAGAGTC
CCGAAACT	ACGAAACT
CCGAAATA	CCGAACAT
CCGAAATC	CCGAACAT
CCAGAGNT	CCAGAGTC
CCGAAATT	CCGAACAT
CCGAAATN	CCGAACAT
CCGAACAA	CCGAACAT
CCGAACAC	CCGAACAT
CCGAACAG	CCGAACAT
CCGAACAT	CCGAACAT
CCGNACAT	CCGAACAT
CCGAACAN	CCGAACAT
CCGAACCA	CCGAACAT
CCAGATCA	CCAGAGTC
CCAGATCC	CCAGAGTC
CCAGATCG	CCAGAGTC
CCGAACCT	CCGAACAT
CCAGATCT	CCAGAGTC
CCAGATCN	CCAGAGTC
CCGAACGA	CCGAACAT
CCAGATGC	CCAAATGC
CCGAACGT	CCGAACAT
CCAGATGT	CCAGAGTC
CCGAACTA	CCGAACAT
CCAGATTA	CCGATTAA
CCGAACTC	CCGAACAT
CCAGATTC	CCAGAGTC
CCGAACTG	CCGAACAT
CCGAACTT	CCGAACAT
CCGAACTN	CCGAACAT
CCGAACNA	CCGAACAT
CCGAACNT	CCGAACAT
CCGAAGAT	CCGAACAT
CCGAAGCA	CCGAACAT
CCGAATAA	CCGATTAA
CCGAATAT	CCGAACAT
CCGAATCA	CCGAACAT
CCCGAGTC	CCAGAGTC
CCGAATGC	CCAAATGC
CCGAATTA	CCGATTAA
CATTNTTT	CATTTTTT
CCGNATTA	CCGATTAA
CCAGANGT	CCAGAGTC
CCAGANTC	CCAGAGTC
CCCGATTA	CCGATTAA
CCGAANAT	CCGAACAT
CCGAANCA	CCGAACAT
CCAGCAGT	CCAGAGTC
CCGACACA	CCGAACAT
CCAGCGAC	CTAGCGAC
CAANCCGA	CAACCGAA
CCGACATA	CCGAACAT
CCGACATC	CCGAACAT
CCAGCGTC	CCAGAGTC
CCGACATG	CCGAACAT
CCGACATT	CCGAACAT
CCGACATN	CCGAACAT
CCGACCAT	CCGAACAT
CCCACGGT	CCTACGGT
CCAGCTTG	CAGCTTGC
CCCACTAC	CTCACTAC
CAANCGAA	CAACCGAA
CCCACTTC	CCCCTTCA
CCCGCGCT	CACGCGCT
CCGACGCT	CGACGCTG
CCGACGGT	CCTACGGT
CCGACTAA	CCGATTAA
CCGACTTA	CCGATTAA
CCCAGAGT	CCAGAGTC
CCAGGAGT	CCAGAGTC
CCCGCTTC	CCCCTTCA
CCGAGACA	CCGAACAT
CCGAGAGT	CCAGAGTC
CCGAGCAT	CCGAACAT
CCCAGTCA	GCCCAGTC
CCCAGTCC	GCCCAGTC
CCCAGTCG	GCCCAGTC
CCCAGTCT	GCCCAGTC
CCCAGTCN	GCCCAGTC
CCAGGGTC	CCAGAGTC
CCAGGTCA	CCAGAGTC
CCAGGTCC	CCAGAGTC
CCAGGTCG	CCAGAGTC
CACNCGCT	CACGCGCT
CCAGGTCT	CCAGAGTC
CCAGGTCN	CCAGAGTC
CCGAGTAA	CCGATTAA
CCGAGTCA	CCAGAGTC
CCGAGTCC	CCAGAGTC
CCGAGTCG	CCAGAGTC
CCGAGTCT	CCAGAGTC
CCGAGTCN	CCAGAGTC
CCGAGTTA	CCGATTAA
CCGATAAC	CCGATTAA
CCGATAAG	CCGATTAA
CCGATAAT	CCGATTAA
CCGATAAN	CCGATTAA
CCAGTAGT	CCAGAGTC
CCGATACA	CCGAACAT
CCCGGGAC	TCCGGGAC
CCGATATA	CCGATTAA
CCGATCAA	CCGATTAA
CCGNTTAA	CCGATTAA
CCGATCAT	CCGAACAT
CCGATCTA	CCGATTAA
CCGATCTG	ACGATCTG
CCGATGAA	CCGATTAA
CCGATGTA	CCGATTAA
CCAGTGTC	CCAGAGTC
CANATCGG	CATATCGG
CCGATTAA	CCGATTAA
CCGATTAC	CCGATTAA
CCGATTAG	CCGATTAA
CCGATTAT	CCGATTAA
CCGATTAN	CCGATTAA
CCGATTCA	CCGATTAA
CCCATTAA	CCGATTAA
CCGATTGA	CCGATTAA
CCCATTCA	CCCCTTCA
CCGATTTA	CCGATTAA
CCGATTNA	CCGATTAA
CCGATNAA	CCGATTAA
CCCGGTTG	ACCGGTTG
CATANCGG	CATATCGG
CCGATNTA	CCGATTAA
CCGANACA	CCGAACAT
CGACACTG	CGACGCTG
CCGANCAT	CCGAACAT
CCAGNAGT	CCAGAGTC
CGACAGCT	CGACGCTG
CGACAGTT	GACAGTTA
CCGANTAA	CCGATTAA
CCCGTGGG	CACGTGGG
CCGANTTA	CCGATTAA
CCAGNGTC	CCAGAGTC
CCCGTTCA	CCCCTTCA
CATANTCG	CATATCGG
CCGCAACA	CCGAACAT
CGACCCTG	CGACGCTG
CGACCGAA	CAACCGAA
CCGCACAT	CCGAACAT
CGACCGCT	CGACGCTG
CGACCTGA	CGACGCTG
CCCCAGTC	GCCCAGTC
CGACCTGC	CGACGCTG
CGACCTGG	CGACGCTG
CGACCTGT	CGACGCTG
CGACCTGN	CGACGCTG
CCGCAGCC	ACGCAGCC
CCCCATCA	CCCCTTCA
CCATAATG	CCAAATGC
CATCACCC	AATCACCC
CCCCATTC	CCCCTTCA
CATCACGC	CATGACGC
CATCACTA	CTCACTAC
CCATACGG	CCTACGGT
CGACGACT	CGACGCTG
CGACGATG	CGACGCTG
CGACGCAG	CGACGCTG
CGACGCAT	CGACGCTG
CATCATCG	CATATCGG
CGACGCCG	CGACGCTG
CGACGCCT	CGACGCTG
CGACGCGA	CGACGCTG
CGACGCGG	CGACGCTG
CGACGCGT	CGACGCTG
CGACGCGN	CGACGCTG
CCGCATTA	CCGATTAA
CGACGCTA	CGACGCTG
CGACGCTC	CGACGCTG
CGACGCTG	CGACGCTG
CGACGCTT	CGACGCTG
CGACGCTN	CGACGCTG
CCATAGTC	CCAGAGTC
CGACGCNG	CGACGCTG
CGACGCNT	CGACGCTG
CCCTACGG	CCTACGGT
CCATATCG	CATATCGG
CGACGGCT	CGACGCTG
CGACGGTG	CGACGCTG
CCATATGC	CCAAATGC
CGACGTCT	CGACGCTG
CGACGTGA	CGACGCTG
CGACGTGC	CGACGCTG
CGACGTGT	CGACGCTG
CGACGTGN	CGACGCTG
CCCCCTCA	CCCCTTCA
CGACGTTG	CGACGCTG
CATCCCAG	CTTCCCAG
CATCCCCT	CATTCCCT
CGACGNCT	CGACGCTG
CATCCCTA	CATTCCCT
CATCCCTG	CATTCCCT
CATCCCTT	CATTCCCT
CATCCCTN	CATTCCCT
CATCCGAA	CAACCGAA
CCCCCTTC	CCCCTTCA
CGACGNTG	CGACGCTG
CATCCTGG	ATCCTGGC
CATCCTTA	ACATCCTT
CATCCTTC	ACATCCTT
CATCCTTG	ACATCCTT
CATCCTTT	ACATCCTT
CATCCTTN	ACATCCTT
CCGCCCTA	ACGCCCTA
CGACTATG	GACTATGT
CCATCCTT	ACATCCTT
CGACTCTG	CGACGCTG
CATCGACG	CATGACGC
CATCGCGC	CACGCGCT
CGACTGCT	CGACGCTG
CCGCCTTC	CCCCTTCA
CCGCCTTT	CTGCCTTT
CATCGTGG	CACGTGGG
CCCTCTTC	CCCCTTCA
CCATGACG	CATGACGC
CCCCGTCA	CCCCTTCA
CCATGAGT	CCAGAGTC
CANCCGAA	CAACCGAA
CCCCGTTC	CCCCTTCA
CGACNCTG	CGACGCTG
CATCTCCC	CATTCCCT
CATCTCGG	CATATCGG
CGACNGCT	CGACGCTG
CCCCTACA	CCCCTTCA
CATCTGAG	ATCTGAGC
CCCCTATC	CCCCTTCA
CCGCGCTA	CACGCGCT
CCGCGCTC	CACGCGCT
CCGCGCTG	CACGCGCT
CCGCGCTT	CACGCGCT
CCCCTCAA	CCCCTTCA
CCGCGCTN	CACGCGCT
CCCCTCAC	CCCCTTCA
CCCCTCAG	CCCCTTCA
CCCCTCAT	CCCCTTCA
CCCCTCAN	CCCCTTCA
CCCCTCCA	CCCCTTCA
CCCCTCTC	CCCCTTCA
CCCCTGCA	CCCCTTCA
CATCTTGC	CAGCTTGC
CATCTTTT	CATTTTTT
CCCCTGTC	CCCCTTCA
CCCCTTAA	CCCCTTCA
CCCCTTAC	CCCCTTCA
CCCCTTAG	CCCCTTCA
CCCCTTAT	CCCCTTCA
CCCCTTAN	CCCCTTCA
CCCCTTCA	CCCCTTCA
CCCCTTCC	CCCCTTCA
CCCCTTCG	CCCCTTCA
CCCCTTCT	CCCCTTCA
CCCCTTCN	CCCCTTCA
CCCCTTGA	CCCCTTCA
CCCCTTGC	CCCCTTCA
CCAAAAGC	CCAAATGC
CCCCTTTA	CCCCTTCA
CCCCTTTC	CCCCTTCA
CCCCTTNA	CCCCTTCA
CCCCTTNC	CCCCTTCA
CCCCTNCA	CCCCTTCA
CCAAAATG	CCAAATGC
CCCCTNTC	CCCCTTCA
CCAAACAT	CCGAACAT
CANCGCGC	CACGCGCT
CCAAACGC	CCAAATGC
CCAAACTG	CCAAATGC
CGAGAGTC	CCAGAGTC
CCAAAGCA	CCAAATGC
CCAAAGCC	CCAAATGC
CCAAAGCG	CCAAATGC
CCAAAGCT	CCAAATGC
CCAAAGCN	CCAAATGC
CCAAAGGC	CCAAATGC
CCAAAGTC	CCAGAGTC
CCAAAGTG	CCAAATGC
CCNAAATG	CCAAATGC
CCAAATAC	CCAAATGC
CCAAATAG	CCAAATGC
CCNAACAT	CCGAACAT
CCAAATCA	CCAAATGC
CCAAATCC	CCAAATGC
CCAAATCG	CCAAATGC
CCAAATCT	CCAAATGC
CCAAATCN	CCAAATGC
CCAAATGA	CCAAATGC
CCAAATGC	CCAAATGC
CCAAATGG	CCAAATGC
CCAAATGT	CCAAATGC
CCAAATGN	CCAAATGC
CATGAACG	CATGACGC
CCAAATTC	CCAAATGC
CCAAATTG	CCAAATGC
CATGAAGC	CATGACGC
CANCGTGG	CACGTGGG
CATGACAC	CATGACGC
CCAAATNC	CCAAATGC
CATGACAG	CATGACGC
CCAAATNG	CCAAATGC
CATGACCA	CATGACGC
CATGACCC	CATGACGC
CATGACCG	CATGACGC
CATGACCT	CATGACGC
CATGACCN	CATGACGC
CATGACGA	CATGACGC
CATGACGC	CATGACGC
CATGACGG	CATGACGC
CATGACGT	CATGACGC
CATGACGN	CATGACGC
CGAGCGAC	CTAGCGAC
CCAAANGC	CCAAATGC
CATGACTC	CATGACGC
CATGACTG	CATGACGC
CGAGCGCT	CGACGCTG
CATGACNC	CATGACGC
CATGACNG	CATGACGC
CATGAGCA	CATGACGC
CATGAGCC	CATGACGC
CATGAGCG	CATGACGC
CATGAGCT	CATGACGC
CCAAANTG	CCAAATGC
CCNAATGC	CCAAATGC
CATGAGCN	CATGACGC
CATGAGGC	CATGACGC
CCTTCCAA	CGTTCCAA
CCAACATA	CCGAACAT
CCNTACGG	CCTACGGT
CATGATAA	CTGATAAA
CCTTCCCA	CTTCCCAG
CCTTCCCT	CATTCCCT
CGAGCTGA	CGACGCTG
CGAGCTGC	CGACGCTG
CGAGCTGG	CGACGCTG
CATGATGC	CATGACGC
CCTAAATG	CCAAATGC
CCAACATC	CCGAACAT
CCAACATT	CCGAACAT
CCAACATN	CCGAACAT
CGAGCTGT	CGACGCTG
CGAGCTGN	CGACGCTG
CGAGCTTG	CAGCTTGC
CCTAACAT	CCGAACAT
CATGANCG	CATGACGC
CATGANGC	CATGACGC
CCTAACGG	CCTACGGT
CCAACCGA	CAACCGAA
CATGCACG	CATGACGC
CCTTCGGT	CCTACGGT
CATGCATG	ATGCATGG
CANCTTGC	CAGCTTGC
CATGCCCT	CATTCCCT
CATGCCGC	CATGACGC
CCTAAGGT	CCTACGGT
CATGCCTT	CTGCCTTT
CCAACGGT	CCTACGGT
CATGCGCA	CATGACGC
CATGCGCC	CATGACGC
CATGCGCG	CATGACGC
CCTAATGC	CCAAATGC
CATGCGCN	CATGACGC
CCTAATTT	ACTAATTT
CCAACTGC	CCAAATGC
CCNACGGT	CCTACGGT
CCAACTTC	TCAACTTC
CATGCTTG	CAGCTTGC
CCATTAAA	CCGATTAA
CCATTAAC	CCGATTAA
CCATTAAG	CCGATTAA
CCATTAAT	CCGATTAA
CCATTAAN	CCGATTAA
CCTACAGG	CCTACGGT
CCTACAGT	CCTACGGT
CCNAGAGT	CCAGAGTC
CGAGGCTG	CGACGCTG
CCATTCCC	CATTCCCT
CCTACCGG	CCTACGGT
CCTACCGT	CCTACGGT
CCTACGAG	CCTACGGT
CCTACGAT	CCTACGGT
CCTACGCG	CCTACGGT
CCTACGCT	CCTACGGT
CCTACGGA	CCTACGGT
CCTACGGC	CCTACGGT
CCTACGGG	CCTACGGT
CCTACGGT	CCTACGGT
CCTACGGN	CCTACGGT
CCTACGTA	CCTACGGT
CCTACGTC	CCTACGGT
CCTACGTG	CCTACGGT
CCTACGTT	CCTACGGT
CCTACGTN	CCTACGGT
CCTACGNG	CCTACGGT
CCTACGNT	CCTACGGT
CGAGGTTC	CGGGTTCG
CCTACTGG	CCTACGGT
CCTACTGT	CCTACGGT
CCATTTTT	CATTTTTT
CCGCTTAA	CCGATTAA
CCGCTTCA	CCCCTTCA
CCGCTTGC	CAGCTTGC
CANGACGC	CATGACGC
CCTACNGG	CCTACGGT
CCTACNGT	CCTACGGT
CCTAGAGT	CCAGAGTC
CCTAGCGA	CTAGCGAC
CCTAGCGG	CCTACGGT
CCTAGGGT	CCTACGGT
CCTAGGTA	CCTACGGT
CCTTTACC	GCTTTACC
CCTAGGTC	CCTACGGT
CCTAGGTG	CCTACGGT
CCTAGGTT	CCTACGGT
CCTAGGTN	CCTACGGT
CCNATTAA	CCGATTAA
CCTTTGTA	TCTTTGTA
CCTTTTTT	CATTTTTT
CCTATGGT	CCTACGGT
CCGGAACA	CCGAACAT
CCTATTAA	CCGATTAA
CCANAATG	CCAAATGC
CCGGACAT	CCGAACAT
CCGGAGTC	CCAGAGTC
CCGGATTA	CCGATTAA
CCANAGTC	CCAGAGTC
CCTANCGG	CCTACGGT
CCGGCCAG	ACGGCCAG
CCCTTCAA	CCCCTTCA
CCCTTCAC	CCCCTTCA
CCCTTCAG	CCCCTTCA
CCCTTCAT	CCCCTTCA
CCCTTCAN	CCCCTTCA
CCTANGGT	CCTACGGT
CCANATGC	CCAAATGC
CCCTTTCA	CCCCTTCA
CCGGGACA	TCCGGGAC
CCGGGACC	TCCGGGAC
CCGGGACG	TCCGGGAC
CCGGGACT	TCCGGGAC
CCGGGACN	TCCGGGAC
CCGGGGGA	TCGGGGGA
CCTNACGG	CCTACGGT
CCGGGTTC	CGGGTTCG
CCTCACGG	CCTACGGT
CCTCACTA	CTCACTAC
CCANGAGT	CCAGAGTC
CGGNGTTC	CGGGTTCG
CCTCCCAG	CTTCCCAG
CCGGTTAA	CCGATTAA
CCTCCGGT	CCTACGGT
CCGGTTCG	CGGGTTCG
CCGGTTGA	ACCGGTTG
CCGGTTGC	ACCGGTTG
CCTNCGGT	CCTACGGT
CCGGTTGG	ACCGGTTG
CCGGTTGT	ACCGGTTG
CCGGTTGN	ACCGGTTG
CCTCCTTC	CCCCTTCA
CGGATAAA	CTGATAAA
CGCGGGTT	TGCGGGTT
CGAGTCCA	CGTGTCCA
CGCGGTTC	CGGGTTCG
CGGATGAA	GGATGAAC
CGGATTAA	CCGATTAA
CGGNTTCG	CGGGTTCG
CGGATTCG	CGGGTTCG
CGAGTTCG	CGGGTTCG
CGCGTAAA	GCGTAAAT
CCGTAAAT	GCGTAAAT
CCGTAACA	CCGAACAT
CGCGTCCA	CGTGTCCA
CCGTACAT	CCGAACAT
CCGTACGG	CCTACGGT
CGCGTGGG	CACGTGGG
CCCNCTTC	CCCCTTCA
CGCGTTAA	GCGTTAAC
CGCGTTCG	CGGGTTCG
CGTAAATA	GCGTAAAT
CGTAAATC	GCGTAAAT
CGTAAATG	GCGTAAAT
CGTAAATT	GCGTAAAT
CGTAAATN	GCGTAAAT
CGCCACCG	TGCCACCG
CGATAAAA	CTGATAAA
CGATAAAC	CTGATAAA
CGATAAAG	CTGATAAA
CGATAAAT	CTGATAAA
CGATAAAN	CTGATAAA
CGGCAAAA	GGCAAAAT
CCCAAATG	CCAAATGC
CCCAACAT	CCGAACAT
CGTACCAA	CGTTCCAA
CGTACCCG	GTACCCGG
CGCCCAGT	GCCCAGTC
CGATATCA	GATATCAT
CGATATCG	CATATCGG
CCCAATGC	CCAAATGC
CCCNTTCA	CCCCTTCA
CGCCCTAA	ACGCCCTA
CGCCCTAC	ACGCCCTA
CGTACGCT	CGACGCTG
CGCCCTAG	ACGCCCTA
CGCCCTAT	ACGCCCTA
CGCCCTAN	ACGCCCTA
CGTACGGT	CCTACGGT
CGCCCTTC	CCCCTTCA
CGCTACGG	CCTACGGT
CGGCCAGA	ACGGCCAG
CGGCCAGC	ACGGCCAG
CGGCCAGG	ACGGCCAG
CGGCCAGT	ACGGCCAG
CGGCCAGN	ACGGCCAG
CGATCCAA	CGTTCCAA
CGCCGCTG	CGACGCTG
CGGCCGCC	AGGCCGCC
CGGCCTTT	CTGCCTTT
CGATCGCT	CGACGCTG
CCTCGGTA	CCTACGGT
CCTCGGTC	CCTACGGT
CCTCGGTG	CCTACGGT
CGCTCCAA	CGTTCCAA
CCTCGGTT	CCTACGGT
CTACTACA	CTCACTAC
CTACTACC	CTCACTAC
CTACTACG	CTCACTAC
CTACTACT	CTCACTAC
CCTCGGTN	CCTACGGT
CTACTACN	CTCACTAC
CGATCTGA	ACGATCTG
CGATCTGC	ACGATCTG
CGATCTGG	ACGATCTG
CGGCGACT	TGGCGACT
CGATCTGT	ACGATCTG
CGATCTGN	ACGATCTG
CGGCGCTG	CGACGCTG
CGCTCGTT	GCTCGTTC
CCTCGTTC	GCTCGTTC
CGATGAAC	GGATGAAC
CGGCGTTC	CGGGTTCG
CGATGACG	CATGACGC
CGATGCTG	CGACGCTG
CGCCTTCA	CCCCTTCA
CGATGTCC	CGTGTCCA
CGCCTTTA	CTGCCTTT
CGCCTTTC	CTGCCTTT
CGCCTTTG	CTGCCTTT
CGCCTTTT	CTGCCTTT
CGCCTTTN	CTGCCTTT
CGAAAAAG	GAAAAAGC
CGATTAAA	CCGATTAA
CGATTAAC	CCGATTAA
CGATTAAG	CCGATTAA
CGATTAAT	CCGATTAA
CGAAAAGA	GGAAAAGA
CGATTAAN	CCGATTAA
CCTCTTCA	CCCCTTCA
CGCTGTCC	CGTGTCCA
CGGCTTCG	CGGGTTCG
CGGCTTGC	CAGCTTGC
CGATTCCA	CGTTCCAA
CGATTCCC	CATTCCCT
CGAAACTA	ACGAAACT
CGAAACTC	ACGAAACT
CGAAACTG	ACGAAACT
CGAAACTT	ACGAAACT
CGAAACTN	ACGAAACT
CTAGAACC	GTAGAACC
CTAGAAGA	TAGAAGAG
CGAAAGTA	GAAAGTAC
CGAAATAG	GAAATAGG
CCNCCTTC	CCCCTTCA
CGAAATGC	CCAAATGC
CTAGACGA	CTAGCGAC
CGCTTACG	GCTTACGG
CTAGAGAC	CTAGCGAC
CGATTTTT	CATTTTTT
CTAGAGGT	TAGAGGTT
CGCTTCCA	CGTTCCAA
CTAGAGTC	CCAGAGTC
CTAGATAA	CTGATAAA
CGAACATA	CCGAACAT
CGAACATC	CCGAACAT
CGCTTGCA	CAGCTTGC
CGAACATG	CCGAACAT
CGCTTGCC	CAGCTTGC
CGAACATT	CCGAACAT
CGCTTGCG	CAGCTTGC
CGCTTGCT	CAGCTTGC
CGAACATN	CCGAACAT
CGCTTGCN	CAGCTTGC
CGCTTTAC	GCTTTACC
CGAACCGA	CAACCGAA
CGAACGCT	CGACGCTG
CGGGACCC	GGGACCCG
CTAGCAAC	CTAGCGAC
CTAGCACA	CTAGCGAC
CTAGCACC	CTAGCGAC
CTAGCACG	CTAGCGAC
CTAGCACT	CTAGCGAC
CTAGCACN	CTAGCGAC
CTAGCAGA	CTAGCGAC
CGGGATCG	CGGGTTCG
CGGGATTC	CGGGTTCG
CGCGAACA	CCGAACAT
CCTGAACA	CCGAACAT
CGAAGCTG	CGACGCTG
CTAGCCAC	CTAGCGAC
CTAGCCGA	CTAGCGAC
CCTGACGC	CATGACGC
CCTGACGG	CCTACGGT
CTAGCCTT	CTGCCTTT
CTAGCGAA	CTAGCGAC
CTAGCGAC	CTAGCGAC
CTAGCGAG	CTAGCGAC
CTAGCGAT	CTAGCGAC
CTAGCGAN	CTAGCGAC
CTAGCGCA	CTAGCGAC
CTAGCGCC	CTAGCGAC
CTAGCGCG	CTAGCGAC
CTAGCGCT	CTAGCGAC
CTAGCGCN	CTAGCGAC
CTAGCGGA	CTAGCGAC
CTAGCGGC	CTAGCGAC
CCTGAGTC	CCAGAGTC
CCTGATAA	CTGATAAA
CTAGCGTA	CTAGCGAC
CTAGCGTC	CTAGCGAC
CCTGATTA	CCGATTAA
CTAGCGNA	CTAGCGAC
CTAGCGNC	CTAGCGAC
CTAGCTAC	CTAGCGAC
CGNTGTCC	CGTGTCCA
CGNACGCT	CGACGCTG
CTAGCTGA	CTAGCGAC
CTAGCTTG	CAGCTTGC
CGCGATTA	CCGATTAA
CCNCTTCA	CCCCTTCA
CCTGCCTT	CTGCCTTT
CTAGCNAC	CTAGCGAC
CGTAGAAC	GTAGAACC
CCTGCGGT	CCTACGGT
CGNTTCCA	CGTTCCAA
CTAGCNGA	CTAGCGAC
CTAGGACA	CTAGCGAC
CTAGGACC	CTAGCGAC
CTAGGACG	CTAGCGAC
CTAGGACT	CTAGCGAC
CTAGGACN	CTAGCGAC
CGTAGCGA	CTAGCGAC
CTAGGCGA	CTAGCGAC
CTAGGGAC	CTAGCGAC
CGTAGTCC	CGTGTCCA
CGTATACG	GTATACGA
CGCGCGCT	CACGCGCT
CGCGCTGA	CGACGCTG
CGCGCTGC	CGACGCTG
CGCGCTGG	CGACGCTG
CGCGCTGT	CGACGCTG
CGCGCTGN	CGACGCTG
CGTATCGG	CATATCGG
CGTATTAA	ACGTATTA
CGTATTAC	ACGTATTA
CGTATTAG	ACGTATTA
CGTATTAT	ACGTATTA
CGTATTAN	ACGTATTA
CTAGTCGA	CTAGCGAC
CTAGTGAC	CTAGCGAC
CGTTTCAA	CGTTCCAA
CGAATTTT	GAATTTTC
CGTTTTTT	CATTTTTT
CTAGNCGA	CTAGCGAC
CTAGNGAC	CTAGCGAC
CGTTNCAA	CGTTCCAA
CGTTNCCA	CGTTCCAA
CGTCACTA	CTCACTAC
CTATAAAA	CTGATAAA
CTATAAAC	CTGATAAA
CTATAAAG	CTGATAAA
CTATAAAT	CTGATAAA
CTATAAAN	CTGATAAA
CCNGAACA	CCGAACAT
CCTGTCCA	CGTGTCCA
CTATACGA	GTATACGA
CGGGCTCG	CGGGTTCG
CGGGCTTC	CGGGTTCG
CGTCCAAA	CGTTCCAA
CCNGAGTC	CCAGAGTC
CGTCCAAC	CGTTCCAA
CGTCCAAG	CGTTCCAA
CGTCCAAT	CGTTCCAA
CGTCCAAN	CGTTCCAA
CCNGATTA	CCGATTAA
CGTCCCAA	CGTTCCAA
CGTCCCAG	CTTCCCAG
CGGGGGAA	TCGGGGGA
CTATATCG	CATATCGG
CGGGGGAC	TCGGGGGA
CGGGGGAG	TCGGGGGA
CGGGGGAT	TCGGGGGA
CGGGGGAN	TCGGGGGA
CGGGGTCG	CGGGTTCG
CGGGGTTC	CGGGTTCG
CGTCGACA	TGTCGACA
CGGGTACG	CGGGTTCG
CGGGTATC	CGGGTTCG
CGGGTCCA	CGTGTCCA
CGGGTCCG	CGGGTTCG
CGGGTCGA	CGGGTTCG
CGGGTCGC	CGGGTTCG
CGGGTCGG	CGGGTTCG
CGGGTCGT	CGGGTTCG
CGGGTCGN	CGGGTTCG
CGGGTCTC	CGGGTTCG
CGTNCCAA	CGTTCCAA
CGGGTGCG	CGGGTTCG
CGTCGCTG	CGACGCTG
CGNCGCTG	CGACGCTG
CGGGTGTC	CGGGTTCG
CGGGTTAC	CGGGTTCG
CGGGTTAG	CGGGTTCG
CGGGTTCA	CGGGTTCG
CGGGTTCC	CGGGTTCG
CGGGTTCG	CGGGTTCG
CGGGTTCT	CGGGTTCG
CTGNTAAA	CTGATAAA
CGGGTTCN	CGGGTTCG
CGGGTTGA	CGGGTTCG
CGGGTTGC	CGGGTTCG
CGGGTTGG	CGGGTTCG
CGGGTTGT	CGGGTTCG
CGGGTTGN	CGGGTTCG
CGGGTTTC	CGGGTTCG
CGGGTTTG	CGGGTTCG
CGGGTTNC	CGGGTTCG
CGGGTTNG	CGGGTTCG
CGGGTNCG	CGGGTTCG
CGGGTNTC	CGGGTTCG
CGTCGTCC	CGTGTCCA
CGANCGCT	CGACGCTG
CGTCTAGC	TGTCTAGC
CGGGNTCG	CGGGTTCG
CGTNGTCC	CGTGTCCA
CGGGNTTC	CGGGTTCG
CGANGCTG	CGACGCTG
CTCTACGG	CCTACGGT
CTCTACTA	CTCACTAC
CTGCCACC	TGCCACCG
CTGCCATT	CTGCCTTT
CGGTCCAC	CGTGTCCA
CGGTCCAG	CGTGTCCA
CGGTCCAT	CGTGTCCA
CGGTCCAN	CGTGTCCA
CTGCCCAG	CTTCCCAG
CTCTATAC	TTCTATAC
CTGCCCTT	CTGCCTTT
CTGCCGTT	CTGCCTTT
CTGCCTAT	CTGCCTTT
CTGCCTCT	CTGCCTTT
CTGCCTGT	CTGCCTTT
CTGCCTTA	CTGCCTTT
CTGCCTTC	CTGCCTTT
CTGCCTTG	CTGCCTTT
CTGCCTTT	CTGCCTTT
CTGCCTTN	CTGCCTTT
CTGCCTNT	CTGCCTTT
CTATCCCA	CTTCCCAG
CTTACCAG	CTTCCCAG
CTATCGAC	CTAGCGAC
CTTACCCA	CTTCCCAG
CTATCGGA	CATATCGG
CTGCCNTT	CTGCCTTT
CTATCGGC	CATATCGG
CTATCGGG	CATATCGG
CTATCGGT	CATATCGG
CTATCGGN	CATATCGG
CTTACGGA	GCTTACGG
CTTACGGC	GCTTACGG
CTTACGGG	GCTTACGG
CTCTCCCA	CTTCCCAG
CTTACGGN	GCTTACGG
CTGCGACA	CTAGCGAC
CTATCTCT	ATATCTCT
CTGCGACC	CTAGCGAC
CTGCGACG	CTAGCGAC
CTGCGACT	CTAGCGAC
CTGCGACN	CTAGCGAC
CGGTGTCC	CGTGTCCA
CTTACTAC	CTCACTAC
CGGTGTTC	CGGGTTCG
CGGTGTTT	GGTGTTTC
CTCTCTAC	CTCACTAC
CTTAGACA	TTTAGACA
CTTAGCAA	GTTAGCAA
CTCTGAGC	ATCTGAGC
CTATGACG	CATGACGC
CTTAGCGA	CTAGCGAC
CTGCGCTT	CTGCCTTT
CGGTTCCA	CGTTCCAA
CGGTTCGA	CGGGTTCG
CGGTTCGC	CGGGTTCG
CGGTTCGG	CGGGTTCG
CGGTTCGT	CGGGTTCG
CGGTTCGN	CGGGTTCG
CTGCGGGT	TGCGGGTT
CTATGCGA	CTAGCGAC
CTGCGTTT	CTGCCTTT
CGGTTTCG	CGGGTTCG
CTGCTAAA	CTGATAAA
CTTATAAA	CTGATAAA
CTCCGGGA	TCCGGGAC
CTATTCCC	CATTCCCT
CTGCTCTT	CTGCCTTT
CTTATCGG	CATATCGG
CTCTTTGT	TCTTTGTA
CTATTTTT	CATTTTTT
CTAAAGTC	ATAAAGTC
CGCAAAAT	GGCAAAAT
CTGCTTGC	CAGCTTGC
CTGCTTTA	CTGCCTTT
CTCCTACA	CTCACTAC
CTGCTTTC	CTGCCTTT
CTCCTACC	CTCACTAC
CTGCTTTG	CTGCCTTT
CTCCTACG	CTCACTAC
CTGCTTTT	CTGCCTTT
CTCCTACT	CTCACTAC
CTGCTTTN	CTGCCTTT
CTCCTACN	CTCACTAC
CGCAAATG	CCAAATGC
CTAAATGC	CCAAATGC
CTCCTGGC	ATCCTGGC
CTGCNCTT	CTGCCTTT
CTCCTTCA	CCCCTTCA
CTCCTTTA	CTGCCTTT
CTCCTTTC	CTGCCTTT
CTCCTTTG	CTGCCTTT
CTCCTTTT	CTGCCTTT
CTCCTTTN	CTGCCTTT
CTAACCGA	CAACCGAA
CTAACGAC	CTAGCGAC
CTAACTAC	CTCACTAC
CTAACTCA	TAACTCAG
CTGCNTTT	CTGCCTTT
CTAAGCGA	CTAGCGAC
CGCACGCT	CGACGCTG
CNAGCGAC	CTAGCGAC
CTCGAACA	CCGAACAT
CGCACTAC	CTCACTAC
CNAGCTTG	CAGCTTGC
CTCGACTA	CTCACTAC
CTGGATAA	CTGATAAA
CTAATAAA	CTGATAAA
CTCNACTA	CTCACTAC
CTCGATAA	CTGATAAA
CGCAGAGT	CCAGAGTC
CTCGATGG	TTCGATGG
CTCGATTA	CCGATTAA
CGCAGCCA	ACGCAGCC
CGCAGCCC	ACGCAGCC
CGCAGCCG	ACGCAGCC
CGCAGCCT	ACGCAGCC
CGCAGCCN	ACGCAGCC
CTANCGAC	CTAGCGAC
CTAATCGA	TAATCGAT
CTGGCCTT	CTGCCTTT
CTCGCCTT	CTGCCTTT
CTAATTTA	ACTAATTT
CTAATTTC	ACTAATTT
CTAATTTG	ACTAATTT
CTGGCGTA	TTGGCGTA
CTCGCGAC	CTAGCGAC
CTAATTTT	ACTAATTT
CTAATTTN	ACTAATTT
CTCGCGCT	CACGCGCT
CTGGCTTT	CTGCCTTT
CTCGCTAC	CTCACTAC
CTCNCTAC	CTCACTAC
CGGAAAAG	GGAAAAGA
CTANGCGA	CTAGCGAC
CGGAACAT	CCGAACAT
CTCGGGGG	TCGGGGGA
CGTGACCA	CGTGTCCA
CGTGACGC	CATGACGC
CTGGGTTC	CGGGTTCG
CGTGATAA	CTGATAAA
CGTGATCC	CGTGTCCA
CTGGTAAA	CTGATAAA
CGGACATT	AGGACATT
CNATATCG	CATATCGG
CGGACCCG	GGGACCCG
CTGGTCCG	ATGGTCCG
CGTGCCAC	CGTGTCCA
CGGACGCT	CGACGCTG
CGTGCCAG	CGTGTCCA
CGTGCCAT	CGTGTCCA
CGTGCCAN	CGTGTCCA
CGTGCCCA	CGTGTCCA
CGTGCCTT	CTGCCTTT
CTCGTGGG	CACGTGGG
CTGGTTCG	CGGGTTCG
CTACACTA	CTCACTAC
CTCGTTCA	GCTCGTTC
CTCGTTCC	GCTCGTTC
CTCGTTCG	GCTCGTTC
CTCGTTCT	GCTCGTTC
CTCGTTCN	GCTCGTTC
CGTGCTCC	CGTGTCCA
CTTCACAG	CTTCCCAG
CTTCACCA	CTTCCCAG
CTTCACTA	CTCACTAC
CTTCAGAT	TTCAGATA
CTNCACTA	CTCACTAC
CGTGGCCA	CGTGTCCA
CGGAGTTC	CGGGTTCG
CGTGGTCC	CGTGTCCA
CGTGGTTC	CGGGTTCG
CNATGACG	CATGACGC
CTTCCAAA	CGTTCCAA
CTTCCAAC	CGTTCCAA
CTNCCCAG	CTTCCCAG
CTTCCAAT	CGTTCCAA
CTTCCAAN	CGTTCCAA
CTTCCACA	CTTCCCAG
CTTCCAGA	CTTCCCAG
CTTCCAGC	CTTCCCAG
CTTCCAGG	CTTCCCAG
CTTCCAGT	CTTCCCAG
CTTCCAGN	CTTCCCAG
CGTGTACA	CGTGTCCA
CGTGTACC	CGTGTCCA
CTACCCAG	CTTCCCAG
CGTGTCAA	CGTGTCCA
CGTGTCAC	CGTGTCCA
CGTGTCAG	CGTGTCCA
CGTGTCAT	CGTGTCCA
CTTCCCAA	CTTCCCAG
CGTGTCAN	CGTGTCCA
CGTGTCCA	CGTGTCCA
CTTCCCAC	CTTCCCAG
CTACCCGC	TACCCGCA
CTTCCCAG	CTTCCCAG
CGTGTCCC	CGTGTCCA
CTACCCGG	GTACCCGG
CGTGTCCG	CGTGTCCA
CGTGTCCT	CGTGTCCA
CTTCCCAT	CTTCCCAG
CTTCCCAN	CTTCCCAG
CTTCCCCA	CTTCCCAG
CTTCCCCG	CTTCCCAG
CTACCGAA	CAACCGAA
CGTGTCCN	CGTGTCCA
CTACCGAC	CTAGCGAC
CGTGTCGA	CGTGTCCA
CGTGTCGC	CGTGTCCA
CTTCCCGA	CTTCCCAG
CTTCCCGC	CTTCCCAG
CTTCCCGG	CTTCCCAG
CTTCCCGT	CTTCCCAG
CGTGTCTA	CGTGTCCA
CTTCCCGN	CTTCCCAG
CGTGTCTC	CGTGTCCA
CTTCCCTC	CATTCCCT
CTTCCCTT	CATTCCCT
CTTCCCTN	CATTCCCT
CGTGTCNA	CGTGTCCA
CTTCCCNA	CTTCCCAG
CGTGTCNC	CGTGTCCA
CTTCCCNG	CTTCCCAG
CTNCCTTT	CTGCCTTT
CTTCCGAG	CTTCCCAG
CTTCCGCA	CTTCCCAG
CGTGTGCA	CGTGTCCA
CGTGTGCC	CGTGTCCA
CTTCCTAG	CTTCCCAG
CTTCCTCA	CTTCCCAG
CTTNCCAG	CTTCCCAG
CTTNCCCA	CTTCCCAG
CTTCCTTT	CTGCCTTT
CTTCCNAG	CTTCCCAG
CTTCCNCA	CTTCCCAG
CGTGTTCA	CGTGTCCA
CGTGTTCC	CGTGTCCA
CGTGTTCG	CGGGTTCG
CTACCTTT	CTGCCTTT
CGTGTTTC	GGTGTTTC
CGTGTNCA	CGTGTCCA
CGTGTNCC	CGTGTCCA
CTTCGATG	TTCGATGG
CTTCGCAG	CTTCCCAG
CTTCGCCA	CTTCCCAG
CTACGACA	CTAGCGAC
CTACGACC	CTAGCGAC
CTACGACG	CTAGCGAC
CNATTCCC	CATTCCCT
CTACGACT	CTAGCGAC
CTACGACN	CTAGCGAC
CGTGNCCA	CGTGTCCA
CTACGCGA	CTAGCGAC
CTACGCGC	CACGCGCT
CTACGCTG	CGACGCTG
CGTGNTCC	CGTGTCCA
CTTCTATA	TTCTATAC
CNATTTTT	CATTTTTT
CTTCTCAG	CTTCCCAG
CTTCTCCA	CTTCCCAG
CTACGGTA	CCTACGGT
CTACGGTC	CCTACGGT
CTACGGTG	CCTACGGT
CTACGGTT	CCTACGGT
CTACGGTN	CCTACGGT
CTACGTGG	CACGTGGG
CGTTAACA	GCGTTAAC
CGTTAACC	GCGTTAAC
CGTTAACG	GCGTTAAC
CGTTAACT	GCGTTAAC
CGTTAACN	GCGTTAAC
CGTTACAA	CGTTCCAA
CGTTACCA	CGTTCCAA
CTTCNCAG	CTTCCCAG
CTTCNCCA	CTTCCCAG
CGTTAGCA	GTTAGCAA
CGTTCAAA	CGTTCCAA
CGTTCAAC	CGTTCCAA
CGTTCAAG	CGTTCCAA
CGTTCAAT	CGTTCCAA
CGTTCAAN	CGTTCCAA
CGTTCACA	CGTTCCAA
CGTTCCAA	CGTTCCAA
CGTTCCCT	CATTCCCT
CGTTCCGA	CGTTCCAA
CGTTCCTA	CGTTCCAA
CGTTCCNA	CGTTCCAA
CGTTCGAA	CGTTCCAA
CGTTCGCA	CGTTCCAA
CGTTCGGC	TGTTCGGC
CTNGATAA	CTGATAAA
CGTTCTAA	CGTTCCAA
CGTTCTCA	CGTTCCAA
CTGTAAAA	CTGATAAA
CTGTAAAC	CTGATAAA
CTGTAAAG	CTGATAAA
CTGTAAAT	CTGATAAA
CTGTAAAN	CTGATAAA
CGTTCNAA	CGTTCCAA
CGTTCNCA	CGTTCCAA
CNTACGGT	CCTACGGT
CTTGACGC	CATGACGC
CGTTGCAA	CGTTCCAA
CTTGAGAA	TTGAGAAC
CGTTGCCA	CGTTCCAA
CTNGCCTT	CTGCCTTT
CTTGATAA	CTGATAAA
CTNGCGAC	CTAGCGAC
CNTAGCGA	CTAGCGAC
CTGTATAA	CTGATAAA
CGTTGTAT	GTTGTATT
CGTTGTCC	CGTGTCCA
CGNGGTTC	CGGGTTCG
CTTGCCAG	CTTCCCAG
CTTGCCCA	CTTCCCAG
CTTGCCTT	CTGCCTTT
CTTGCGAC	CTAGCGAC
CGNGTCCA	CGTGTCCA
CTTGCGTC	TTTGCGTC
CTGTCCAA	CGTGTCCA
CTGTCCAC	CGTGTCCA
CTGTCCAG	CGTGTCCA
CTGTCCAT	CGTGTCCA
CTGTCCAN	CGTGTCCA
CTGTCCCA	CTTCCCAG
CTTGCTGA	TTTGCTGA
CTGTCCTT	CTGCCTTT
CTGTCGAC	TGTCGACA
CNTATCGG	CATATCGG
CGNGTTCG	CGGGTTCG
CTNACTAC	CTCACTAC
CNAAATGC	CCAAATGC
CTGTCTAG	TGTCTAGC
CTCAAATG	CCAAATGC
CTGTCTTT	CTGCCTTT
CTTGGCGT	TTGGCGTA
CTCAACTA	CTCACTAC
CTCAACTT	TCAACTTC
CNAACCGA	CAACCGAA
CTCAAGAC	TCAAGACG
CTNAGCGA	CTAGCGAC
CTCAATAC	CTCACTAC
CTCACAAC	CTCACTAC
CTGTGTCC	CGTGTCCA
CTCACACA	CTCACTAC
CTCACACC	CTCACTAC
CTCACACG	CTCACTAC
CTCACACT	CTCACTAC
CTCACACN	CTCACTAC
CTCACATA	CTCACTAC
CTCACCAC	CTCACTAC
CTCACCTA	CTCACTAC
CTCACGAC	CTCACTAC
CTGTTAAA	CTGATAAA
CTCACGTA	CTCACTAC
CTNATAAA	CTGATAAA
CTCACTAA	CTCACTAC
CTCACTAC	CTCACTAC
CTCACTAG	CTCACTAC
CTCACTAT	CTCACTAC
CTCACTAN	CTCACTAC
CTCACTCA	CTCACTAC
CTCACTCC	CTCACTAC
CTCACTCG	CTCACTAC
CTCACTCT	CTCACTAC
CTCACTCN	CTCACTAC
CTCACTGA	CTCACTAC
CTCACTGC	CTCACTAC
CTCACTTA	CTCACTAC
CTCACTTC	CTCACTAC
CTCACTNA	CTCACTAC
CTCACTNC	CTCACTAC
CTCACNAC	CTCACTAC
CTGTTCCA	CGTTCCAA
CTGTTCGG	TGTTCGGC
CTCACNTA	CTCACTAC
CTCAGAGT	CCAGAGTC
CNTCACTA	CTCACTAC
CGNTCCAA	CGTTCCAA
CTCAGATA	TTCAGATA
CTGTTTAA	TTGTTTAA
CTCAGCGA	CTAGCGAC
CTCAGCTA	CTCACTAC
CNCGAACA	CCGAACAT
CTCAGTAC	CTCACTAC
CNTCCCAG	CTTCCCAG
CNCGATTA	CCGATTAA
CTCATAAA	CTGATAAA
CTCATACA	CTCACTAC
CTCATACC	CTCACTAC
CTCATACG	CTCACTAC
CTCATACT	CTCACTAC
CTCATACN	CTCACTAC
CNCGCGCT	CACGCGCT
CTCATCTA	CTCACTAC
CTCATTAC	CTCACTAC
CTGNATAA	CTGATAAA
GAATAAAG	GAAAAAGC
CTGAAAAA	CTGATAAA
CTGAAAAC	CTGATAAA
CTGAAAAG	CTGATAAA
CTGAAAAT	CTGATAAA
CTGAAAAN	CTGATAAA
GAATAAGC	GAAAAAGC
CTCANCTA	CTCACTAC
CTGAACAT	CCGAACAT
CTCANTAC	CTCACTAC
GAATACGA	GTATACGA
CNCGTGGG	CACGTGGG
GAATAGGA	GAAATAGG
CTGNCCTT	CTGCCTTT
GAATAGGC	GAAATAGG
GAATAGGG	GAAATAGG
GAATAGGT	GAAATAGG
GAATAGGN	GAAATAGG
GAATAGTA	GAAAGTAC
CTGAATAA	CTGATAAA
GAATATAG	GAAATAGG
CTCCACTA	CTCACTAC
GAATATCA	GATATCAT
GAATATGT	GACTATGT
CTGNCTTT	CTGCCTTT
CTGACAAA	CTGATAAA
GAATATTC	GAATTTTC
GAATATTT	GAATTTTC
CNCAAATG	CCAAATGC
CTGACCTT	CTGCCTTT
CTGACGCA	CATGACGC
CTGACGCC	CATGACGC
CTGACGCG	CATGACGC
CTGACGCN	CATGACGC
GAATCACC	AATCACCC
CTCCCAGA	CTTCCCAG
CTCCCAGC	CTTCCCAG
CTCCCAGG	CTTCCCAG
CTCCCAGT	CTTCCCAG
CTCCCAGN	CTTCCCAG
CNGAACAT	CCGAACAT
GAATCATA	GATATCAT
GAATCATC	GATATCAT
GAATCATG	GATATCAT
GAATCATT	GATATCAT
GAATCATN	GATATCAT
CTCCCCAG	CTTCCCAG
CTGACTAA	CTGATAAA
CTGACTAC	CTCACTAC
CTGACTTT	CTGCCTTT
GAATCGAT	TAATCGAT
CNGGGTTC	CGGGTTCG
GAATCGCT	AAATCGCT
CTCCCTAC	CTCACTAC
CTGAGAAA	CTGATAAA
CTGAGAAC	TTGAGAAC
CTCCCTCT	ATCCCTCT
CTCCCTTC	CCCCTTCA
CTCCCTTT	CTGCCTTT
GAATCTTC	GAATTTTC
GAATCTTT	GAATTTTC
CTGAGCGA	CTAGCGAC
CNCTACGG	CCTACGGT
CTTGTATT	GTTGTATT
GAATGAAC	GGATGAAC
CTGAGTAA	CTGATAAA
CNCACTAC	CTCACTAC
CTTGTCCA	CGTGTCCA
CNGGTTCG	CGGGTTCG
CTGATAAA	CTGATAAA
CTGATAAC	CTGATAAA
CTGATAAG	CTGATAAA
CTGATAAT	CTGATAAA
CTGATAAN	CTGATAAA
CTGATACA	CTGATAAA
CTGATAGA	CTGATAAA
CTGATATA	CTGATAAA
CTGATANA	CTGATAAA
CTGATCAA	CTGATAAA
CTTGTTTA	TTGTTTAA
GAATGTAC	GAAAGTAC
GAATGTTC	GAATTTTC
GAATGTTT	GAATTTTC
CTGATGAA	CTGATAAA
GAATTAGG	GAAATAGG
GAATTATC	GAATTTTC
GAATTATT	GAATTTTC
CTGATNAA	CTGATAAA
GAATTCTC	GAATTTTC
GAATTCTT	GAATTTTC
CTGANAAA	CTGATAAA
GAATTGTC	GAATTTTC
GAATTGTT	GAATTTTC
GAATTTAC	GAATTTTC
GAATTTAT	GAATTTTC
GAATTTCA	GAATTTTC
GAATTTCC	GAATTTTC
GAATTTCG	GAATTTTC
GAATTTCT	GAATTTTC
GAATTTCN	GAATTTTC
GAATTTGC	GAATTTTC
GAATTTGT	GAATTTTC
GAATTTTA	GAATTTTC
GAATTTTC	GAATTTTC
GAATTTTG	GAATTTTC
GAATTTTT	GAATTTTC
GAATTTTN	GAATTTTC
GAATTTNC	GAATTTTC
GAATTTNT	GAATTTTC
GAATTNTC	GAATTTTC
GAATTNTT	GAATTTTC
CTTTACCA	GCTTTACC
CTTTACCC	GCTTTACC
CTTTACCG	GCTTTACC
CTTTACCT	GCTTTACC
CTTTACCN	GCTTTACC
CTGANTAA	CTGATAAA
CTTTAGAC	TTTAGACA
CTTTAGCC	TTTTAGCC
GAATNTTC	GAATTTTC
GAATNTTT	GAATTTTC
CTGCACTA	CTCACTAC
CTGCACTT	CTGCCTTT
CNACCGAA	CAACCGAA
GAANAAAG	GAAAAAGC
GAANAAGC	GAAAAAGC
CTGCATAA	CTGATAAA
CTGCATGG	ATGCATGG
CTGCATTT	CTGCCTTT
CTTTCCAA	CGTTCCAA
CTTTCCAG	CTTCCCAG
CTTTCCCA	CTTCCCAG
CTTTCCCT	CATTCCCT
GAANAGTA	GAAAGTAC
CNTGACGC	CATGACGC
GAANATAG	GAAATAGG
CNACGCGC	CACGCGCT
CNACGCTG	CGACGCTG
CNTGATAA	CTGATAAA
CNACGTGG	CACGTGGG
CTTTGCGT	TTTGCGTC
CTTTGCTG	TTTGCTGA
CNTGCCTT	CTGCCTTT
CTTTGTAA	TCTTTGTA
CTTTGTAC	TCTTTGTA
CTTTGTAG	TCTTTGTA
CTTTGTAT	TCTTTGTA
CTTTGTAN	TCTTTGTA
GAAAAAAC	GAAAAAGC
GAAAAAAG	GAAAAAGC
GAAAAACA	GAAAAAGC
GAAAAACC	GAAAAAGC
GAAAAACG	GAAAAAGC
GAAAAACT	GAAAAAGC
GAAAAACN	GAAAAAGC
GAAAAAGC	GAAAAAGC
CTTTTAGC	TTTTAGCC
GAAAAAGT	GAAAAAGC
GAAAAAGN	GAAAAAGC
GATATAAT	GATATCAT
GAAAAATC	GAAAAAGC
GAAAAATG	GAAAAAGC
GATATACA	GATATCAT
GATATACG	GTATACGA
GAAAAANC	GAAAAAGC
GAAAAANG	GAAAAAGC
GATATAGG	GAAATAGG
GAAAACAG	GAAAAAGC
GAAAACGC	GAAAAAGC
GATATATA	GATATCAT
GATATATC	GATATCAT
GATATATG	GATATCAT
GATATATT	GATATCAT
GATATATN	GATATCAT
GAAAAGAA	GGAAAAGA
GAAAAGAC	GGAAAAGA
GATATCAA	GATATCAT
GAAAAGAT	GGAAAAGA
GATATCAC	GATATCAT
GAAAAGAN	GGAAAAGA
GATATCAG	GATATCAT
GAAAAGCA	GAAAAAGC
GAAAAGCC	GAAAAAGC
GATATCAT	GATATCAT
GAAAAGCG	GAAAAAGC
GATATCAN	GATATCAT
GAAAAGCT	GAAAAAGC
GATATCCA	GATATCAT
GAAAAGCN	GAAAAAGC
GAAAAGGA	GAAATAGG
GATATCCT	GATATCAT
GAAAAGGG	GAAATAGG
GAAAAGGT	GAAATAGG
GATATCGA	GATATCAT
GAAAAGGN	GAAATAGG
GAAAAGTA	GAAAGTAC
CTTTTTTA	CATTTTTT
CTTTTTTC	CATTTTTT
CTTTTTTG	CATTTTTT
CTTTTTTN	CATTTTTT
GAAAATAC	GAAAGTAC
GAAAATGC	GAAAAAGC
GATATCGG	CATATCGG
GATATCGT	GATATCAT
GATATCTA	GATATCAT
GAAAANAG	GAAAAAGC
GATATCTG	GATATCAT
GATATCTT	GATATCAT
GATATCTN	GATATCAT
GATATCNA	GATATCAT
GAAAANGC	GAAAAAGC
GATATCNT	GATATCAT
GATATGAT	GATATCAT
GATATGCA	GATATCAT
GAAACAAG	GAAAAAGC
GAAACAGC	GAAAAAGC
GAAACAGG	GAAATAGG
GATATGTA	GACTATGT
GATATGTC	GACTATGT
GATATGTG	GACTATGT
GATATGTT	GACTATGT
GATATGTN	GACTATGT
CNTGTCCA	CGTGTCCA
GATATTAT	GATATCAT
GATATTCA	GATATCAT
GATATTTT	GAATTTTC
GATATNAT	GATATCAT
GATATNCA	GATATCAT
GAAACGTA	GAAAGTAC
GAAACTAC	GAAAGTAC
GAAACTAG	GAAATAGG
GATANCAT	GATATCAT
GAAAGAAC	GAAAGTAC
GAAAGAAG	GAAAAAGC
GAAAGACA	GAAAGTAC
GAAAGACC	GAAAGTAC
GAAAGACG	GAAAGTAC
GAAAGACT	GAAAGTAC
GAAAGACN	GAAAGTAC
GAAAGAGC	GAAAAAGC
GAAAGAGG	GAAATAGG
GAAAGATA	GAAAGTAC
GAAAGCAC	GAAAGTAC
GATANTCA	GATATCAT
GAAAGCTA	GAAAGTAC
GAAAGGAC	GAAAGTAC
GAAAGGTA	GAAAGTAC
GAAAGTAA	GAAAGTAC
GAAAGTAC	GAAAGTAC
GAAAGTAT	GAAAGTAC
GAAAGTAN	GAAAGTAC
GAAAGTCA	GAAAGTAC
GAAAGTCC	GAAAGTAC
GAAAGTCG	GAAAGTAC
GAAAGTCT	GAAAGTAC
GAAAGTCN	GAAAGTAC
GAAAGTGA	GAAAGTAC
GAAAGTGC	GAAAGTAC
GAAAGTTC	GAAAGTAC
GAAAGTNA	GAAAGTAC
GAAAGTNC	GAAAGTAC
GATCACCC	AATCACCC
GAAAGNAC	GAAAGTAC
CNAGAGTC	CCAGAGTC
GAAAGNTA	GAAAGTAC
GAAATACA	GAAAGTAC
GAAATACC	GAAAGTAC
GAAATACT	GAAAGTAC
GAAATACN	GAAAGTAC
GAAATAGA	GAAATAGG
GAAATAGG	GAAATAGG
GAAATAGT	GAAATAGG
GAAATAGN	GAAATAGG
CTNTCCCA	CTTCCCAG
GAAATATG	GAAATAGG
GAAATANG	GAAATAGG
GAAATCAG	GAAATAGG
GAAATCAT	GATATCAT
GAAATCGC	AAATCGCT
GAAATCGG	GAAATAGG
CNCAGAGT	CCAGAGTC
GAAATGAG	GAAATAGG
GATCAGTT	GACAGTTA
GAAATGGA	GAAATAGG
GAAATGGC	GAAATAGG
GAAATGGG	GAAATAGG
GAAATGGT	GAAATAGG
GAAATGGN	GAAATAGG
GAAATGTA	GAAAGTAC
GATCATCA	GATATCAT
GAAATTAC	GAAAGTAC
GAAATTAG	GAAATAGG
GAAATTGG	GAAATAGG
GAAATTTC	GAATTTTC
GAAATTTT	GAATTTTC
GAAATNAG	GAAATAGG
GAAATNGG	GAAATAGG
CNGTGTCC	CGTGTCCA
GAAANAAG	GAAAAAGC
GAAANAGC	GAAAAAGC
GAAANAGG	GAAATAGG
GATCCCTC	ATCCCTCT
GAAANGTA	GAAAGTAC
GAAANTAC	GAAAGTAC
GAAANTAG	GAAATAGG
CNGTTCCA	CGTTCCAA
GAACAAAG	GAAAAAGC
GAACAAGC	GAAAAAGC
GATCCTGG	ATCCTGGC
GAACAGTA	GAAAGTAC
GAACAGTT	GACAGTTA
GAACATAG	GAAATAGG
GACNGTTA	GACAGTTA
GAANGTAC	GAAAGTAC
GATCGTTC	GCTCGTTC
GACNTATG	GACTATGT
GAGGGGAC	AAGGGGAC
GACGTAAA	GCGTAAAT
GAANTAGG	GAAATAGG
GATCTATG	GACTATGT
GATCTCAT	GATATCAT
GATCTGAG	ATCTGAGC
GACGTATG	GACTATGT
GACGTATT	ACGTATTA
GAANTTTC	GAATTTTC
GAANTTTT	GAATTTTC
GACGTGGG	CACGTGGG
GACGTTAC	GACAGTTA
GACGTTAG	GACAGTTA
GACGTTAT	GACAGTTA
GACGTTAN	GACAGTTA
GAGAAAGC	GAAAAAGC
GAGAACCA	GTAGAACC
GAGAACCC	GTAGAACC
GAGAACCG	GTAGAACC
GAGAACCT	GTAGAACC
GAGAACCN	GTAGAACC
GAGAAGAG	TAGAAGAG
GAGAAGTA	GAAAGTAC
GACAAAAG	GAAAAAGC
GACAAAAT	GGCAAAAT
GAGAATAA	AAGAATAA
GAGAATAG	GAAATAGG
GACAAAGC	GAAAAAGC
GATGAACA	GGATGAAC
GATGAACC	GGATGAAC
GATGAACG	GGATGAAC
GATGAACT	GGATGAAC
GATGAACN	GGATGAAC
GACAAGTA	GAAAGTAC
GATGACGC	CATGACGC
GAGACCCG	GGGACCCG
GACAAGTT	GACAGTTA
GACAATAG	GAAATAGG
GACAATGT	GACTATGT
GACAATTA	GACAGTTA
GATGATCA	GATATCAT
GAGTAAAT	GCGTAAAT
GACTAAGT	GACTATGT
GACTAATG	GACTATGT
GACTAATT	ACTAATTT
CNGACGCT	CGACGCTG
GCATGAAC	GGATGAAC
GACTACGT	GACTATGT
GCATGACG	CATGACGC
GACTACTG	GACTATGT
CNCCCTTC	CCCCTTCA
GACTAGGT	GACTATGT
GACACAAG	ACACAAGT
GACTAGTA	GACTATGT
GACTAGTC	GACTATGT
GACTAGTG	GACTATGT
GACTAGTN	GACTATGT
GACTATAG	GACTATGT
GACTATAT	GACTATGT
GACTATCA	GATATCAT
GACTATCG	GACTATGT
GACTATCT	GACTATGT
GACTATGA	GACTATGT
GACTATGC	GACTATGT
GACTATGG	GACTATGT
GACTATGT	GACTATGT
GACTATGN	GACTATGT
GACTATTA	GACTATGT
GACTATTC	GACTATGT
GACTATTG	GACTATGT
GACTATTT	GACTATGT
GACTATTN	GACTATGT
GACTATNG	GACTATGT
GACTATNT	GACTATGT
GACTANGT	GACTATGT
GAGTATCA	GATATCAT
GACTANTG	GACTATGT
GACTCATG	GACTATGT
GAGTATGT	GACTATGT
GCATTAAC	GCGTTAAC
GCATTACC	GCTTTACC
GCATTACG	GCTTACGG
GACACGTT	GACAGTTA
GACTCGTT	GCTCGTTC
GCATTCCC	CATTCCCT
GACTCTGT	GACTATGT
GACACTTA	GACAGTTA
GCATTTAC	GCTTTACC
GAGAGGTT	TAGAGGTT
CNGATAAA	CTGATAAA
GCATTTTC	GAATTTTC
GCATTTTT	CATTTTTT
GACTGATG	GACTATGT
GAGAGTAC	GAAAGTAC
GAGAGTTA	GACAGTTA
GACTGGGA	AACTGGGA
CNCCTTCA	CCCCTTCA
GACAGATA	GACAGTTA
GACAGATT	GACAGTTA
GACTGTGT	GACTATGT
GACTGTTA	GACAGTTA
CNGATTAA	CCGATTAA
GACTTACG	GCTTACGG
GACTTATG	GACTATGT
GACAGCTA	GACAGTTA
GACAGCTT	GACAGTTA
GAGATAGG	GAAATAGG
GAGTGCTG	AAGTGCTG
GACAGGTA	GACAGTTA
GACAGGTT	GACAGTTA
GAGATCAT	GATATCAT
GACAGTAA	GACAGTTA
GACAGTAG	GACAGTTA
GACAGTAT	GACAGTTA
GACAGTAN	GACAGTTA
GACAGTCA	GACAGTTA
GACAGTCT	GACAGTTA
GACTTGTA	GACTATGT
GACAGTGA	GACAGTTA
GACTTGTC	GACTATGT
GACTTGTG	GACTATGT
GAACCCGG	GTACCCGG
GACAGTGT	GACAGTTA
GACTTGTT	GACTATGT
GAGATGAA	GGATGAAC
GACTTGTN	GACTATGT
GACAGTTA	GACAGTTA
GACAGTTC	GACAGTTA
GACAGTTG	GACAGTTA
GACAGTTT	GACAGTTA
GACAGTTN	GACAGTTA
GACAGTNA	GACAGTTA
GACTTTAC	GCTTTACC
GACAGTNT	GACAGTTA
GAACCGAA	CAACCGAA
GACTTTGT	GACTATGT
GACTTTTC	GAATTTTC
GACAGNTA	GACAGTTA
GACAGNTT	GACAGTTA
GAGATTTT	GAATTTTC
GAGTGGTG	AAGTGGTG
GACATAGG	GAAATAGG
GACATATG	GACTATGT
GACATCAT	GATATCAT
GACTNATG	GACTATGT
GACATCCT	ACATCCTT
GAGTGTTT	GGTGTTTC
CNTTCCAA	CGTTCCAA
CNTTCCCA	CTTCCCAG
CNTTCCCT	CATTCCCT
GACATGTA	GACTATGT
GACATGTC	GACTATGT
GACATGTG	GACTATGT
GACATGTN	GACTATGT
GACATTAA	GACAGTTA
GACATTAC	GACAGTTA
GACATTAG	GACAGTTA
GACTNTGT	GACTATGT
GAGTTAAC	GCGTTAAC
GAACGCAT	AACGCATG
GACATTAT	GACAGTTA
GACATTAN	GACAGTTA
GACATTTA	GACAGTTA
GACATTTT	GAATTTTC
GAACGTAC	GAAAGTAC
GAACTAGG	GAAATAGG
GAACTATG	GACTATGT
GACANGTT	GACAGTTA
GAACTCAG	TAACTCAG
GACANTTA	GACAGTTA
GACNAGTT	GACAGTTA
GAACTGGG	AACTGGGA
GAGTTTTC	GAATTTTC
GACNATGT	GACTATGT
GAACTTTC	GAATTTTC
GAACTTTT	GAATTTTC
GATGCATG	ATGCATGG
CNGCCTTT	CTGCCTTT
GANAGTAC	GAAAGTAC
GANAGTTA	GACAGTTA
CNTTTTTT	CATTTTTT
GANATAGG	GAAATAGG
GANATCAT	GATATCAT
GCAACCGA	CAACCGAA
GAAGAAAG	GAAAAAGC
GAAGAACC	GTAGAACC
GAAGAAGC	GAAAAAGC
GAAGAATA	AAGAATAA
CNGCTTGC	CAGCTTGC
GCAACTTC	TCAACTTC
GANATTTT	GAATTTTC
GAAGAGTA	GAAAGTAC
GCAAGACG	TCAAGACG
GAAGATAG	GAAATAGG
GCAAGTAC	GAAAGTAC
GCAATAGG	GAAATAGG
GATGGTCC	ATGGTCCG
GANTATCA	GATATCAT
GANTATGT	GACTATGT
GAAGGAGT	AAGGAGTG
GCAATTTT	GAATTTTC
GATGTATT	GTTGTATT
GANCAGTT	GACAGTTA
GATGTCAT	GATATCAT
GCTCCAGT	GCCCAGTC
GAAGGGGA	AAGGGGAC
GATGTTTC	GGTGTTTC
GCTCCGTT	GCTCGTTC
GAAGGTAC	GAAAGTAC
GCTCCTTC	GCTCGTTC
GCTCGATC	GCTCGTTC
GCTCGATT	GCTCGTTC
GCTCGCTC	GCTCGTTC
GCTCGCTT	GCTCGTTC
GCTCGGTC	GCTCGTTC
GCTCGGTT	GCTCGTTC
GCTCGTAC	GCTCGTTC
GCTCGTAT	GCTCGTTC
GCTCGTCA	GCTCGTTC
GCTCGTCC	GCTCGTTC
GCTCGTCG	GCTCGTTC
GCTCGTCT	GCTCGTTC
GCTCGTCN	GCTCGTTC
GCTCGTGC	GCTCGTTC
GCTCGTGT	GCTCGTTC
GCTCGTTA	GCTCGTTC
GCTCGTTC	GCTCGTTC
GCTCGTTG	GCTCGTTC
GCTCGTTT	GCTCGTTC
GCTCGTTN	GCTCGTTC
GCTCGTNC	GCTCGTTC
GCTCGTNT	GCTCGTTC
GAAGTACA	GAAAGTAC
GAAGTACC	GAAAGTAC
GAAGTACG	GAAAGTAC
GAAGTACT	GAAAGTAC
GAAGTACN	GAAAGTAC
GAAGTAGG	GAAATAGG
GCTCGNTC	GCTCGTTC
GCTCGNTT	GCTCGTTC
GCTCTACC	GCTTTACC
GCTCTACG	GCTTACGG
GAAGTGCT	AAGTGCTG
GAAGTGGT	AAGTGGTG
GAAGTTAA	GACAGTTA
GAAGTTAC	GACAGTTA
GAAGTTAG	GACAGTTA
GAAGTTAT	GACAGTTA
GAAGTTAN	GACAGTTA
GCACAAGT	ACACAAGT
GAAGTTTC	GAATTTTC
GAAGTTTT	GAATTTTC
GCTCTGTT	GCTCGTTC
GCTCTTAC	GCTTTACC
GCTCTTCA	GCTCGTTC
GCTCTTCC	GCTCGTTC
GCTCTTCG	GCTCGTTC
GCTCTTCT	GCTCGTTC
GCTCTTCN	GCTCGTTC
GCACAGTC	GCCCAGTC
GCACAGTT	GACAGTTA
GCTCTTTC	GCTCGTTC
GCGAAAAG	GGAAAAGA
GCGAAAAT	GCGTAAAT
GCGAAACT	ACGAAACT
GCGAAATA	GCGTAAAT
GCGAAATC	GCGTAAAT
GCGAAATG	GCGTAAAT
GCGAAATT	GCGTAAAT
GCGAAATN	GCGTAAAT
GATTACGG	GCTTACGG
GCGAACAT	CCGAACAT
GCTCNGTT	GCTCGTTC
GCACCAGT	GCCCAGTC
GCTCNTTC	GCTCGTTC
GATTAGCA	GTTAGCAA
GATTATCA	GATATCAT
GATTATGT	GACTATGT
GCACCCGG	GTACCCGG
GATTCATA	GATATCAT
GCGACCCG	GGGACCCG
GATTCATC	GATATCAT
GATTCATG	GATATCAT
GATTCATT	GATATCAT
GACCAGTC	GCCCAGTC
GATTCATN	GATATCAT
GACCAGTT	GACAGTTA
GANCTATG	GACTATGT
GATTCCCT	CATTCCCT
GACCATGT	GACTATGT
GCGACGCT	CGACGCTG
GACCCAGT	GCCCAGTC
GCTGACGG	GCTTACGG
GACCCGCA	TACCCGCA
GACCCGGA	GTACCCGG
GACCCGGC	GTACCCGG
GACCCGGG	GTACCCGG
GACCCGGT	GTACCCGG
GACCCGGN	GTACCCGG
GCGATAAA	GCGTAAAT
GCGATAAC	GCGTTAAC
GCACGCGC	CACGCGCT
GCTGATAA	CTGATAAA
GATTGTAT	GTTGTATT
GCGATCTG	ACGATCTG
GCGATGAA	GGATGAAC
GATTTACC	GCTTTACC
GATTTCAT	GATATCAT
GACCGGTT	ACCGGTTG
GCACGTGG	CACGTGGG
GCACGTTC	GCTCGTTC
GACCGTTA	GACAGTTA
GCTGCCTT	CTGCCTTT
GCTGCGTT	GCTCGTTC
GATTTTCA	GAATTTTC
GATTTTCC	GAATTTTC
GATTTTCG	GAATTTTC
GATTTTCT	GAATTTTC
GATTTTCN	GAATTTTC
GACCTATG	GACTATGT
GCACTATG	GACTATGT
GATTTTTC	GAATTTTC
GATTTTTT	CATTTTTT
GCCTCAGT	GCCCAGTC
GCCAAAAT	GGCAAAAT
GCCAAATG	CCAAATGC
GCCTCGTT	GCTCGTTC
GCGCAAAA	GGCAAAAT
GCGCAAAT	GCGTAAAT
GCGTAAAA	GCGTAAAT
GCGTAAAG	GCGTAAAT
GCGTAAAT	GCGTAAAT
GCGTAAAN	GCGTAAAT
GCGTAACC	GCGTTAAC
GCGTAACG	GCGTTAAC
GCGTAACN	GCGTTAAC
GCGTAAGA	GCGTAAAT
GCGTAAGT	GCGTAAAT
GCGTAATA	GCGTAAAT
GCGTAATC	GCGTAAAT
GCGTAATG	GCGTAAAT
GCGTAATT	GCGTAAAT
GCGTAATN	GCGTAAAT
GCGTAANA	GCGTAAAT
GCGCAGCC	ACGCAGCC
GCGTAANT	GCGTAAAT
GCGTACAA	GCGTAAAT
GCGTACAT	GCGTAAAT
GCGCAGTC	GCCCAGTC
GCGTACGG	GCTTACGG
GCCAAGTC	GCCCAGTC
GCGTAGAA	GCGTAAAT
GCGTAGAT	GCGTAAAT
GCGTATAT	GCGTAAAT
GCGTATTA	ACGTATTA
GCGTANAA	GCGTAAAT
GACGAAAC	ACGAAACT
GCGTANAT	GCGTAAAT
GCGCCAGT	GCCCAGTC
GCGTCAAA	GCGTAAAT
GCGTCAAC	GCGTTAAC
GCGTCAAT	GCGTAAAT
GATAAAAG	GAAAAAGC
GCGCCCTA	ACGCCCTA
GATAAAGC	GAAAAAGC
GATAAAGT	ATAAAGTC
GCCACAGT	GCCCAGTC
GATAACAT	GATATCAT
GCTGGTTC	GCTCGTTC
GCCTTAAC	GCGTTAAC
GCCTTACC	GCTTTACC
GCCTTACG	GCTTACGG
GACGAGTT	GACAGTTA
GCTGTAAA	GCGTAAAT
GCTGTACC	GCTTTACC
GCTGTACG	GCTTACGG
GATAAGTA	GAAAGTAC
GCGTCGTT	GCTCGTTC
GCGTCTAA	GCGTTAAC
GATAATAG	GAAATAGG
GATAATCA	GATATCAT
GACGATCT	ACGATCTG
GCTGTATT	GTTGTATT
GACGATGT	GACTATGT
GCCACCGA	TGCCACCG
GCCACCGC	TGCCACCG
GCCACCGG	TGCCACCG
GCCACCGT	TGCCACCG
GCCACCGN	TGCCACCG
GCCTTTAC	GCTTTACC
GAGCAAAA	GGCAAAAT
GCGTGAAA	GCGTAAAT
GCGTGAAC	GCGTTAAC
GCGTGAAT	GCGTAAAT
GACGCAGC	ACGCAGCC
GCTGTTAA	GCGTTAAC
GCTGTTAC	GCTTTACC
GCTGTTCA	GCTCGTTC
GACGCATG	AACGCATG
GCTGTTCC	GCTCGTTC
GCTGTTCG	GCTCGTTC
GCTGTTCT	GCTCGTTC
GCTGTTCN	GCTCGTTC
GCNGTAAA	GCGTAAAT
GACGCCCT	ACGCCCTA
GCTGTTTC	GGTGTTTC
GACGCGCT	CACGCGCT
GATACATA	GATATCAT
GATACATC	GATATCAT
GATACATG	GATATCAT
GATACATT	GATATCAT
GATACATN	GATATCAT
GATACCAT	GATATCAT
GACGCTGA	CGACGCTG
GACGCTGC	CGACGCTG
GACGCTGG	CGACGCTG
GACGCTGT	CGACGCTG
GATACCCG	GTACCCGG
GACGCTGN	CGACGCTG
GCGTGTAA	GCGTTAAC
GATACGAA	GTATACGA
GATACGAC	GTATACGA
GCGTGTCC	CGTGTCCA
GATACGAG	GTATACGA
GATACGAT	GTATACGA
GATACGAN	GTATACGA
GGANAAAG	GGAAAAGA
GCCAGAGT	CCAGAGTC
GAGCAGTT	GACAGTTA
GGANAAGA	GGAAAAGA
GCGTGTTT	GGTGTTTC
GATACTCA	GATATCAT
GCNGTTAA	GCGTTAAC
GACGGCCA	ACGGCCAG
GCGTTAAC	GCGTTAAC
GATAGAAC	GTAGAACC
GCGTTAAG	GCGTTAAC
GCGTTAAN	GCGTTAAC
GCGTTACA	GCGTTAAC
GCGTTACT	GCGTTAAC
GCGTTACN	GCGTTAAC
GCGTTAGA	GCGTTAAC
GCCAGTCA	GCCCAGTC
GCCAGTCC	GCCCAGTC
GCCAGTCG	GCCCAGTC
GCCAGTCT	GCCCAGTC
GCCAGTCN	GCCCAGTC
GATAGCAA	GTTAGCAA
GCGTTAGC	GCGTTAAC
GATAGCAT	GATATCAT
GCGTTATA	GCGTTAAC
GCGTTATC	GCGTTAAC
GCGTTANA	GCGTTAAC
GCGTTANC	GCGTTAAC
GCGTTCAA	GCGTTAAC
GACGGTTA	GACAGTTA
GCGTTCAC	GCGTTAAC
GCCAGTTA	GACAGTTA
GCGTTCCA	CGTTCCAA
GCGTTGAA	GCGTTAAC
GCGTTGAC	GCGTTAAC
GATAGTAC	GAAAGTAC
GATAGTCA	GATATCAT
GATAGTTA	GACAGTTA
GCCNAGTC	GCCCAGTC
GCGTTTAA	GCGTTAAC
GCCNCAGT	GCCCAGTC
GCNTAAAT	GCGTAAAT
GCGTTNAA	GCGTTAAC
GCGTTNAC	GCGTTAAC
GCNTACGG	GCTTACGG
GAGCTATG	GACTATGT
GATNATCA	GATATCAT
GCGTNAAA	GCGTAAAT
GCGTNAAC	GCGTTAAC
GCGTNAAT	GCGTAAAT
GAGCTTGC	CAGCTTGC
GCAGAACC	GTAGAACC
GCGTNTAA	GCGTTAAC
GGANGAAC	GGATGAAC
GCAGAGTC	CCAGAGTC
GCGNAAAT	GCGTAAAT
GCNTCGTT	GCTCGTTC
GCCCAAGT	GCCCAGTC
GCCCAATC	GCCCAGTC
GATNTCAT	GATATCAT
GAGGACAT	AGGACATT
GCCCACGT	GCCCAGTC
GAGGACCC	GGGACCCG
GCCCACTC	GCCCAGTC
GCCCAGAC	GCCCAGTC
GCCCAGAT	GCCCAGTC
GCCCAGCA	GCCCAGTC
GCCCAGCC	GCCCAGTC
GCCCAGCG	GCCCAGTC
GCCCAGCT	GCCCAGTC
GCCCAGCN	GCCCAGTC
GCCCAGGC	GCCCAGTC
GCCCAGGT	GCCCAGTC
GCCCAGTA	GCCCAGTC
GCCCAGTC	GCCCAGTC
GCCCAGTG	GCCCAGTC
GCCCAGTT	GCCCAGTC
GCCCAGTN	GCCCAGTC
GCCCAGNC	GCCCAGTC
GCCCAGNT	GCCCAGTC
GAGGAGTG	AAGGAGTG
GCCCATCA	GCCCAGTC
GCCCATCC	GCCCAGTC
GCCCATCG	GCCCAGTC
GCCCATCT	GCCCAGTC
GCCCATCN	GCCCAGTC
GCCCATGT	GCCCAGTC
GCCCATTC	GCCCAGTC
GCCCANGT	GCCCAGTC
GCCCANTC	GCCCAGTC
GGANTGAA	GGATGAAC
GCCCCAGT	GCCCAGTC
GAGGCCGC	AGGCCGCC
GCAGCTTG	CAGCTTGC
GCCCCGTC	GCCCAGTC
GCCCCTTC	CCCCTTCA
GANAAAAG	GAAAAAGC
GCNCAGTC	GCCCAGTC
GANAAAGC	GAAAAAGC
GCCCGAGT	GCCCAGTC
GCNTTAAC	GCGTTAAC
GCNTTACC	GCTTTACC
GCNTTACG	GCTTACGG
GGAANAAG	GGAAAAGA
GCCCGGTC	GCCCAGTC
GGAANAGA	GGAAAAGA
GANAAGTA	GAAAGTAC
GANTTTTC	GAATTTTC
GCCCGTCA	GCCCAGTC
GCCCGTCC	GCCCAGTC
GCCCGTCG	GCCCAGTC
GANAATAG	GAAATAGG
GCCCGTCT	GCCCAGTC
GCCCGTCN	GCCCAGTC
GCCCGTTC	GCTCGTTC
GCNCCAGT	GCCCAGTC
GGCAAAAA	GGCAAAAT
GGCAAAAC	GGCAAAAT
GGCAAAAT	GGCAAAAT
GGCAAAAN	GGCAAAAT
GGCAAACA	GGCAAAAT
GGCAAACT	GGCAAAAT
GGCAAAGT	GGCAAAAT
GGCAAATA	GGCAAAAT
GGCAAATC	GGCAAAAT
GGCAAATG	GGCAAAAT
GGCAAATT	GGCAAAAT
GGCAAATN	GGCAAAAT
GGCAAANA	GGCAAAAT
GGCAAANT	GGCAAAAT
GGCAACAA	GGCAAAAT
GGCAACAT	GGCAAAAT
GCNTTTAC	GCTTTACC
GGCAAGAA	GGCAAAAT
GGCAAGAT	GGCAAAAT
GGCAATAA	GGCAAAAT
GGACAAAA	GGCAAAAT
GGCAATAT	GGCAAAAT
GGACAAAG	GGAAAAGA
GGACAAGA	GGAAAAGA
GCAGTAAA	GCGTAAAT
GCTTAAAT	GCGTAAAT
GCTTAACA	GCGTTAAC
GCTTAACT	GCGTTAAC
GCTTAACN	GCGTTAAC
GCTTAAGG	GCTTACGG
GCTTACAG	GCTTACGG
GCTTACCA	GCTTTACC
GCTTACCC	GCTTTACC
GCTTACCT	GCTTTACC
GCTTACCN	GCTTTACC
GCTTACGA	GCTTACGG
GCTTACGC	GCTTACGG
GCTTACGG	GCTTACGG
GCTTACGT	GCTTACGG
GCTTACGN	GCTTACGG
GGCAANAA	GGCAAAAT
GCTTACTG	GCTTACGG
GGCAANAT	GGCAAAAT
GCTTACNG	GCTTACGG
GGACAGTT	GACAGTTA
GCTTAGCA	GTTAGCAA
GCTTAGCG	GCTTACGG
GCTTAGGA	GCTTACGG
GCCCTAGT	GCCCAGTC
GCTTAGGC	GCTTACGG
GCTTAGGG	GCTTACGG
GCTTAGGT	GCTTACGG
GCTTAGGN	GCTTACGG
GGCACAAA	GGCAAAAT
GGCACAAT	GGCAAAAT
GGACATTA	AGGACATT
GCTTATAC	GCTTTACC
GGACATTC	AGGACATT
GGACATTG	AGGACATT
GGACATTT	AGGACATT
GGACATTN	AGGACATT
GCTTATCG	GCTTACGG
GCTTATGG	GCTTACGG
GCNCGTTC	GCTCGTTC
GCCCTGTC	GCCCAGTC
GCTTANCG	GCTTACGG
GCAGTTAC	GACAGTTA
GCCCTTCA	CCCCTTCA
GCAGTTAG	GACAGTTA
GCAGTTAT	GACAGTTA
GCAGTTAN	GACAGTTA
GGCACCCG	GGGACCCG
GGACCCGA	GGGACCCG
GGACCCGC	GGGACCCG
GGACCCGT	GGGACCCG
GGACCCGN	GGGACCCG
GCTTANGG	GCTTACGG
GCTTCACC	GCTTTACC
GCTTCACG	GCTTACGG
GCCCNAGT	GCCCAGTC
GCTTCCCA	CTTCCCAG
GCTTCCGG	GCTTACGG
GCTTCGGA	GCTTACGG
GCTTCGGC	GCTTACGG
GGACGAAC	GGATGAAC
GCTTCGGG	GCTTACGG
GCTTCGGT	GCTTACGG
GCTTCGGN	GCTTACGG
GGGAGCCC	GGGACCCG
GCTTCGTT	GCTCGTTC
GGGAGCCG	GGGACCCG
GCTTCTAC	GCTTTACC
GGACGCTG	CGACGCTG
GCCCNGTC	GCCCAGTC
GCTTGACC	GCTTTACC
GCTTGACG	GCTTACGG
GGCAGAAA	GGCAAAAT
GGCAGAAT	GGCAAAAT
GGGATCCC	GGGACCCG
GGGATCCG	GGGACCCG
GCTTGCGG	GCTTACGG
GGGATGAA	GGATGAAC
GGACTATG	GACTATGT
GGACTGAA	GGATGAAC
GCTTGTAC	GCTTTACC
GCTTGTAT	GTTGTATT
GCTTGTTC	GCTCGTTC
GCCGAACA	CCGAACAT
GGGANCCC	GGGACCCG
GGGANCCG	GGGACCCG
GCATAAAT	GCGTAAAT
GCTTTACA	GCTTTACC
GCTTTACC	GCTTTACC
GCTTTACT	GCTTTACC
GCTTTACN	GCTTTACC
GCTTTAGC	GCTTTACC
GGCAGTTA	GACAGTTA
GCATACGA	GTATACGA
GCCGAGTC	GCCCAGTC
GCTTTATC	GCTTTACC
GCATACGG	GCTTACGG
GCTTTANC	GCTTTACC
GGGCAAAA	GGCAAAAT
GCTTTCAC	GCTTTACC
GCCGATTA	CCGATTAA
GCTTTCCA	GCTTTACC
GCTTTCCC	GCTTTACC
GCTTTCCG	GCTTTACC
GCTTTCCT	GCTTTACC
GCTTTCCN	GCTTTACC
GCTTTCGG	GCTTACGG
GCTTTGAC	GCTTTACC
GCTTTGCC	GCTTTACC
GCATATCA	GATATCAT
GCTTTGTA	TCTTTGTA
GGGCACCC	GGGACCCG
GCATATCG	CATATCGG
GGAGAAAG	GGAAAAGA
GGAGAACA	GGATGAAC
GGAGAACG	GGATGAAC
GGAGAACT	GGATGAAC
GGAGAACN	GGATGAAC
GGAGAAGA	GGAAAAGA
GCTTTTAC	GCTTTACC
GCTTTTCC	GCTTTACC
GCCGCAGT	GCCCAGTC
GCTTTNAC	GCTTTACC
GGAGACCC	GGGACCCG
GCTTTNCC	GCTTTACC
GCTTNACC	GCTTTACC
GCTTNACG	GCTTACGG
GGTGAACA	GGATGAAC
GGTGAACC	GGATGAAC
GGTGAACG	GGATGAAC
GCTTNCGG	GCTTACGG
GGTGAACT	GGATGAAC
GGTGAACN	GGATGAAC
GCATCCTT	ACATCCTT
GGTGACCC	GGGACCCG
GCAAAAAG	GAAAAAGC
GCAAAAGA	GGAAAAGA
GCAAAAGC	GAAAAAGC
GCAAAATA	GGCAAAAT
GCAAAATC	GGCAAAAT
GCAAAATG	GGCAAAAT
GCAAAATT	GGCAAAAT
GCAAAATN	GGCAAAAT
GCATCGTT	GCTCGTTC
GCTTNTAC	GCTTTACC
GGGCCCCG	GGGACCCG
GGGCCCGA	GGGACCCG
GGGCCCGC	GGGACCCG
GGGCCCGG	GGGACCCG
GGGCCCGT	GGGACCCG
GGGCCCGN	GGGACCCG
GGTGATTC	GGTGTTTC
GGTGATTT	GGTGTTTC
GCAAAGTA	GAAAGTAC
GCTNACGG	GCTTACGG
GGGCCGCC	AGGCCGCC
GCGNTAAA	GCGTAAAT
GCGNTAAC	GCGTTAAC
GCAAATAG	GAAATAGG
GCAAATGC	CCAAATGC
GCCGGGAC	TCCGGGAC
GGGTTAAC	GCGTTAAC
GGGCGACT	TGGCGACT
GCCGGTTG	ACCGGTTG
GCGNTTAA	GCGTTAAC
GGGTTCGA	CGGGTTCG
GGGTTCGC	CGGGTTCG
GGGTTCGG	CGGGTTCG
GGGTTCGT	CGGGTTCG
GGGTTCGN	CGGGTTCG
GCCGTAAA	GCGTAAAT
GCGCGTTC	GCTCGTTC
GGGTTTCA	GGTGTTTC
GGTGCTTC	GGTGTTTC
GGGTTTCC	GGTGTTTC
GGGTTTCG	GGTGTTTC
GGGTTTCT	GGTGTTTC
GGGTTTCN	GGTGTTTC
GGTGCTTT	GGTGTTTC
GCGCTAAA	GCGTAAAT
GCGCTAAC	GCGTTAAC
GCTNCGTT	GCTCGTTC
GCCGTTAA	GCGTTAAC
GCCGTTCA	GCTCGTTC
GCCGTTCC	GCTCGTTC
GCCGTTCG	GCTCGTTC
GCCGTTCT	GCTCGTTC
GCCGTTCN	GCTCGTTC
GGCATAAA	GGCAAAAT
GGCATAAT	GGCAAAAT
GCGCTTAA	GCGTTAAC
GGCATGAA	GGATGAAC
GCTAAATA	GCGTAAAT
GCTAAATC	GCGTAAAT
GCTAAATG	GCGTAAAT
GCTAAATT	GCGTAAAT
GCTAAATN	GCGTAAAT
GGTGGTTC	GGTGTTTC
GGTGGTTT	GGTGTTTC
GCTAACGG	GCTTACGG
GGTGTATC	GGTGTTTC
GCTAATTT	ACTAATTT
GGTGTCCA	CGTGTCCA
GGTGTCTC	GGTGTTTC
GGTGTCTT	GGTGTTTC
GGTGTGTC	GGTGTTTC
GGTGTGTT	GGTGTTTC
GGCNAAAA	GGCAAAAT
GGCNAAAT	GGCAAAAT
GGTGTTAC	GGTGTTTC
GGTGTTAT	GGTGTTTC
GGTGTTCA	GGTGTTTC
GGTGTTCC	GGTGTTTC
GCTACCCG	GTACCCGG
GGTGTTCG	GGTGTTTC
GGTGTTCT	GGTGTTTC
GGTGTTCN	GGTGTTTC
GGGNACCC	GGGACCCG
GGTGTTGC	GGTGTTTC
GGTGTTGT	GGTGTTTC
GGTGTTTA	GGTGTTTC
GGTGTTTC	GGTGTTTC
GGTGTTTG	GGTGTTTC
GGTGTTTT	GGTGTTTC
GGTGTTTN	GGTGTTTC
GGTGTTNC	GGTGTTTC
GGTGTTNT	GGTGTTTC
GCGGAAAT	GCGTAAAT
GGCANAAA	GGCAAAAT
GCCTAAAT	GCGTAAAT
GGTGTNTC	GGTGTTTC
GGTGTNTT	GGTGTTTC
GGCANAAT	GGCAAAAT
GCTACGGA	GCTTACGG
GCTACGGC	GCTTACGG
GCTACGGG	GCTTACGG
GCTACGGN	GCTTACGG
GCTACGTT	GCTCGTTC
GCGGACCC	GGGACCCG
GCCTAGTC	GCCCAGTC
GGTGNTTC	GGTGTTTC
GGTGNTTT	GGTGTTTC
GCTAGAAC	GTAGAACC
GCCTATGT	GACTATGT
GGGNCCCG	GGGACCCG
GGTTAACA	GCGTTAAC
GGTTAACC	GCGTTAAC
GGTTAACG	GCGTTAAC
GGTTAACT	GCGTTAAC
GGTTAACN	GCGTTAAC
GCTAGCAA	GTTAGCAA
GGTTACGG	GCTTACGG
GGCCAAAA	GGCAAAAT
GGCCAAAT	GGCAAAAT
GCTAGCGA	CTAGCGAC
GGTTAGCA	GTTAGCAA
GGCCACCG	TGCCACCG
GCGGCCAG	ACGGCCAG
GGCCAGTC	GCCCAGTC
GCTAGTTC	GCTCGTTC
GCTNGTTC	GCTCGTTC
GGNTGAAC	GGATGAAC
GGCCCAGT	GCCCAGTC
GCGGGGGA	TCGGGGGA
GCTNTACC	GCTTTACC
GCTNTACG	GCTTACGG
GCTATACC	GCTTTACC
GCGGGTTA	TGCGGGTT
GCGGGTTG	TGCGGGTT
GCGGGTTT	TGCGGGTT
GCGGGTTN	TGCGGGTT
GCTATCAT	GATATCAT
GCGGTAAA	GCGTAAAT
GCGGTAAC	GCGTTAAC
GCTATGTA	GACTATGT
GCTATGTC	GACTATGT
GCTATGTG	GACTATGT
GCTATGTT	GACTATGT
GCTATGTN	GACTATGT
GCTNTTAC	GCTTTACC
GCTATTAC	GCTTTACC
GGTTCCAA	CGTTCCAA
GGNTGTTT	GGTGTTTC
GGTTCGGC	TGTTCGGC
GCGGTTAA	GCGTTAAC
GTANTACG	GTATACGA
GGCCGCCA	AGGCCGCC
GGCCGCCC	AGGCCGCC
GGCCGCCG	AGGCCGCC
GGCCGCCT	AGGCCGCC
GGCCGCCN	AGGCCGCC
GCTCACGG	GCTTACGG
GCTCACTA	CTCACTAC
GCTCAGTC	GCCCAGTC
GCTCAGTT	GCTCGTTC
GGGAAAAG	GGAAAAGA
GGGAAAAT	GGCAAAAT
GCTCATTC	GCTCGTTC
GGGAAAGA	GGAAAAGA
GGGAACCC	GGGACCCG
GGGAACCG	GGGACCCG
GGAGGAAC	GGATGAAC
GTCAAAAT	GGCAAAAT
GGTAAAAG	GGAAAAGA
GGTAAAAT	GGCAAAAT
GGTAAAGA	GGAAAAGA
GGTAAATA	GCGTAAAT
GGTAAATC	GCGTAAAT
GGTAAATG	GCGTAAAT
GGTAAATT	GCGTAAAT
GGTAAATN	GCGTAAAT
GGGACACC	GGGACCCG
GGGACACG	GGGACCCG
GGGACATT	AGGACATT
GGGACCAC	GGGACCCG
GGGACCAG	GGGACCCG
GGGACCCA	GGGACCCG
GGGACCCC	GGGACCCG
GGGACCCG	GGGACCCG
GGGACCCT	GGGACCCG
GGGACCCN	GGGACCCG
GGGACCGA	GGGACCCG
GGGACCGC	GGGACCCG
GGGACCGG	GGGACCCG
GTCAACTT	TCAACTTC
GTCAAGAC	TCAAGACG
GGGACCGT	GGGACCCG
GGGACCGN	GGGACCCG
GGGACCTC	GGGACCCG
GGGACCTG	GGGACCCG
GGGACCNC	GGGACCCG
GGGACCNG	GGGACCCG
GTACGAAC	GTAGAACC
GGGACGCC	GGGACCCG
GGGACGCG	GGGACCCG
GGGACTCC	GGGACCCG
GGGACTCG	GGGACCCG
GGAGTGAA	GGATGAAC
GGCGAAAA	GGCAAAAT
GTACGCCG	GTACCCGG
GTACGCGG	GTACCCGG
GGCGAAAT	GGCAAAAT
GGGACNCC	GGGACCCG
GGGACNCG	GGGACCCG
GGCGACCC	GGGACCCG
GGAGTTTC	GGTGTTTC
GTCACCCG	GTACCCGG
GGCGACTA	TGGCGACT
GGCGACTC	TGGCGACT
GGCGACTG	TGGCGACT
GGCGACTT	TGGCGACT
GGCGACTN	TGGCGACT
GTCACTAC	CTCACTAC
GTACTACG	GTATACGA
GTACTATG	GACTATGT
GGAAAAAA	GGAAAAGA
GGAAAAAC	GGAAAAGA
GGAAAAAN	GGAAAAGA
GGAAAACA	GGAAAAGA
GGTTGAAC	GGATGAAC
GGAAAACG	GGAAAAGA
GGAAAAGA	GGAAAAGA
GGAAAAGG	GGAAAAGA
GGAAAAGT	GGAAAAGA
GGAAAAGN	GGAAAAGA
GGAAAATC	GGCAAAAT
GGAAAATT	GGCAAAAT
GGAAAATN	GGCAAAAT
GGAAAANA	GGAAAAGA
GGAAAANG	GGAAAAGA
GGAAACAG	GGAAAAGA
GTACTCCG	GTACCCGG
GGAAACGA	GGAAAAGA
GTACTCGG	GTACCCGG
GGAAAGAA	GGAAAAGA
GGAAAGAC	GGAAAAGA
GGAAAGAG	GGAAAAGA
GGAAAGAT	GGAAAAGA
GGAAAGAN	GGAAAAGA
GGAAAGGA	GGAAAAGA
GGAAAGTA	GAAAGTAC
GGAAATGA	GGAAAAGA
GTCAGAAC	GTAGAACC
GGAAANAG	GGAAAAGA
GTCAGATA	TTCAGATA
GGAAANGA	GGAAAAGA
GTCAGCAA	GTTAGCAA
GGAACAAG	GGAAAAGA
GGAACAGA	GGAAAAGA
GGATAAAC	GGATGAAC
GGATAAAG	GGAAAAGA
GGAACCCG	GGGACCCG
GGATAACA	GGATGAAC
GGATAACC	GGATGAAC
GGATAACG	GGATGAAC
GGATAACT	GGATGAAC
GGATAACN	GGATGAAC
GGATAAGA	GGAAAAGA
GTCAGTTA	GACAGTTA
GGTTGTAT	GTTGTATT
GTCATACG	GTATACGA
GGATACGA	GTATACGA
GGTTGTTT	GGTGTTTC
GGAAGAAC	GGATGAAC
GGATAGAA	GGATGAAC
GGAAGAAG	GGAAAAGA
GGAAGAGA	GGAAAAGA
GTACNCCG	GTACCCGG
GGATATCA	GATATCAT
GGTTTACC	GCTTTACC
GTACNCGG	GTACCCGG
GTGCAAAA	GGCAAAAT
GGAAGTAC	GAAAGTAC
GGNGACCC	GGGACCCG
GGATCAAC	GGATGAAC
GGAATAAG	GGAAAAGA
GGAATAGA	GGAAAAGA
GGAATAGG	GAAATAGG
GTGCATGG	ATGCATGG
GGAATGAA	GGATGAAC
GGTTTTCA	GGTGTTTC
GGTTTTCC	GGTGTTTC
GGAATTTT	GAATTTTC
GGATCGAA	GGATGAAC
GTAGAAAC	GTAGAACC
GGTTTTCG	GGTGTTTC
GGTTTTCT	GGTGTTTC
GGTTTTCN	GGTGTTTC
GGTTTTTC	GGTGTTTC
GTCCAGTC	GCCCAGTC
GTAGAACA	GTAGAACC
GTAGAACC	GTAGAACC
GTAGAACG	GTAGAACC
GTAGAACT	GTAGAACC
GTAGAACN	GTAGAACC
GTAGAAGA	TAGAAGAG
GTAGAAGC	GTAGAACC
GTAGAATC	GTAGAACC
GGGGACCC	GGGACCCG
GTAGAANC	GTAGAACC
GTAGACAC	GTAGAACC
GGCGGGTT	TGCGGGTT
GTAGACCA	GTAGAACC
GTAGACCC	GTAGAACC
GTAGACCG	GTAGAACC
GTAGACCT	GTAGAACC
GTAGACCN	GTAGAACC
GTAGACGA	GTATACGA
GTGCCACC	TGCCACCG
GTTGGATT	GTTGTATT
GTTGGCAA	GTTAGCAA
GTAGAGAC	GTAGAACC
GTTGGCGT	TTGGCGTA
GTAGAGCC	GTAGAACC
GGATGAAA	GGATGAAC
GTTGGTAT	GTTGTATT
GGATGAAC	GGATGAAC
GGATGAAG	GGATGAAC
GTAGAGGT	TAGAGGTT
GGATGAAT	GGATGAAC
GGATGAAN	GGATGAAC
GGATGACA	GGATGAAC
GGATGACC	GGATGAAC
GGATGACG	GGATGAAC
GGATGACT	GGATGAAC
GGATGACN	GGATGAAC
GGATGAGA	GGATGAAC
GGATGAGC	GGATGAAC
GTGCCCGG	GTACCCGG
GTAGATAC	GTAGAACC
GTAGATCC	GTAGAACC
GGCGTAAA	GCGTAAAT
GGGGCCCG	GGGACCCG
GGATGATA	GGATGAAC
GGATGATC	GGATGAAC
GGATGANA	GGATGAAC
GGATGANC	GGATGAAC
GGATGCAA	GGATGAAC
GGATGCAC	GGATGAAC
GTTGTAAT	GTTGTATT
GTTGTACT	GTTGTATT
GTAGANAC	GTAGAACC
GTTGTAGT	GTTGTATT
GTTGTATA	GTTGTATT
GTTGTATC	GTTGTATT
GTTGTATG	GTTGTATT
GTTGTATT	GTTGTATT
GTTGTATN	GTTGTATT
GTTGTANT	GTTGTATT
GTTGTCAT	GTTGTATT
GTAGANCC	GTAGAACC
GGATGGAA	GGATGAAC
GGATGGAC	GGATGAAC
GTTGTCTT	GTTGTATT
GTGCCTTT	CTGCCTTT
GTTGTGAT	GTTGTATT
GTAGCAAA	GTTAGCAA
GTAGCAAG	GTTAGCAA
GTAGCAAT	GTTAGCAA
GTAGCAAN	GTTAGCAA
GTAGCACC	GTAGAACC
GGCGTTAA	GCGTTAAC
GGATGTAA	GGATGAAC
GTTGTGTT	GTTGTATT
GGATGTAC	GGATGAAC
GGCGTTTC	GGTGTTTC
GTTGTTAT	GTTGTATT
GTTGTTTG	GTTGTATT
GTTGTTTT	GTTGTATT
GTTGTTTN	GTTGTATT
GGATGTTT	GGTGTTTC
GTAGCCCG	GTACCCGG
GTTGTNAT	GTTGTATT
GTAGCCGG	GTACCCGG
GGATGNAA	GGATGAAC
GGATGNAC	GGATGAAC
GTTGTNTT	GTTGTATT
GTTGNATT	GTTGTATT
GTAGCGAC	CTAGCGAC
GGATTAAC	GGATGAAC
GTTGNTAT	GTTGTATT
GTGCGGGT	TGCGGGTT
GGATTGAA	GGATGAAC
GGCTAAAA	GGCAAAAT
GGATTTTC	GAATTTTC
GGCTAAAT	GGCAAAAT
GTTTACCA	GCTTTACC
GTTTACCC	GCTTTACC
GTTTACCG	GCTTTACC
GTTTACCT	GCTTTACC
GTTTACCN	GCTTTACC
GTTTACGA	GTATACGA
GTTTACGG	GCTTACGG
GTTTAGAC	TTTAGACA
GTTTAGCA	GTTAGCAA
GTTTAGCC	TTTTAGCC
GGATNAAC	GGATGAAC
GTTTATTA	GTTGTATT
GTTTATTC	GTTGTATT
GTTTATTG	GTTGTATT
GTTTATTT	GTTGTATT
GTTTATTN	GTTGTATT
GTAGGAAC	GTAGAACC
GTAGGACC	GTAGAACC
GGGGTTCG	CGGGTTCG
GGGGTTTC	GGTGTTTC
GGCTATGT	GACTATGT
GTTTGCAA	GTTAGCAA
GGATNGAA	GGATGAAC
GTTTGCGT	TTTGCGTC
GTTTGCTG	TTTGCTGA
GTTTGTAT	GTTGTATT
GTGGAACC	GTAGAACC
GTGGACCC	GGGACCCG
GTTTTACC	GCTTTACC
GGGTAAAT	GCGTAAAT
GTTTTAGC	TTTTAGCC
GTTTTATT	GTTGTATT
GGGTACCC	GGGACCCG
GGTNGTTT	GGTGTTTC
GGNGTTTC	GGTGTTTC
GTAGTAAC	GTAGAACC
GTAGTACC	GTAGAACC
GTAGTACG	GTATACGA
GTGGCGAC	TGGCGACT
GTGGCGTA	TTGGCGTA
GTAGTATT	GTTGTATT
GGCTCGTT	GCTCGTTC
GGGTCCCG	GGGACCCG
GTAGNAAC	GTAGAACC
GGCTGAAC	GGATGAAC
GTAGNACC	GTAGAACC
GGTNTTTC	GGTGTTTC
GGTAGAAC	GTAGAACC
GGGTGAAC	GGATGAAC
GGTAGCAA	GTTAGCAA
GGCTGTTT	GGTGTTTC
GGCTTACG	GCTTACGG
GGGTGTTT	GGTGTTTC
GGTAGTTT	GGTGTTTC
GGCTTTAC	GCTTTACC
GGTATACG	GTATACGA
GGTATCAT	GATATCAT
GGNAAAAG	GGAAAAGA
GGNAAAAT	GGCAAAAT
GGNAAAGA	GGAAAAGA
GGTATGAA	GGATGAAC
GTCCCAGT	GCCCAGTC
GTCCCCGG	GTACCCGG
GGTATTTC	GGTGTTTC
GTAAAAAG	GAAAAAGC
GTAAAACC	GTAGAACC
GTAAAAGA	GGAAAAGA
GTAAAAGC	GAAAAAGC
GTCCCGGA	GTACCCGG
GTCCCGGC	GTACCCGG
GTCCCGGG	GTACCCGG
GTCCCGGT	GTACCCGG
GTCCCGGN	GTACCCGG
GNCAGTTA	GACAGTTA
GGNACCCG	GGGACCCG
GTCCCTCT	ATCCCTCT
GTAAACCA	GTAGAACC
GTAAACCC	GTAGAACC
GTAAACCG	GTAGAACC
GTAAACCT	GTAGAACC
GTAAACCN	GTAGAACC
GTAAACGA	GTATACGA
GTAAAGTA	GAAAGTAC
GTAAAGTC	ATAAAGTC
GTAAATAG	GAAATAGG
GTCCGGGA	TCCGGGAC
GGTCAAAA	GGCAAAAT
GTAACCCG	GTACCCGG
GTAACCGG	GTACCCGG
GTAACGAA	GTATACGA
GTAACGAC	GTATACGA
GTAACGAG	GTATACGA
GTAACGAT	GTATACGA
GTAACGAN	GTATACGA
GTAACTCA	TAACTCAG
GTTAACAA	GTTAGCAA
GTTAAGCA	GTTAGCAA
GTAAGAAC	GTAGAACC
GTGAAAAG	GGAAAAGA
GTAAGCAA	GTTAGCAA
GTGAACCA	GTAGAACC
GTGAACCC	GTAGAACC
GTGAACCG	GTAGAACC
GTGAACCT	GTAGAACC
GTGAACCN	GTAGAACC
GTAAGTAC	GAAAGTAC
GTTACAAA	GTTAGCAA
GTTACAAC	GTTAGCAA
GTTACAAG	GTTAGCAA
GTTACAAT	GTTAGCAA
GTTACAAN	GTTAGCAA
GTCCTGGC	ATCCTGGC
GTTACCAA	GTTAGCAA
GTTACCCG	GTACCCGG
GNCCAGTC	GCCCAGTC
GTTACGAA	GTATACGA
GTTACGAC	GTATACGA
GTTACGAG	GTATACGA
GTTACGAT	GTATACGA
GTTACGAN	GTATACGA
GTTACGCA	GTTAGCAA
GTTACGGA	GCTTACGG
GTTACGGC	GCTTACGG
GTTACGGG	GCTTACGG
GTAATACG	GTATACGA
GTTACGGT	GCTTACGG
GTTACGGN	GCTTACGG
GGNATGAA	GGATGAAC
GTAATAGG	GAAATAGG
GNAAAAAG	GAAAAAGC
GNAAAAGA	GGAAAAGA
GNAAAAGC	GAAAAAGC
GTAATCGA	TAATCGAT
GTAATTTT	GAATTTTC
GTTAGAAA	GTTAGCAA
GTTAGAAG	GTTAGCAA
GTTAGAAT	GTTAGCAA
GTTAGAAN	GTTAGCAA
GNCCCAGT	GCCCAGTC
GTTAGCAA	GTTAGCAA
GTTAGCAC	GTTAGCAA
GTTAGCAG	GTTAGCAA
GTTAGCAT	GTTAGCAA
GTTAGCAN	GTTAGCAA
GTTAGCCA	GTTAGCAA
GGTCGACA	TGTCGACA
GTTAGCGA	GTTAGCAA
GTTAGCTA	GTTAGCAA
GTTAGCNA	GTTAGCAA
GTTAGGAA	GTTAGCAA
GTTAGGCA	GTTAGCAA
GNAAAGTA	GAAAGTAC
GTGAGCAA	GTTAGCAA
GTTAGTAA	GTTAGCAA
GTTAGTAT	GTTGTATT
GTTAGTCA	GTTAGCAA
GNAAATAG	GAAATAGG
GGTCGTTC	GCTCGTTC
GTTAGNAA	GTTAGCAA
GGTCGTTT	GGTGTTTC
GTTAGNCA	GTTAGCAA
GTTATACG	GTATACGA
GTGATAAA	CTGATAAA
GTTATATT	GTTGTATT
GTACAACC	GTAGAACC
GTGATACG	GTATACGA
GTTATCAA	GTTAGCAA
GTTATCAT	GATATCAT
GTCGAACC	GTAGAACC
GTACACCG	GTACCCGG
GTACACGA	GTATACGA
GTACACGG	GTACCCGG
GTTATGCA	GTTAGCAA
GGTCTAGC	TGTCTAGC
GGNCAAAA	GGCAAAAT
GTGATGAA	GGATGAAC
GTACAGTT	GACAGTTA
GTCGACAA	TGTCGACA
GTCGACAC	TGTCGACA
GTCGACAG	TGTCGACA
GTCGACAT	TGTCGACA
GTCGACAN	TGTCGACA
GNAGAACC	GTAGAACC
GTACCACG	GTACCCGG
GTACCAGG	GTACCCGG
GTACCCAG	GTACCCGG
GTCGATGG	TTCGATGG
GTACCCCG	GTACCCGG
GTACCCGA	GTACCCGG
GTACCCGG	GTACCCGG
GTACCCGT	GTACCCGG
GTACCCGN	GTACCCGG
GTACCCTG	GTACCCGG
GTACCCNG	GTACCCGG
GTACCGCG	GTACCCGG
GTACCGGA	GTACCCGG
GTACCGGC	GTACCCGG
GTACCGGG	GTACCCGG
GTACCGGT	GTACCCGG
GTACCGGN	GTACCCGG
GTACCTCG	GTACCCGG
GGTCTTTC	GGTGTTTC
GTACCTGG	GTACCCGG
GTACCNCG	GTACCCGG
GTACCNGG	GTACCCGG
GTATAACC	GTAGAACC
GTATAACG	GTATACGA
GTATAAGA	GTATACGA
GTGGTATT	GTTGTATT
GTATACAA	GTATACGA
GTATACAC	GTATACGA
GTATACAG	GTATACGA
GTATACAT	GTATACGA
GTATACAN	GTATACGA
GTGGTCCG	ATGGTCCG
GTATACCA	GTATACGA
GTATACCG	GTATACGA
GTATACGA	GTATACGA
GTATACGC	GTATACGA
GTATACGG	GTATACGA
GTATACGT	GTATACGA
GTATACGN	GTATACGA
GTATACTA	GTATACGA
GTATACTG	GTATACGA
GTATACNA	GTATACGA
GTATACNG	GTATACGA
GNTTACGG	GCTTACGG
GTATAGAA	GTATACGA
GTATAGAC	GTATACGA
GTATAGAG	GTATACGA
GTATAGAT	GTATACGA
GNTTAGCA	GTTAGCAA
GTATAGAN	GTATACGA
GTATAGCA	GTTAGCAA
GTATAGCG	GTATACGA
GTATAGGA	GTATACGA
GTATATCA	GATATCAT
GTATATCG	GTATACGA
GTATATGA	GTATACGA
GTATANCG	GTATACGA
GTATANGA	GTATACGA
GTATCACG	GTATACGA
GTATCATA	GATATCAT
GTATCATC	GATATCAT
GTATCATG	GATATCAT
GTATCATT	GATATCAT
GTATCATN	GATATCAT
GTATCCCG	GTACCCGG
GTGTAAAT	GCGTAAAT
GTATCCGA	GTATACGA
GTATCCGG	GTACCCGG
GTATCGAA	GTATACGA
GTATCGAC	GTATACGA
GTATCGAG	GTATACGA
GTATCGAT	GTATACGA
GTCGGGGG	TCGGGGGA
GTATCGAN	GTATACGA
GTNGTATT	GTTGTATT
GTGTACGA	GTATACGA
GTGTAGCA	GTTAGCAA
GTATCTCT	ATATCTCT
GTGTATTA	GTTGTATT
GTGTATTC	GTTGTATT
GTGTATTG	GTTGTATT
GTGTATTT	GTTGTATT
GTGTATTN	GTTGTATT
GNTTGTAT	GTTGTATT
GTATGACG	GTATACGA
GTCGTAAA	GCGTAAAT
GTGTCCAA	CGTGTCCA
GTGTCCAC	CGTGTCCA
GTGTCCAG	CGTGTCCA
GTGTCCAT	CGTGTCCA
GTGTCCAN	CGTGTCCA
GNTTTACC	GCTTTACC
GTCGTATT	GTTGTATT
GTGTCGAC	TGTCGACA
GTATGCGA	GTATACGA
GTGTCTAG	TGTCTAGC
GNGGACCC	GGGACCCG
GTATGTAT	GTTGTATT
GTCGTTAA	GCGTTAAC
GTCGTTCA	GCTCGTTC
GTCGTTCC	GCTCGTTC
GTCGTTCG	GCTCGTTC
GTCGTTCT	GCTCGTTC
GTCGTTCN	GCTCGTTC
GTCTACGA	GTATACGA
GTATTACG	GTATACGA
GTCTAGCC	TGTCTAGC
GTCTAGCG	TGTCTAGC
GTCTAGCT	TGTCTAGC
GTCTAGCN	TGTCTAGC
GTGTGTAT	GTTGTATT
GTATTCGA	GTATACGA
GTCTATAC	TTCTATAC
GTGTGTTT	GGTGTTTC
GTCTATGT	GACTATGT
GTGTTAAC	GCGTTAAC
GTGTTCGG	TGTTCGGC
GTTNAGCA	GTTAGCAA
GTGTTTAA	TTGTTTAA
GTGTTTCA	GGTGTTTC
GTGTTTCC	GGTGTTTC
GTGTTTCG	GGTGTTTC
GTGTTTCT	GGTGTTTC
GTGTTTCN	GGTGTTTC
GTCTCGTT	GCTCGTTC
GTATTTTC	GAATTTTC
GTNTACGA	GTATACGA
GTCTGAGC	ATCTGAGC
GTATNACG	GTATACGA
GTNTAGCA	GTTAGCAA
GTCTGTAT	GTTGTATT
GTATNCGA	GTATACGA
GNATACGA	GTATACGA
GTCTTACG	GCTTACGG
GNATATCA	GATATCAT
GTCTTTAC	GCTTTACC
GTCTTTGT	TCTTTGTA
GTANAACC	GTAGAACC
GTANACGA	GTATACGA
GTTNGCAA	GTTAGCAA
GTANCCCG	GTACCCGG
GTANCCGG	GTACCCGG
GTTNGTAT	GTTGTATT
GNATGAAC	GGATGAAC
GTNTGTAT	GTTGTATT
GTTNTATT	GTTGTATT
GTANGAAC	GTAGAACC
GNGTAAAT	GCGTAAAT
GNAAGTAC	GAAAGTAC
GTNATACG	GTATACGA
GNAATAGG	GAAATAGG
GTTANCAA	GTTAGCAA
GTTANGCA	GTTAGCAA
GNGAAAAG	GGAAAAGA
GNAATTTT	GAATTTTC
GTTCAGAT	TTCAGATA
GTTCAGCA	GTTAGCAA
TACCACCG	TGCCACCG
TACCACGC	TACCCGCA
GTNACCCG	GTACCCGG
TACCAGCA	TACCCGCA
GTTCCAAA	CGTTCCAA
GTTCCAAC	CGTTCCAA
GTTCCAAG	CGTTCCAA
GTTCCAAT	CGTTCCAA
GTTCCAAN	CGTTCCAA
GNGACCCG	GGGACCCG
GNTACCCG	GTACCCGG
GTTCCCAG	CTTCCCAG
GTTCCCGG	GTACCCGG
TACCCACA	TACCCGCA
TACCCAGC	TACCCGCA
TACCCCAA	TACCCGCA
TACCCCAC	TACCCGCA
TACCCCAG	TACCCGCA
TACCCCAT	TACCCGCA
TACCCCAN	TACCCGCA
GNACAGTT	GACAGTTA
TACCCCCA	TACCCGCA
TACCCCGC	TACCCGCA
GTNAGAAC	GTAGAACC
TACCCGAA	TACCCGCA
TACCCGAC	TACCCGCA
TACCCGAG	TACCCGCA
TACCCGAT	TACCCGCA
TACCCGAN	TACCCGCA
TACCCGCA	TACCCGCA
TACCCGCC	TACCCGCA
TACCCGCG	TACCCGCA
TACCCGCT	TACCCGCA
TACCCGCN	TACCCGCA
TACCCGGG	GTACCCGG
TACCCGGT	GTACCCGG
TACCCGGN	GTACCCGG
TACCCGTA	TACCCGCA
TACCCGTC	TACCCGCA
TACCCGNA	TACCCGCA
GTNAGCAA	GTTAGCAA
TACCCGNC	TACCCGCA
TACCCTCA	TACCCGCA
TACCCTGC	TACCCGCA
GNTAGAAC	GTAGAACC
GTNCCCGG	GTACCCGG
TACCCNCA	TACCCGCA
TACCCNGC	TACCCGCA
GNTAGCAA	GTTAGCAA
GTTCGATG	TTCGATGG
GTTCGCAA	GTTAGCAA
TACCGCAA	TACCCGCA
TACCGCAC	TACCCGCA
TACCGCAG	TACCCGCA
TACCGCAT	TACCCGCA
TACCGCAN	TACCCGCA
GNACCCGG	GTACCCGG
TACCGCGC	TACCCGCA
GTTCGGCA	TGTTCGGC
GTTCGGCC	TGTTCGGC
GTTCGGCG	TGTTCGGC
GTTCGGCT	TGTTCGGC
GTTCGGCN	TGTTCGGC
GNTATACG	GTATACGA
TACCGGCA	TACCCGCA
TACCGGGA	TCCGGGAC
TACCGGTT	ACCGGTTG
GNTATCAT	GATATCAT
GTTCGTAT	GTTGTATT
TAAAAAGC	GAAAAAGC
GTTCGTTC	GCTCGTTC
TACCTCAG	TAACTCAG
TACCTCGC	TACCCGCA
TAAAAGAG	TAGAAGAG
GNGATGAA	GGATGAAC
TACCTGCA	TACCCGCA
GTTCTATA	TTCTATAC
GTTCTATT	GTTGTATT
GNACTATG	GACTATGT
TACCNCGC	TACCCGCA
TAAACGAT	TAATCGAT
TAAACTCA	TAACTCAG
TACCNGCA	TACCCGCA
TAAACTTC	TCAACTTC
TAAAGACG	TCAAGACG
TAAAGAGA	TAGAAGAG
TAAAGAGC	TAGAAGAG
TAAAGAGG	TAGAAGAG
TAAAGAGT	TAGAAGAG
TAAAGAGN	TAGAAGAG
TACGAAAC	ACGAAACT
TACGAAGA	TAGAAGAG
TAAAGGTT	TAGAGGTT
GTNGAACC	GTAGAACC
TAAAGTAC	GAAAGTAC
TAAAGTCA	ATAAAGTC
TAAAGTCC	ATAAAGTC
TAAAGTCG	ATAAAGTC
TAAAGTCT	ATAAAGTC
GNGCAAAA	GGCAAAAT
TAAAGTCN	ATAAAGTC
TACGAGGT	TAGAGGTT
TACGATCT	ACGATCTG
TACGATGG	TTCGATGG
TAAATAGG	GAAATAGG
GTTGAACC	GTAGAACC
TAAATCAG	TAACTCAG
TAAATCGA	TAATCGAT
TAAATCGC	AAATCGCT
TACGCAGC	ACGCAGCC
GTTGAATT	GTTGTATT
TACGCATG	AACGCATG
TACGCCCT	ACGCCCTA
TACGCCGC	TACCCGCA
GTTGAGAA	TTGAGAAC
GNCGTAAA	GCGTAAAT
GTTGAGCA	GTTAGCAA
GTTGATAT	GTTGTATT
TACGCGCA	TACCCGCA
TACGCGCT	CACGCGCT
GTTGATTA	GTTGTATT
GTTGATTC	GTTGTATT
GTTGATTG	GTTGTATT
GTTGATTT	GTTGTATT
GTTGATTN	GTTGTATT
GTTGCAAA	GTTAGCAA
GTTGCAAC	GTTAGCAA
GTTGCAAG	GTTAGCAA
GTTGCAAT	GTTAGCAA
GTTGCAAN	GTTAGCAA
TAAGTCAG	TAACTCAG
GNCGTTAA	GCGTTAAC
TAAGTCGA	TAATCGAT
GTTGCATT	GTTGTATT
GNCTTACG	GCTTACGG
TATTTAGC	TTTTAGCC
TAAGTGCT	AAGTGCTG
TAAGTGGT	AAGTGGTG
GTTGCGTC	TTTGCGTC
TATTTGTA	TCTTTGTA
GTTGCTAT	GTTGTATT
GTTGCTGA	TTTGCTGA
GNCTTTAC	GCTTTACC
TAGGCCGC	AGGCCGCC
GNGTGTTT	GGTGTTTC
TAGGCGAC	TGGCGACT
TAGGCGTA	TTGGCGTA
GNGTTAAC	GCGTTAAC
TAGGGGAC	AAGGGGAC
TAGGGGGA	TCGGGGGA
TAGGGGTT	TAGAGGTT
TAGGGTTA	TAGAGGTT
TAGGGTTC	TAGAGGTT
TAGGGTTG	TAGAGGTT
TAGGGTTT	TAGAGGTT
TAGGGTTN	TAGAGGTT
TAATACGA	TAATCGAT
TAATAGAT	TAATCGAT
GNATTTTC	GAATTTTC
TAATCAAT	TAATCGAT
TAATCACC	AATCACCC
TAATCAGC	TAACTCAG
TAATCAGG	TAACTCAG
TAATCAGT	TAACTCAG
TAATCAGN	TAACTCAG
TAATCATA	TAATCGAT
TAATCATC	TAATCGAT
TAATCATG	TAATCGAT
TAATCATT	TAATCGAT
TAATCATN	TAATCGAT
TAATCCAT	TAATCGAT
TAATCCGA	TAATCGAT
GNCTATGT	GACTATGT
TAATCGAA	TAATCGAT
TAATCGAC	TAATCGAT
TAATCGAG	TAATCGAT
TAATCGAT	TAATCGAT
TAATCGAN	TAATCGAT
TAATCGCA	TAATCGAT
TAATCGGA	TAATCGAT
TAATCGGT	TAATCGAT
TAATCGTA	TAATCGAT
TAATCGTC	TAATCGAT
TAATCGTG	TAATCGAT
TAATCGTT	TAATCGAT
TAATCGTN	TAATCGAT
TAATCGNA	TAATCGAT
TAATCGNT	TAATCGAT
TAATCTAT	TAATCGAT
TAATCTCA	TAACTCAG
TAATCTGA	TAATCGAT
TAATCNAT	TAATCGAT
TAATCNGA	TAATCGAT
TAATGATA	TAATCGAT
TAATGATC	TAATCGAT
TAATGATG	TAATCGAT
TAATGATT	TAATCGAT
TAATGATN	TAATCGAT
TAATGCGA	TAATCGAT
GNCTCGTT	GCTCGTTC
TAATGGAT	TAATCGAT
TAGTAAGA	TAGAAGAG
TAGTAGAG	TAGAAGAG
TAGTAGGT	TAGAGGTT
TAATTCAG	TAACTCAG
TAATTCGA	TAATCGAT
TAATTGAT	TAATCGAT
TAATTTTC	GAATTTTC
TAGTCGAC	TGTCGACA
TAGTCGAT	TAATCGAT
TAATNCGA	TAATCGAT
TAGTCTAG	TGTCTAGC
TAATNGAT	TAATCGAT
TAGTGCTG	AAGTGCTG
GNCAAAAT	GGCAAAAT
TAGTGGTG	AAGTGGTG
TAGTGGTT	TAGAGGTT
TANAAGAG	TAGAAGAG
TAGTTCGG	TGTTCGGC
GNTCGTTC	GCTCGTTC
TCCCGCAA	TACCCGCA
TCCCGCAC	TACCCGCA
TCCCGCAG	TACCCGCA
TCCCGCAT	TACCCGCA
TCCCGCAN	TACCCGCA
TATAGACA	TTTAGACA
TAGTTTAA	TTGTTTAA
TCCCGGAC	TCCGGGAC
TAACACAG	TAACTCAG
TCCCGGGA	TCCGGGAC
TATAGGTT	TAGAGGTT
TAGATAGA	TAGAAGAG
TCAAAACG	TCAAGACG
TAGATCGA	TAATCGAT
TCAAACGA	TCAAGACG
TCAAACGC	TCAAGACG
TCAAACGG	TCAAGACG
TCAAACGT	TCAAGACG
TCAAACGN	TCAAGACG
TCAAACTT	TCAACTTC
TAGATGAG	TAGAAGAG
TCCCTCTA	ATCCCTCT
TCCCTCTC	ATCCCTCT
TCCCTCTG	ATCCCTCT
TCCCTCTT	ATCCCTCT
TCCCTCTN	ATCCCTCT
TAGATGGT	TAGAGGTT
TAGATGTT	TAGAGGTT
TAACATCA	TAACTCAG
TATATCAT	GATATCAT
TCAAAGAC	TCAAGACG
TCCCTTCA	CCCCTTCA
TATATCGA	TAATCGAT
TATATCGG	CATATCGG
TATATCTC	ATATCTCT
TCAAATGC	CCAAATGC
TCAAATTC	TCAACTTC
TCAACACG	TCAAGACG
TAGANAGA	TAGAAGAG
TCAACATC	TCAACTTC
TCAACATT	TCAACTTC
TCAACCGA	CAACCGAA
TCAACCTC	TCAACTTC
TCAACCTT	TCAACTTC
TAACCAGA	TAACTCAG
TAACCAGC	TAACTCAG
TAACCAGG	TAACTCAG
TCAACGAC	TCAAGACG
TAACCAGT	TAACTCAG
TAACCAGN	TAACTCAG
TCAACGTC	TCAACTTC
TAACCCAG	TAACTCAG
TCAACGTT	TCAACTTC
TCAACTAC	TCAACTTC
TAACCCGC	TACCCGCA
TCAACTAT	TCAACTTC
TCAACTCC	TCAACTTC
TCAACTCG	TCAACTTC
TCAACTCT	TCAACTTC
TCAACTCN	TCAACTTC
TCAACTGC	TCAACTTC
TAACCGAA	CAACCGAA
TCAACTGT	TCAACTTC
TAACCGAT	TAATCGAT
TCAACTTA	TCAACTTC
TCAACTTC	TCAACTTC
TCAACTTG	TCAACTTC
TAACCGCA	TACCCGCA
TCAACTTT	TCAACTTC
TCAACTTN	TCAACTTC
TCAACTNC	TCAACTTC
TCAACTNT	TCAACTTC
TCAACNTC	TCAACTTC
TCAACNTT	TCAACTTC
TAGANGAG	TAGAAGAG
TCCGAACA	CCGAACAT
TCAAGAAC	TCAAGACG
TCAAGAAG	TCAAGACG
TCAAGACA	TCAAGACG
TCAAGACC	TCAAGACG
TCAAGACG	TCAAGACG
TCAAGACT	TCAAGACG
TCAAGACN	TCAAGACG
TCAAGAGA	TCAAGACG
TCAAGAGC	TCAAGACG
TCAAGAGG	TCAAGACG
TAACCTCA	TAACTCAG
TCAAGAGT	TCAAGACG
TCAAGAGN	TCAAGACG
TCAAGATC	TCAAGACG
TCAAGATG	TCAAGACG
TCAAGANC	TCAAGACG
TCAAGANG	TCAAGACG
TCAAGCAC	TCAAGACG
TAGANGGT	TAGAGGTT
TCAAGCCG	TCAAGACG
TAGANGTT	TAGAGGTT
TCAAGCGA	TCAAGACG
TCAAGCGC	TCAAGACG
TCAAGCGG	TCAAGACG
TCAAGCGT	TCAAGACG
TCAAGCGN	TCAAGACG
TCAAGCTT	TCAACTTC
TCAAGGAC	TCAAGACG
TCCGAGAC	TCCGGGAC
TCAAGGCG	TCAAGACG
TCCGAGGA	TCCGGGAC
TCAAGTAC	TCAAGACG
TAACGATA	TAATCGAT
TAACGATC	TAATCGAT
TAACGATG	TAATCGAT
TAACGATT	TAATCGAT
TAACGATN	TAATCGAT
TCAAGTCG	TCAAGACG
TCAAGTTC	TCAACTTC
TAACGCAG	TAACTCAG
TAACGCAT	AACGCATG
TCCGATGG	TTCGATGG
TCAAGNAC	TCAAGACG
TCAAGNCG	TCAAGACG
TCCGATTA	CCGATTAA
TCAATACG	TCAAGACG
TCAATCGA	TAATCGAT
TAGCAAGA	TAGAAGAG
TAACGTCA	TAACTCAG
TCAATCTT	TCAACTTC
TCAATGAC	TCAAGACG
TCAATTCA	TCAACTTC
TCAATTCC	TCAACTTC
TCAATTCG	TCAACTTC
TCAATTCT	TCAACTTC
TCAATTCN	TCAACTTC
TCAATTTC	TCAACTTC
TCCGCGAC	TCCGGGAC
TAACTAAG	TAACTCAG
TAACTACA	TAACTCAG
TCCGCGGA	TCCGGGAC
TAACTAGA	TAACTCAG
TAACTAGC	TAACTCAG
TAACTAGG	TAACTCAG
TAACTAGT	TAACTCAG
TAACTAGN	TAACTCAG
TACGGCCA	ACGGCCAG
TAGCAGAG	TAGAAGAG
TAACTCAA	TAACTCAG
TCAANACG	TCAAGACG
TAGCAGGT	TAGAGGTT
TAACTCAC	TAACTCAG
TAACTCAG	TAACTCAG
TAACTCAT	TAACTCAG
TAACTCAN	TAACTCAG
TAACTCCA	TAACTCAG
TAACTCCG	TAACTCAG
TAACTCGC	TAACTCAG
TAACTCGG	TAACTCAG
TAACTCGT	TAACTCAG
TAACTCGN	TAACTCAG
TAACTCTA	TAACTCAG
TAACTCTG	TAACTCAG
TAACTCNA	TAACTCAG
TATCACCC	AATCACCC
TCAANCTT	TCAACTTC
TCCGGAAC	TCCGGGAC
TACGGGAC	TCCGGGAC
TCCGGACA	TCCGGGAC
TCCGGACC	TCCGGGAC
TCCGGACG	TCCGGGAC
TCCGGACT	TCCGGGAC
TCCGGACN	TCCGGGAC
TCCGGAGA	TCCGGGAC
TAACTCNG	TAACTCAG
TACGGGGG	TCGGGGGA
TAACTGAG	TAACTCAG
TAACTGCA	TAACTCAG
TCCGGCAC	TCCGGGAC
TCAANGAC	TCAAGACG
TCCGGCGA	TCCGGGAC
TAACTGGG	AACTGGGA
TACGGGTT	TGCGGGTT
TCCGGGAA	TCCGGGAC
TCCGGGAC	TCCGGGAC
TCCGGGAG	TCCGGGAC
TCCGGGAT	TCCGGGAC
TCCGGGAN	TCCGGGAC
TCCGGGCA	TCCGGGAC
TCCGGGCC	TCCGGGAC
TCCGGGCG	TCCGGGAC
TCCGGGCT	TCCGGGAC
TCCGGGCN	TCCGGGAC
TAACTTAG	TAACTCAG
TATCAGAT	TTCAGATA
TCCGGGGC	TCCGGGAC
TCCGGGGG	TCGGGGGA
TAACTTCC	TCAACTTC
TAACTTCG	TCAACTTC
TAACTTCT	TCAACTTC
TCCGGGTA	TCCGGGAC
TAACTTCN	TCAACTTC
TCCGGGTC	TCCGGGAC
TCCGGGTT	TGCGGGTT
TCCGGGNA	TCCGGGAC
TCCGGGNC	TCCGGGAC
TCCGGTAC	TCCGGGAC
TCCGGTGA	TCCGGGAC
TCAANTTC	TCAACTTC
TCCGGTTG	ACCGGTTG
TAGCCACC	TGCCACCG
TCCGGNAC	TCCGGGAC
TCCGGNGA	TCCGGGAC
TAACTNAG	TAACTCAG
TAACTNCA	TAACTCAG
TAGCCCGC	TACCCGCA
TAGCCGCA	TACCCGCA
TCACAAGT	ACACAAGT
TACGTATT	ACGTATTA
TCCGTGAC	TCCGGGAC
TCCGTGGA	TCCGGGAC
TAACNCAG	TAACTCAG
TCACACTT	TCAACTTC
TCACAGAC	TCAAGACG
TAGCGACA	CTAGCGAC
TAACNTCA	TAACTCAG
TACGTGGG	CACGTGGG
TAGCGACC	CTAGCGAC
TAGCGACG	CTAGCGAC
TAGCGACN	CTAGCGAC
TATCCCGC	TACCCGCA
TATCCCTC	ATCCCTCT
TATCCGCA	TACCCGCA
TAAGAAGA	TAGAAGAG
TAAGAATA	AAGAATAA
TAAGACGA	TCAAGACG
TAAGACGC	TCAAGACG
TAAGACGG	TCAAGACG
TAAGACGT	TCAAGACG
TAAGACGN	TCAAGACG
TAAGAGGT	TAGAGGTT
TCACCCGC	TACCCGCA
GNTGTATT	GTTGTATT
TATCCTGG	ATCCTGGC
TAGCGGGT	TGCGGGTT
TAGCGGTT	TAGAGGTT
TCACCTTC	TCAACTTC
TATCGACA	TGTCGACA
TCACGACG	TCAAGACG
TATCGATA	TAATCGAT
TATCGATC	TAATCGAT
TATCGATT	TAATCGAT
TCCGNGAC	TCCGGGAC
TATCGATN	TAATCGAT
TCACGCGC	CACGCGCT
TAAGCGAT	TAATCGAT
TCCGNGGA	TCCGGGAC
GNTGTTTC	GGTGTTTC
TCACGGGA	TCCGGGAC
TAGCTCAG	TAACTCAG
TAAGCTCA	TAACTCAG
TACNCCGC	TACCCGCA
TCACGTGG	CACGTGGG
TAAGGAGT	AAGGAGTG
TACNCGCA	TACCCGCA
TACTAATT	ACTAATTT
TAAGGGGA	AAGGGGAC
TAGCTTGC	CAGCTTGC
TAAGGTTA	TAGAGGTT
TAAGGTTC	TAGAGGTT
TAAGGTTG	TAGAGGTT
TAAGGTTT	TAGAGGTT
TAAGGTTN	TAGAGGTT
TCGGNGGA	TCGGGGGA
TCGGNGGG	TCGGGGGA
TACTATAC	TTCTATAC
TACTATGT	GACTATGT
TATCTAGC	TGTCTAGC
TATCTATA	TTCTATAC
TAANCGAT	TAATCGAT
TACTCAGA	TAACTCAG
TACTCAGC	TAACTCAG
TACTCAGG	TAACTCAG
TACTCAGT	TAACTCAG
TCGTAAAT	GCGTAAAT
TACTCAGN	TAACTCAG
TACTCCGC	TACCCGCA
TAANCTCA	TAACTCAG
TATCTCAG	TAACTCAG
TACTCGAT	TAATCGAT
TACTCGCA	TACCCGCA
TATCTCTA	ATATCTCT
TATCTCTC	ATATCTCT
TATCTCTG	ATATCTCT
TATCTCTT	ATATCTCT
TATCTCTN	ATATCTCT
TATCTGAG	ATCTGAGC
TCGTATTA	ACGTATTA
TAGNAAGA	TAGAAGAG
TACTGGGA	AACTGGGA
TAGNAGAG	TAGAAGAG
TAGNAGGT	TAGAGGTT
TCGTCGAC	TGTCGACA
TCGTCTAG	TGTCTAGC
TAGGAAGA	TAGAAGAG
TAGGACAT	AGGACATT
TAANTCAG	TAACTCAG
TAANTCGA	TAATCGAT
TAGGAGAG	TAGAAGAG
TAGGAGGT	TAGAGGTT
TAGGAGTG	AAGGAGTG
TACTTTGT	TCTTTGTA
TCGTGGGA	TCGGGGGA
TCGTGGGG	TCGGGGGA
TCGTGTCC	CGTGTCCA
TCGTTAAC	GCGTTAAC
TCGTTCCA	CGTTCCAA
TCTNTGTA	TCTTTGTA
TCGTTCGG	TGTTCGGC
TCTNTTGT	TCTTTGTA
TCGTTGTA	TCTTTGTA
TCGTTTAA	TTGTTTAA
TCGTTTGT	TCTTTGTA
TAGAAAAG	TAGAAGAG
TAGAAAGA	TAGAAGAG
TAGAAAGC	TAGAAGAG
TAGAAAGG	TAGAAGAG
TAGAAAGT	TAGAAGAG
TAGAAAGN	TAGAAGAG
TAGAACAG	TAGAAGAG
TAGAACCA	GTAGAACC
TACAACTT	TCAACTTC
TAGAACCC	GTAGAACC
TAGAACCG	GTAGAACC
TAGAACCT	GTAGAACC
TAGAACCN	GTAGAACC
TAGAACGA	TAGAAGAG
TANACTCA	TAACTCAG
TACAAGAC	TCAAGACG
TACAAGAG	TAGAAGAG
TAGAAGAA	TAGAAGAG
TAGAAGAC	TAGAAGAG
TAGAAGAG	TAGAAGAG
TAGAAGAT	TAGAAGAG
TAGAAGAN	TAGAAGAG
TAGAAGCA	TAGAAGAG
TAGAAGCG	TAGAAGAG
TAGAAGGA	TAGAAGAG
TAGAAGGC	TAGAAGAG
TAGAAGGG	TAGAAGAG
TAGAAGGN	TAGAAGAG
TAGAAGTA	TAGAAGAG
TAGAAGTG	TAGAAGAG
TAGAAGTT	TAGAGGTT
TAGAAGNA	TAGAAGAG
TAGAAGNG	TAGAAGAG
TAGAATAA	AAGAATAA
TAGAATAG	TAGAAGAG
TAGAATGA	TAGAAGAG
TAGAANAG	TAGAAGAG
TACACAAG	ACACAAGT
TAGAANGA	TAGAAGAG
TAGNGGTT	TAGAGGTT
TCATCCTT	ACATCCTT
TAGACAGA	TAGAAGAG
TANAGGTT	TAGAGGTT
TACACCGC	TACCCGCA
TCATCGAT	TAATCGAT
TCNAACTT	TCAACTTC
TACACGCA	TACCCGCA
TCNAAGAC	TCAAGACG
TACACTCA	TAACTCAG
TCATCTTC	TCAACTTC
TAGACGAG	TAGAAGAG
TAGACGGT	TAGAGGTT
TAGACGTT	TAGAGGTT
TANATCGA	TAATCGAT
TACAGATA	TTCAGATA
TAGACTCA	TAACTCAG
TAGAGAAC	TTGAGAAC
TAGAGAGA	TAGAAGAG
TAGAGAGC	TAGAAGAG
TAGAGAGG	TAGAAGAG
TACAGGTT	TAGAGGTT
TAGAGAGN	TAGAAGAG
TAGAGATT	TAGAGGTT
TACAGTTA	GACAGTTA
TAGAGCGT	TAGAGGTT
TAGAGCTT	TAGAGGTT
TAGAGGAG	TAGAAGAG
TAGAGGAT	TAGAGGTT
TAGAGGCT	TAGAGGTT
TAGAGGGT	TAGAGGTT
TAGAGGTA	TAGAGGTT
TAGAGGTC	TAGAGGTT
TAGAGGTG	TAGAGGTT
TAGAGGTT	TAGAGGTT
TAGAGGTN	TAGAGGTT
TAGAGGNT	TAGAGGTT
TAGAGTGT	TAGAGGTT
TAGAGTTA	TAGAGGTT
TAGAGTTC	TAGAGGTT
TAGAGTTG	TAGAGGTT
TAGAGTTT	TAGAGGTT
TAGAGTTN	TAGAGGTT
TAGAGNGT	TAGAGGTT
TAGAGNTT	TAGAGGTT
TCNACTTC	TCAACTTC
TACATCCT	ACATCCTT
TACATCGA	TAATCGAT
TATAAAGT	ATAAAGTC
TCNAGACG	TCAAGACG
TATAAGAG	TAGAAGAG
TCATTCCC	CATTCCCT
TGAATCGA	TAATCGAT
TATGAAGA	TAGAAGAG
TCATTGTA	TCTTTGTA
TANGAAGA	TAGAAGAG
TGAATTTT	GAATTTTC
TCATTTGT	TCTTTGTA
TATACGAA	GTATACGA
TATACGAC	GTATACGA
TCATTTTT	CATTTTTT
TATACGAG	GTATACGA
TATACGAT	GTATACGA
TATACGAN	GTATACGA
TANGAGGT	TAGAGGTT
TATGACGC	CATGACGC
TATACTCA	TAACTCAG
TANCCCGC	TACCCGCA
TATGAGAA	TTGAGAAC
TCACTACA	CTCACTAC
TANCCGCA	TACCCGCA
TCACTACC	CTCACTAC
TCACTACG	CTCACTAC
TCACTACT	CTCACTAC
TCACTACN	CTCACTAC
TATGAGGT	TAGAGGTT
TCACTCAG	TAACTCAG
TCACTTCA	TCAACTTC
TCACTTCC	TCAACTTC
TCACTTCG	TCAACTTC
TCACTTCT	TCAACTTC
TCACTTCN	TCAACTTC
TGACACCG	TGCCACCG
TATGCATG	ATGCATGG
TGACAGTT	GACAGTTA
TGCGACAA	TGTCGACA
TGCGACAC	TGTCGACA
TGCGACAG	TGTCGACA
TGACCACC	TGCCACCG
TGCGACAT	TGTCGACA
TGCGACAN	TGTCGACA
TGCGACCG	TGCCACCG
TATGCGTC	TTTGCGTC
TGCGACTA	TGGCGACT
TGCGACTC	TGGCGACT
TGCGACTG	TGGCGACT
TGCGACTT	TGGCGACT
TGCGACTN	TGGCGACT
TATGCTGA	TTTGCTGA
TGCGAGGT	TGCGGGTT
TGCGAGTT	TGCGGGTT
TGACCCGC	TACCCGCA
TGCGATGG	TTCGATGG
TGCGCACC	TGCCACCG
TCANACTT	TCAACTTC
TCANAGAC	TCAAGACG
TCAGAAGA	TAGAAGAG
TGCGCGAC	TGGCGACT
TGCGCGGT	TGCGGGTT
TGCGCGTT	TGCGGGTT
TANCTCAG	TAACTCAG
TATGGCGT	TTGGCGTA
TCAGACGA	TCAAGACG
TCAGACGC	TCAAGACG
TCAGACGG	TCAAGACG
TCAGACGT	TCAAGACG
TCAGACGN	TCAAGACG
TCAGACTT	TCAACTTC
TCAGAGAC	TCAAGACG
TCGCCACC	TGCCACCG
TATGGTCC	ATGGTCCG
TCAGAGGT	TAGAGGTT
TCAGAGTC	CCAGAGTC
TCAGATAA	TTCAGATA
TCAGATAC	TTCAGATA
TCAGATAG	TTCAGATA
TCAGATAT	TTCAGATA
TCAGATAN	TTCAGATA
TGCGGAGT	TGCGGGTT
TGACGACA	TGTCGACA
TGCGGATT	TGCGGGTT
TGACGACT	TGGCGACT
TCGCCCTA	ACGCCCTA
TGCGGCGT	TGCGGGTT
TGCGGCTT	TGCGGGTT
TGCGGGAC	TCCGGGAC
TGCGGGAT	TGCGGGTT
TGCGGGCT	TGCGGGTT
TGCGGGGG	TCGGGGGA
TGCGGGGT	TGCGGGTT
TGCGGGTA	TGCGGGTT
TGCGGGTC	TGCGGGTT
TGCGGGTG	TGCGGGTT
TGACGCTG	CGACGCTG
TGCGGGTT	TGCGGGTT
TGCGGGTN	TGCGGGTT
TGCGGGNT	TGCGGGTT
TGACGGGT	TGCGGGTT
TCCTACGG	CCTACGGT
TATGTTTA	TTGTTTAA
TGCGGTGT	TGCGGGTT
TGCGGTTA	TGCGGGTT
TGCGGTTC	TGCGGGTT
TGCGGTTG	TGCGGGTT
TGCGGTTT	TGCGGGTT
TGCGGTTN	TGCGGGTT
TCANCTTC	TCAACTTC
TGCGGNGT	TGCGGGTT
TCCTATAC	TTCTATAC
TGCGGNTT	TGCGGGTT
TGCGTAAA	GCGTAAAT
TCGCGACT	TGGCGACT
TCAGCTTC	TCAACTTC
TCAGCTTG	CAGCTTGC
TGCGTGGT	TGCGGGTT
TGACTAGC	TGTCTAGC
TGCGTGTT	TGCGGGTT
TGACTATG	GACTATGT
TGCGTTAA	GCGTTAAC
TGACTCAG	TAACTCAG
TCAGGACG	TCAAGACG
TCANGACG	TCAAGACG
TCGCGGGG	TCGGGGGA
TCGCGGGT	TGCGGGTT
TCAGGGAC	TCCGGGAC
TCAGGGGA	TCGGGGGA
TCAGGGGG	TCGGGGGA
TGCGNGGT	TGCGGGTT
TGCGNGTT	TGCGGGTT
TATTAGAC	TTTAGACA
TATTAGCC	TTTTAGCC
TGCTACCG	TGCCACCG
TGCTAGCA	TGTCTAGC
TGCTAGCC	TGTCTAGC
TGCTAGCG	TGTCTAGC
TGCTAGCT	TGTCTAGC
TGCTAGCN	TGTCTAGC
TGCTATAC	TTCTATAC
TCCTGGAC	TCCGGGAC
TCCTGGCA	ATCCTGGC
TCCTGGCC	ATCCTGGC
TCCTGGCG	ATCCTGGC
TCCTGGCT	ATCCTGGC
TCCTGGCN	ATCCTGGC
TCCTGGGA	TCCGGGAC
TGCTCACC	TGCCACCG
TATTCCCT	CATTCCCT
TGCTCGAC	TGTCGACA
TATTCGAT	TAATCGAT
TGCTCGGC	TGTTCGGC
TATTCGGC	TGTTCGGC
TGCTCGTT	GCTCGTTC
TANTCGAT	TAATCGAT
TGCTCTAG	TGTCTAGC
TGAGAACA	TTGAGAAC
TGAGAACC	TTGAGAAC
TGAGAACG	TTGAGAAC
TGAGAACT	TTGAGAAC
TGAGAACN	TTGAGAAC
TGAGAAGA	TAGAAGAG
TCTCACTA	CTCACTAC
TCTCAGAT	TTCAGATA
TGAGAGGT	TAGAGGTT
TCCTTGTA	TCTTTGTA
TGGTGACT	TGGCGACT
TCCTTTGT	TCTTTGTA
TCATACTT	TCAACTTC
TCATAGAC	TCAAGACG
TATTGCGT	TTTGCGTC
TATTGCTG	TTTGCTGA
TGCTGGGT	TGCGGGTT
TGCTGGTT	TGCGGGTT
TCATATCG	CATATCGG
TGGTGTTT	GGTGTTTC
TCGGAGGA	TCGGGGGA
TCGGAGGG	TCGGGGGA
TGGTTCGG	TGTTCGGC
TCGGCCAG	ACGGCCAG
TCTCGACA	TGTCGACA
TCTCGATG	TTCGATGG
TCGGCGAC	TGGCGACT
TCGGCGGA	TCGGGGGA
TCGGCGGG	TCGGGGGA
TCGGCGTA	TTGGCGTA
TCGNGGGA	TCGGGGGA
TGGTTTAA	TTGTTTAA
TCGNGGGG	TCGGGGGA
TCTCGGGA	TCCGGGAC
TCGGGACA	TCCGGGAC
TCGGGACC	TCCGGGAC
TCGGGACG	TCCGGGAC
TCGGGACT	TCCGGGAC
TCGGGACN	TCCGGGAC
TCGGGAGA	TCGGGGGA
TCGGGAGG	TCGGGGGA
TCGAAACT	ACGAAACT
TCGAACAT	CCGAACAT
TCGGGCGA	TCGGGGGA
TCGGGCGG	TCGGGGGA
TCTCGTTC	GCTCGTTC
TCGAACTT	TCAACTTC
TCGAAGAC	TCAAGACG
TCGAAGAG	TAGAAGAG
TCGGGGAA	TCGGGGGA
TCGGGGAG	TCGGGGGA
TCGGGGAT	TCGGGGGA
TCGGGGAN	TCGGGGGA
TCCAAATG	CCAAATGC
TCGGGGCA	TCGGGGGA
TCGGGGCG	TCGGGGGA
TCGGGGGA	TCGGGGGA
TCGGGGGC	TCGGGGGA
TCGGGGGG	TCGGGGGA
TCGGGGGT	TCGGGGGA
TCGGGGGN	TCGGGGGA
TCCAACTT	TCAACTTC
TCGGGGTA	TCGGGGGA
TCGGGGTG	TCGGGGGA
TCTCTAGC	TGTCTAGC
TCCAAGAC	TCAAGACG
TCTCTATA	TTCTATAC
TCGGGGNA	TCGGGGGA
TCGGGGNG	TCGGGGGA
TCGGGTGA	TCGGGGGA
TCGGGTGG	TCGGGGGA
TCGGGTTA	TGCGGGTT
TCGGGTTG	TGCGGGTT
TCGGGTTT	TGCGGGTT
TCGGGTTN	TGCGGGTT
TCGGGNGA	TCGGGGGA
TCGGGNGG	TCGGGGGA
TCTCTGTA	TCTTTGTA
TCCACCGA	TGCCACCG
TCCACCGC	TGCCACCG
TCCACCGG	TGCCACCG
TCCACCGT	TGCCACCG
TCCACCGN	TGCCACCG
TCGACGCT	CGACGCTG
TCTCTTGT	TCTTTGTA
TCGGTGGA	TCGGGGGA
TGGNCGAC	TGGCGACT
TCGGTGGG	TCGGGGGA
TCGACTTC	TCAACTTC
TCGAGAAC	TTGAGAAC
TCGAGACG	TCAAGACG
TCCACTTC	TCAACTTC
TCGAGGGA	TCGGGGGA
TCGAGGGG	TCGGGGGA
TGGNGACT	TGGCGACT
TCGAGGTT	TAGAGGTT
TCCAGACG	TCAAGACG
TCCAGAGT	CCAGAGTC
TCCAGATA	TTCAGATA
TCCAGGAC	TCCGGGAC
TCCAGGGA	TCCGGGAC
TCCNGGAC	TCCGGGAC
TCCNGGGA	TCCGGGAC
TCGATCTG	ACGATCTG
TCGATGGA	TTCGATGG
TCGATGGC	TTCGATGG
TCGATGGG	TTCGATGG
TCGATGGT	TTCGATGG
TCGATGGN	TTCGATGG
TCGATTAA	CCGATTAA
TCTAACTT	TCAACTTC
TCTAAGAC	TCAAGACG
TCTAATTT	ACTAATTT
TCTGAGAA	TTGAGAAC
TCTGAGCA	ATCTGAGC
TCTGAGCC	ATCTGAGC
TCTGAGCG	ATCTGAGC
TCTGAGCT	ATCTGAGC
TCTGAGCN	ATCTGAGC
TCTGATAA	CTGATAAA
TCTACGGT	CCTACGGT
TCTACTTC	TCAACTTC
TCTGCCTT	CTGCCTTT
TCTAGACA	TTTAGACA
TCTGCGTC	TTTGCGTC
TCTGCTGA	TTTGCTGA
TCTAGACG	TCAAGACG
TCGCAGCC	ACGCAGCC
TCTAGCGA	CTAGCGAC
TTACCCGC	TACCCGCA
TTACCCGG	GTACCCGG
TCTGGCGT	TTGGCGTA
TCTGGGAC	TCCGGGAC
TCTGGGGA	TCGGGGGA
TCTGGGGG	TCGGGGGA
TCTATACA	TTCTATAC
TGAAAAAG	GAAAAAGC
TCTATACC	TTCTATAC
TCTATACG	TTCTATAC
TCTATACT	TTCTATAC
TCTATACN	TTCTATAC
TGAAAAGA	GGAAAAGA
TCNGGGAC	TCCGGGAC
TCNGGGGA	TCGGGGGA
TCNGGGGG	TCGGGGGA
TTACGATG	TTCGATGG
TCNCGGGA	TCCGGGAC
TGAAAGTA	GAAAGTAC
TCCCACCG	TGCCACCG
TCTATGTA	TCTTTGTA
TCTATTGT	TCTTTGTA
TGAAATAG	GAAATAGG
TGNCACCG	TGCCACCG
TCCCAGTC	GCCCAGTC
TTACTATA	TTCTATAC
TTACTCAG	TAACTCAG
TGNCCACC	TGCCACCG
TGAACTCA	TAACTCAG
TCCCCGCA	TACCCGCA
TGAACTTC	TCAACTTC
TGAGCGAC	TGGCGACT
TGAAGACG	TCAAGACG
TGAAGAGA	TAGAAGAG
TCCCCTTC	CCCCTTCA
TGAAGAGC	TAGAAGAG
TGAAGAGG	TAGAAGAG
TGAAGAGT	TAGAAGAG
TGAAGAGN	TAGAAGAG
TGAGGGTT	TGCGGGTT
TGAGGTTA	TAGAGGTT
TGAGGTTC	TAGAGGTT
TGAGGTTG	TAGAGGTT
TGAGGTTT	TAGAGGTT
TGAGGTTN	TAGAGGTT
TGGCNACT	TGGCGACT
TTAGAACA	TTGAGAAC
TTAGAACG	TTGAGAAC
TTAGAACT	TTGAGAAC
TTAGAACN	TTGAGAAC
TTAGAAGA	TAGAAGAG
TTAGACAA	TTTAGACA
TTAGACAC	TTTAGACA
TTAGACAG	TTTAGACA
TTAGACAT	TTTAGACA
TTAGACAN	TTTAGACA
TTAGAGAA	TTGAGAAC
TTCGTATA	TTCTATAC
TGGCNGAC	TGGCGACT
TTCGTATG	TTCGATGG
TCTGTGTA	TCTTTGTA
TTAGAGGT	TAGAGGTT
TTAGATAA	TTCAGATA
TTAGATAC	TTCAGATA
TTAGATAG	TTCAGATA
TTAGATAT	TTCAGATA
TTAGATAN	TTCAGATA
TTAGATGG	TTCGATGG
TCTGTTGT	TCTTTGTA
TCTGTTTA	TTGTTTAA
TTCGTGGA	TTCGATGG
TTCGTGGC	TTCGATGG
TTCGTGGG	TTCGATGG
TTCGTGGT	TTCGATGG
TTCGTGGN	TTCGATGG
TTAGCAAA	GTTAGCAA
TTAGCAAC	GTTAGCAA
TTAGCAAG	GTTAGCAA
TTAGCAAT	GTTAGCAA
TTAGCAAN	GTTAGCAA
TGGGACCC	GGGACCCG
TGGGACTA	TGGCGACT
TGGGACTC	TGGCGACT
TGGGACTG	TGGCGACT
TGGGACTT	TGGCGACT
TGGGACTN	TGGCGACT
TTCGTTGG	TTCGATGG
TTCGTTTA	TTGTTTAA
TTAGCGAC	CTAGCGAC
TTAGCGTA	TTGGCGTA
TTAGCGTC	TTTGCGTC
TTAGCTGA	TTTGCTGA
TTCGNATG	TTCGATGG
TGATAAAA	CTGATAAA
TGATAAAC	CTGATAAA
TGATAAAG	CTGATAAA
TGATAAAT	CTGATAAA
TGATAAAN	CTGATAAA
TTAGGCGT	TTGGCGTA
TCTTACGG	GCTTACGG
TCTTAGAC	TTTAGACA
TCTTAGCC	TTTTAGCC
TCTTAGTA	TCTTTGTA
TTCGNTGG	TTCGATGG
TGCTTACG	GCTTACGG
TCTTATGT	TCTTTGTA
TGCTTCGG	TGTTCGGC
TGATATCA	GATATCAT
TGGGCGAC	TGGCGACT
TGGGCGTA	TTGGCGTA
TGCTTTAC	GCTTTACC
TGCTTTGT	TCTTTGTA
TCTTCCCA	CTTCCCAG
TTCTAAAC	TTCTATAC
TTCTAACA	TTCTATAC
TTCTAACC	TTCTATAC
TTCTAACG	TTCTATAC
TTCTAACT	TTCTATAC
TCTTCGGC	TGTTCGGC
TCTTCGTA	TCTTTGTA
TGATCGAC	TGTCGACA
TGATCGAT	TAATCGAT
TTCTAACN	TTCTATAC
TGATCGGC	TGTTCGGC
TCTTCTGT	TCTTTGTA
TGATCTAG	TGTCTAGC
TTCTAATA	TTCTATAC
TTAGTTTA	TTGTTTAA
TTCTACAC	TTCTATAC
TGGGGACT	TGGCGACT
TTCTACTA	TTCTATAC
TGATGAAC	GGATGAAC
TTCTAGAT	TTCAGATA
TCTTGCGT	TTTGCGTC
TTCTAGCA	TGTCTAGC
TTCTAGCG	TGTCTAGC
TCTTGCTG	TTTGCTGA
TTCTAGCT	TGTCTAGC
TCTTGGTA	TCTTTGTA
TCTTGTAA	TCTTTGTA
TCTTGTAC	TCTTTGTA
TCTTGTAG	TCTTTGTA
TCTTGTAT	TCTTTGTA
TCTTGTAN	TCTTTGTA
TCTTGTGT	TCTTTGTA
TTCTAGCN	TGTCTAGC
TGGGGGAA	TCGGGGGA
TGGGGGAC	TCGGGGGA
TGGGGGAG	TCGGGGGA
TGGGGGAT	TCGGGGGA
TTCTAGTA	TTCTATAC
TGCAAAAT	GGCAAAAT
TTCTATAA	TTCTATAC
TTCTATAC	TTCTATAC
TTCTATAG	TTCTATAC
TGGGGGAN	TCGGGGGA
TTCTATAT	TTCTATAC
TTCTATAN	TTCTATAC
TTCTATCA	TTCTATAC
TTCTATCC	TTCTATAC
TTCTATCG	TTCTATAC
TTCTATCT	TTCTATAC
TTCTATCN	TTCTATAC
TGGGGGGA	TCGGGGGA
TTCTATGA	TTCTATAC
TTCTATGC	TTCTATAC
TTCTATGG	TTCGATGG
TTGNAGAA	TTGAGAAC
TTCTATTA	TTCTATAC
TTCTATTC	TTCTATAC
TGCAACCG	TGCCACCG
TGGGGGTT	TGCGGGTT
TTCTATNA	TTCTATAC
TTCTATNC	TTCTATAC
TCTTTACC	GCTTTACC
TTCTANAC	TTCTATAC
TGCAACTT	TCAACTTC
TCTTTAGC	TTTTAGCC
TCTTTAGT	TCTTTGTA
TCTTTATA	TCTTTGTA
TGCAAGAC	TCAAGACG
TTCTANTA	TTCTATAC
TCTTTCGT	TCTTTGTA
TCTTTCTA	TCTTTGTA
TCTTTGAA	TCTTTGTA
TCTTTGAC	TCTTTGTA
TCTTTGAG	TCTTTGTA
TCTTTGAT	TCTTTGTA
TCTTTGAN	TCTTTGTA
TCTTTGCA	TCTTTGTA
TCTTTGCT	TCTTTGTA
TGGGGTTA	TGCGGGTT
TGGGGTTC	TGCGGGTT
TGGGGTTG	TGCGGGTT
TGGGGTTT	TGCGGGTT
TGGGGTTN	TGCGGGTT
TCTTTGGA	TCTTTGTA
TCTTTGGT	TCTTTGTA
TCTTTGTA	TCTTTGTA
TCTTTGTC	TCTTTGTA
TCTTTGTG	TCTTTGTA
TCTTTGTT	TCTTTGTA
TCTTTGTN	TCTTTGTA
TGATTCGG	TGTTCGGC
TCTTTGNA	TCTTTGTA
TCTTTGNT	TCTTTGTA
TCTTTTAA	TCTTTGTA
TCTTTTAC	TCTTTGTA
TCTTTTAG	TCTTTGTA
TCTTTTAT	TCTTTGTA
TCTTTTAN	TCTTTGTA
TCTTTTGT	TCTTTGTA
TTCTCATA	TTCTATAC
TCTTTTTA	TCTTTGTA
TGCACACC	TGCCACCG
TGCNACCG	TGCCACCG
TCTTTNGT	TCTTTGTA
TCTTTNTA	TCTTTGTA
TGCACCGA	TGCCACCG
TGCACCGC	TGCCACCG
TGCACCGG	TGCCACCG
TGCACCGT	TGCCACCG
TGCACCGN	TGCCACCG
TTGNCGTA	TTGGCGTA
TCTTNGTA	TCTTTGTA
TGTCTAAC	TGTCTAGC
TGTCTAAG	TGTCTAGC
TGTCTACC	TGTCTAGC
TGTCTACG	TGTCTAGC
TGTCTACT	TGTCTAGC
TTCTCTAC	TTCTATAC
TGTCTACN	TGTCTAGC
TGTCTAGA	TGTCTAGC
TGTCTAGC	TGTCTAGC
TCNTTGTA	TCTTTGTA
TGTCTAGG	TGTCTAGC
TGTCTAGT	TGTCTAGC
TGTCTAGN	TGTCTAGC
TGTCTATA	TTCTATAC
TCTTNTGT	TCTTTGTA
TGTCTATC	TGTCTAGC
TGTCTATG	TGTCTAGC
TGTCTANC	TGTCTAGC
TGCNCACC	TGCCACCG
TGTCTANG	TGTCTAGC
TGTCTCAG	TGTCTAGC
TCNTTTGT	TCTTTGTA
TGTCTCGC	TGTCTAGC
TGTCTCGG	TGTTCGGC
TGTCTGAC	TGTCGACA
TGTCTGAG	TGTCTAGC
TGTCTGCA	TGTCTAGC
TGTCTGCC	TGTCTAGC
TGTCTGCG	TGTCTAGC
TGTCTGCT	TGTCTAGC
TGTCTGCN	TGTCTAGC
TGTCTGGC	TGTCTAGC
TGGGTTCG	CGGGTTCG
TGTCTTAG	TGTCTAGC
TGTCTTGC	TGTCTAGC
TTGNGAAC	TTGAGAAC
TGTCTNAG	TGTCTAGC
TGTCTNGC	TGTCTAGC
TGTCNACA	TGTCGACA
TGTCNAGC	TGTCTAGC
TTCTGAGC	ATCTGAGC
TTCTGATG	TTCGATGG
TGTACCCG	GTACCCGG
TGTCNGAC	TGTCGACA
TTCTGCGT	TTTGCGTC
TTGNGCGT	TTGGCGTA
TTCTGCTG	TTTGCTGA
TGTCNTAG	TGTCTAGC
TGTACGAC	TGTCGACA
TGTACGGC	TGTTCGGC
TTCTGTAC	TTCTATAC
TGTACTAG	TGTCTAGC
TGCNGGGT	TGCGGGTT
TGCNGGTT	TGCGGGTT
TGCAGATA	TTCAGATA
TGTGACAA	TGTCGACA
TGTGACAC	TGTCGACA
TGTGACAG	TGTCGACA
TGTGACAT	TGTCGACA
TGTGACAN	TGTCGACA
TGCAGGGT	TGCGGGTT
TGCAGGTT	TGCGGGTT
TGTAGAAC	GTAGAACC
TGTGAGAA	TTGAGAAC
TGGACATT	AGGACATT
TGGACCCG	GGGACCCG
TTCTTACA	TTCTATAC
TTCTTACC	TTCTATAC
TTCTTACG	TTCTATAC
TTCTTACT	TTCTATAC
TTCTTACN	TTCTATAC
TTCTTAGC	TTTTAGCC
TTCTTATA	TTCTATAC
TGGACGAC	TGGCGACT
TTCTTTAA	TTGTTTAA
TTCTTTAC	TTCTATAC
TTGNTTAA	TTGTTTAA
TTCTTTGT	TCTTTGTA
TGCATGGA	ATGCATGG
TGCATGGC	ATGCATGG
TGCATGGG	ATGCATGG
TGCATGGT	ATGCATGG
TGCATGGN	ATGCATGG
TTGNTTTA	TTGTTTAA
TGTGCGGC	TGTTCGGC
TGTATACG	GTATACGA
TGTGCGTC	TTTGCGTC
TGTATAGC	TGTCTAGC
TGTGCTAG	TGTCTAGC
TTCTNATA	TTCTATAC
TGGTCCGA	ATGGTCCG
TGGTCCGC	ATGGTCCG
TGGTCCGG	ATGGTCCG
TGGTCCGT	ATGGTCCG
TGTGCTGA	TTTGCTGA
TGGTCCGN	ATGGTCCG
TGTATCGG	TGTTCGGC
TGGAGAAC	TTGAGAAC
TGGAGACT	TGGCGACT
TGGTCGGC	TGTTCGGC
TGTGGACA	TGTCGACA
TGGTCTAG	TGTCTAGC
TGTGGCGT	TTGGCGTA
TTCTNTAC	TTCTATAC
TGTGGGTT	TGCGGGTT
TGGAAAAG	GGAAAAGA
TGGAGGTT	TAGAGGTT
TGCCAACC	TGCCACCG
TGCCAACG	TGCCACCG
TGCCACAC	TGCCACCG
TGCCACAG	TGCCACCG
TGCCACCA	TGCCACCG
TGCCACCC	TGCCACCG
TGCCACCG	TGCCACCG
TGCCACCT	TGCCACCG
TGCCACCN	TGCCACCG
TGCCACGA	TGCCACCG
TGCCACGC	TGCCACCG
TGCCACGG	TGCCACCG
TGCCACGT	TGCCACCG
TGCCACGN	TGCCACCG
TGCCACTC	TGCCACCG
TGCCACTG	TGCCACCG
TGCCACNC	TGCCACCG
TGCCACNG	TGCCACCG
TGGAAGAG	TAGAAGAG
TGTGTAGC	TGTCTAGC
TGCCAGCC	TGCCACCG
TGCCAGCG	TGCCACCG
TGTGTCCA	CGTGTCCA
TGCCATCC	TGCCACCG
TGTGTCGG	TGTTCGGC
TGCCATCG	TGCCACCG
TTTAAACA	TTTAGACA
TTCNAGAT	TTCAGATA
TGTCAACA	TGTCGACA
TGTCAAGC	TGTCTAGC
TGCCANCC	TGCCACCG
TGCCANCG	TGCCACCG
TTCNATAC	TTCTATAC
TGTCACAA	TGTCGACA
TTTAACAA	TTTAGACA
TGTCACAC	TGTCGACA
TTTAACAC	TTTAGACA
TGTCACAG	TGTCGACA
TTTAACAG	TTTAGACA
TTTAACAT	TTTAGACA
TGTCACAT	TGTCGACA
TTTAACAN	TTTAGACA
TGTCACAN	TGTCGACA
TGTCACCG	TGCCACCG
TTCNATGG	TTCGATGG
TGGATGAA	GGATGAAC
TGTCAGAC	TGTCGACA
TGTCAGAT	TTCAGATA
TGTCAGCA	TGTCTAGC
TGTCAGCC	TGTCTAGC
TGTCAGCG	TGTCTAGC
TGCCCACC	TGCCACCG
TGTCAGCT	TGTCTAGC
TGTCAGCN	TGTCTAGC
TGNCGACA	TGTCGACA
TGTGTTTA	TTGTTTAA
TGTGTTTC	GGTGTTTC
TGNCGACT	TGGCGACT
TGTCATAG	TGTCTAGC
TGCCCAGT	GCCCAGTC
TTTAAGAC	TTTAGACA
TTNAGAAC	TTGAGAAC
TTNAGACA	TTTAGACA
TGCCCCCG	TGCCACCG
TTTAAGCC	TTTTAGCC
TGCCCCGA	TGCCACCG
TGCCCCGC	TGCCACCG
TGCCCCGG	TGCCACCG
TGCCCCGT	TGCCACCG
TGCCCCGN	TGCCACCG
TTNAGATA	TTCAGATA
TGCCCGCA	TACCCGCA
TGTCCACA	TGTCGACA
TGTCCACC	TGCCACCG
TGTCCAGC	TGTCTAGC
TGNCGGGT	TGCGGGTT
TTAAAGTC	ATAAAGTC
TGTCCGAC	TGTCGACA
TGNCTAGC	TGTCTAGC
TGTCCGGC	TGTTCGGC
TGGCAAAA	GGCAAAAT
TGGCAACT	TGGCGACT
TGGCACCG	TGCCACCG
TGGCACTA	TGGCGACT
TGGCACTC	TGGCGACT
TGGCACTG	TGGCGACT
TGGCACTT	TGGCGACT
TGTCCTAG	TGTCTAGC
TGGCACTN	TGGCGACT
TGGCAGAC	TGGCGACT
TGCCGACA	TGTCGACA
TGCCGACC	TGCCACCG
TGCCGACT	TGGCGACT
TTTACACA	TTTAGACA
TGCCGCCG	TGCCACCG
TGTTACGG	TGTTCGGC
TGTCGAAA	TGTCGACA
TGTCGAAC	TGTCGACA
TGTCGAAG	TGTCGACA
TGTCGAAT	TGTCGACA
TGTCGAAN	TGTCGACA
TGTCGACA	TGTCGACA
TGTCGACC	TGTCGACA
TGTCGACG	TGTCGACA
TGTTAGAC	TTTAGACA
TGTTAGCG	TGTCTAGC
TGTTAGCT	TGTCTAGC
TGTTAGCN	TGTCTAGC
TGTTAGGC	TGTTCGGC
TGCCGGGA	TCCGGGAC
TGTCGACN	TGTCGACA
TGTCGAGA	TGTCGACA
TGCCGGGT	TGCGGGTT
TGGCCACC	TGCCACCG
TGTCGATA	TGTCGACA
TTTACGAC	TTTAGACA
TGGCCACT	TGGCGACT
TGTCGATC	TGTCGACA
TGCCGGTT	TGCGGGTT
TGTCGATG	TTCGATGG
TGTCGANA	TGTCGACA
TGTCGANC	TGTCGACA
TTAACTCA	TAACTCAG
TTTACGTC	TTTGCGTC
TTAACTTC	TCAACTTC
TGTCGCAA	TGTCGACA
TGTCGCAC	TGTCGACA
TGTCGCAG	TGTCGACA
TGTCGCAT	TGTCGACA
TGTCGCAN	TGTCGACA
TGTCGCCA	TGTCGACA
TTTACTGA	TTTGCTGA
TGTCGGAC	TGTCGACA
TTAAGAAC	TTGAGAAC
TTAAGACA	TTTAGACA
TGTCGGCC	TGTTCGGC
TTAAGACG	TCAAGACG
TGTCGGCG	TGTTCGGC
TGTCGGCT	TGTTCGGC
TGTCGGCN	TGTTCGGC
TGTCGGGT	TGCGGGTT
TTAAGATA	TTCAGATA
TGTCGTAC	TGTCGACA
TGTCGTAG	TGTCTAGC
TGGCCGAC	TGGCGACT
TGTCGTCA	TGTCGACA
TTTAGAAA	TTTAGACA
TTTAGAAG	TTTAGACA
TTTAGAAT	TTTAGACA
TTTAGAAN	TTTAGACA
TTTAGACA	TTTAGACA
TTTAGACC	TTTAGACA
TTTAGACG	TTTAGACA
TTTAGACT	TTTAGACA
TTTAGACN	TTTAGACA
TTTAGAGA	TTTAGACA
TTTAGAGC	TTTAGACA
TGGCCGCC	AGGCCGCC
TTTAGATC	TTTAGACA
TTTAGANA	TTTAGACA
TTTAGANC	TTTAGACA
TGTCGNAC	TGTCGACA
TTTAGCAC	TTTAGACA
TGTCGNCA	TGTCGACA
TTTAGCAG	TTTAGACA
TTTAGCAT	TTTAGACA
TTTAGCAN	TTTAGACA
TTTAGCCC	TTTTAGCC
TTTAGCCG	TTTTAGCC
TTTAGCCT	TTTTAGCC
TTTAGCCN	TTTTAGCC
TTTAGCGT	TTTGCGTC
TGCCTACC	TGCCACCG
TGCCTAGC	TGTCTAGC
TTTAGCTG	TTTGCTGA
TTTAGGAC	TTTAGACA
TGCCTCCG	TGCCACCG
TTTAGGCA	TTTAGACA
TGGCGAAC	TGGCGACT
TGGCGAAT	TGGCGACT
TGGCGACC	TGGCGACT
TTTAGTAC	TTTAGACA
TGGCGACG	TGGCGACT
TGGCGACT	TGGCGACT
TGGCGACN	TGGCGACT
TTTAGTCA	TTTAGACA
TGGCGAGC	TGGCGACT
TGGCGAGT	TGGCGACT
TGGCGATA	TGGCGACT
TGGCGATC	TGGCGACT
TGNGCGAC	TGGCGACT
TTAATCGA	TAATCGAT
TTTAGNAC	TTTAGACA
TTTAGNCA	TTTAGACA
TGCCTTTA	CTGCCTTT
TGGCGATG	TGGCGACT
TGCCTTTC	CTGCCTTT
TGGCGATT	TGGCGACT
TGCCTTTG	CTGCCTTT
TGGCGATN	TGGCGACT
TGCCTTTT	CTGCCTTT
TGCCTTTN	CTGCCTTT
TGGCGANC	TGGCGACT
TGGCGANT	TGGCGACT
TGGCGCAC	TGGCGACT
TGGCGCCT	TGGCGACT
TGGCGCTA	TGGCGACT
TGGCGCTC	TGGCGACT
TGGCGCTG	TGGCGACT
TGGCGCTT	TGGCGACT
TGGCGCTN	TGGCGACT
TGGCGGAC	TGGCGACT
TGGCGGCT	TGGCGACT
TGCCNACC	TGCCACCG
TGGCGGGT	TGCGGGTT
TGCCNCCG	TGCCACCG
TGGCGTAA	TTGGCGTA
TGGCGTAG	TTGGCGTA
TGGCGTAT	TTGGCGTA
TGGCGTAN	TTGGCGTA
TGGCGTCT	TGGCGACT
TTATACGA	GTATACGA
TTATAGAC	TTTAGACA
TGGCGNAC	TGGCGACT
TTATAGCC	TTTTAGCC
TGGCGNCT	TGGCGACT
TGNGGGTT	TGCGGGTT
TTATATAC	TTCTATAC
TGGCTACT	TGGCGACT
TGGCTAGC	TGTCTAGC
TNAGAAGA	TAGAAGAG
TTNCAGAT	TTCAGATA
TGGCTGAC	TGGCGACT
TNAGAGGT	TAGAGGTT
TTACAGAT	TTCAGATA
TTATCGAT	TAATCGAT
TTATCTCT	ATATCTCT
TTGGGAAC	TTGAGAAC
TTGGGCGT	TTGGCGTA
TTGGGGGA	TCGGGGGA
TTGGGGTA	TTGGCGTA
TTGGGTAA	TTGGCGTA
TTGGGTAC	TTGGCGTA
TGTTCAGC	TGTTCGGC
TGTTCAGG	TGTTCGGC
TTGGGTAG	TTGGCGTA
TTGGGTAT	TTGGCGTA
TTCAAATA	TTCAGATA
TTGGGTAN	TTGGCGTA
TTCAACTT	TCAACTTC
TTATGCGT	TTTGCGTC
TTATGCTG	TTTGCTGA
TTCAAGAC	TCAAGACG
TTCAAGAT	TTCAGATA
TTCAATAA	TTCAGATA
TTCAATAG	TTCAGATA
TTCAATAT	TTCAGATA
TTCAATAN	TTCAGATA
TGTTCCAA	CGTTCCAA
TTCAATGG	TTCGATGG
TGTTCCGC	TGTTCGGC
TGTTCCGG	TGTTCGGC
TTNCGATG	TTCGATGG
TGTTCGAG	TGTTCGGC
TGTTCGCA	TGTTCGGC
TGTTCGCC	TGTTCGGC
TGTTCGCG	TGTTCGGC
TGTTCGCT	TGTTCGGC
TGNTCGAC	TGTCGACA
TGTTCGCN	TGTTCGGC
TGTTCGGA	TGTTCGGC
TGTTCGGC	TGTTCGGC
TGTTCGGG	TGTTCGGC
TGTTCGGT	TGTTCGGC
TGTTCGGN	TGTTCGGC
TGTTCGTC	TGTTCGGC
TGTTCGTG	TGTTCGGC
TGNTCGGC	TGTTCGGC
TGTTCGNC	TGTTCGGC
TGTTCGNG	TGTTCGGC
TGTTCTAG	TGTCTAGC
TTCACATA	TTCAGATA
TTGGTCCG	ATGGTCCG
TTATTAGC	TTTTAGCC
TGNTCTAG	TGTCTAGC
TGTTCTGC	TGTTCGGC
TGTTCTGG	TGTTCGGC
TGTTCNGC	TGTTCGGC
TGTTCNGG	TGTTCGGC
TTCACGAT	TTCAGATA
TGTTGACA	TGTCGACA
TTCACTAC	CTCACTAC
TTATTTAA	TTGTTTAA
TTGGTCGT	TTGGCGTA
TGTTGCGG	TGTTCGGC
TGTTGCGT	TTTGCGTC
TGTTGCTG	TTTGCTGA
TTGGTGTA	TTGGCGTA
TGTTGGCA	TGTTCGGC
TTGGTTAA	TTGTTTAA
TGTTGGCC	TGTTCGGC
TGTTGGCG	TGTTCGGC
TGTTGGCT	TGTTCGGC
TGTTGGCN	TGTTCGGC
TGTTGGGC	TGTTCGGC
TTCAGAAA	TTCAGATA
TTCAGAAG	TTCAGATA
TTCAGAAT	TTCAGATA
TTCAGAAN	TTCAGATA
TGTTGTAT	GTTGTATT
TTCAGACT	TTCAGATA
TTCAGAGA	TTCAGATA
TTGGTTTA	TTGTTTAA
TTCAGAGT	TTCAGATA
TTCAGATA	TTCAGATA
TTCAGATC	TTCAGATA
TTCAGATT	TTCAGATA
TTCAGATN	TTCAGATA
TTCAGANA	TTCAGATA
TTCAGANT	TTCAGATA
TTCAGCAT	TTCAGATA
TTNCTATA	TTCTATAC
TTCAGCTA	TTCAGATA
TTCNGATA	TTCAGATA
TTCAGGAT	TTCAGATA
TTCNGATG	TTCGATGG
TTCAGGTA	TTCAGATA
TTCAGTAA	TTCAGATA
TTCAGTAC	TTCAGATA
TTCAGTAG	TTCAGATA
TTCAGTAT	TTCAGATA
TTCAGTAN	TTCAGATA
TTCAGTTA	TTCAGATA
TGTTTAAA	TTGTTTAA
TGTTTAAC	TTGTTTAA
TGTTTAAG	TTGTTTAA
TGTTTAAT	TTGTTTAA
TTGGNCGT	TTGGCGTA
TGTTTAAN	TTGTTTAA
TTCAGNAT	TTCAGATA
TTCAGNTA	TTCAGATA
TTGGNGTA	TTGGCGTA
TGTTTCGG	TGTTCGGC
TGTTTGGC	TGTTCGGC
TTCATACA	TTCTATAC
TTCATACC	TTCTATAC
TGTTTGTA	TCTTTGTA
TGNTTCGG	TGTTCGGC
TTCATACG	TTCTATAC
TTCATACT	TTCTATAC
TTCATACN	TTCTATAC
TTCNTATA	TTCTATAC
TTCATGAT	TTCAGATA
TTCATGGA	TTCGATGG
TTCATGGC	TTCGATGG
TTCATGGG	TTCGATGG
TTCATGGT	TTCGATGG
TTCATGGN	TTCGATGG
TTCANATA	TTCAGATA
TTGTAGAA	TTGAGAAC
TTGTAGAC	TTTAGACA
TTGTAGCC	TTTTAGCC
TTGTATAA	TTGTTTAA
TTCANGAT	TTCAGATA
TTGTATAC	TTCTATAC
TGTTNCGG	TGTTCGGC
TTGTATTC	GTTGTATT
TTGTATTG	GTTGTATT
TTGTATTT	GTTGTATT
TTGTATTN	GTTGTATT
TGTTNGGC	TGTTCGGC
TTTATACC	TTCTATAC
TTTATACG	TTCTATAC
TTTATACT	TTCTATAC
TTTATACN	TTCTATAC
TTTATAGC	TTTTAGCC
TTTATGAC	TTTAGACA
TTGTCGAC	TGTCGACA
TTGTCGTA	TTGGCGTA
TTGTCTAA	TTGTTTAA
TTGTCTAG	TGTCTAGC
TTTANACA	TTTAGACA
TTGAAAAC	TTGAGAAC
TTGTCTTA	TTGTTTAA
TTGAAACA	TTGAGAAC
TTGAAACC	TTGAGAAC
TTGAAACG	TTGAGAAC
TTGAAACT	TTGAGAAC
TTTGCAGA	TTTGCTGA
TTGAAACN	TTGAGAAC
TTTGCAGT	TTTGCGTC
TTTGCATC	TTTGCGTC
TTTGCATG	TTTGCTGA
TTTGCCGA	TTTGCTGA
TTTGCCGT	TTTGCGTC
TTTGCCTC	TTTGCGTC
TTTGCCTG	TTTGCTGA
TTTGCGAA	TTTGCTGA
TTTGCGAG	TTTGCTGA
TTTGCGAN	TTTGCTGA
TTTGCGCA	TTTGCGTC
TTTGCGCC	TTTGCGTC
TTTGCGCG	TTTGCGTC
TTTGCGCT	TTTGCGTC
TTTGCGCN	TTTGCGTC
TTTGCGGA	TTTGCTGA
TTTGCGGC	TTTGCGTC
TTTGCGGT	TTTGCGTC
TTTANGAC	TTTAGACA
TTGAAGAA	TTGAGAAC
TTTGCGTC	TTTGCGTC
TTTGCGTT	TTTGCGTC
TTGAAGAG	TAGAAGAG
TTTGCGTN	TTTGCGTC
TTTGCGNC	TTTGCGTC
TTTGCGNT	TTTGCGTC
TTTGCTAA	TTTGCTGA
TTTGCTAC	TTTGCTGA
TTTGCTAG	TTTGCTGA
TTTGCTAT	TTTGCTGA
TTTGCTAN	TTTGCTGA
TTGTGAAC	TTGAGAAC
TTTGCTCC	TTTGCGTC
TTTGCTCT	TTTGCGTC
TTTGCTCN	TTTGCGTC
TTTGCTGA	TTTGCTGA
TTTGCTGC	TTTGCTGA
TTTGCTGG	TTTGCTGA
TTTGCTGN	TTTGCTGA
TTTGCTTA	TTTGCTGA
TTTGCTTC	TTTGCGTC
TTTGCTTG	TTTGCTGA
TTTGCTNA	TTTGCTGA
TTTGCTNG	TTTGCTGA
TTTGCNGA	TTTGCTGA
TTTGCNGT	TTTGCGTC
TTTGCNTC	TTTGCGTC
TNATCGAT	TAATCGAT
TTTGCNTG	TTTGCTGA
TGTNCGAC	TGTCGACA
TTTGGACA	TTTAGACA
TGTNCGGC	TGTTCGGC
TTGTGCTG	TTTGCTGA
TGTNCTAG	TGTCTAGC
TTTGGCTG	TTTGCTGA
TTTGGGTC	TTTGCGTC
TTGACAAC	TTGAGAAC
TTTGGTCA	TTTGCGTC
TTTGGTCC	TTTGCGTC
TTTGGTCG	TTTGCGTC
TTTGGTCT	TTTGCGTC
TTTGGTCN	TTTGCGTC
TTTGGTGA	TTTGCTGA
TTGTGTAA	TTGTTTAA
TGTNGACA	TGTCGACA
TTGTGTTA	TTGTTTAA
TTTCAGAC	TTTAGACA
TTTCAGAT	TTCAGATA
TTTCAGCC	TTTTAGCC
TTGACGAA	TTGAGAAC
TTGACGTA	TTGGCGTA
TTTGTAGC	TTTTAGCC
TTTGTATT	GTTGTATT
TTGTTAAA	TTGTTTAA
TTGTTAAC	TTGTTTAA
TTGTTAAG	TTGTTTAA
TTGTTAAT	TTGTTTAA
TTGTTAAN	TTGTTTAA
TTTGTCGT	TTTGCGTC
TTTGTCTG	TTTGCTGA
TTGTTAGC	TTTTAGCC
TTGTTATA	TTGTTTAA
TTTGTGAA	TTTGCTGA
TTTGTGAC	TTTGCTGA
TTGTTCAA	TTGTTTAA
TTTGTGAG	TTTGCTGA
TTTGTGAT	TTTGCTGA
TTTGTGAN	TTTGCTGA
TTGTTCGG	TGTTCGGC
TTTGTGTC	TTTGCGTC
TTGTTCTA	TTGTTTAA
TTTCCCAG	CTTCCCAG
TTGTTGAA	TTGTTTAA
TTTGTTGA	TTTGCTGA
TTGTTGTA	TTGTTTAA
TTTGTTTA	TTGTTTAA
TTGTTTAA	TTGTTTAA
TTGTTTAC	TTGTTTAA
TTGTTTAG	TTGTTTAA
TTGTTTAT	TTGTTTAA
TTGTTTAN	TTGTTTAA
TTGTTTCA	TTGTTTAA
TTGAGAAA	TTGAGAAC
TTGAGAAC	TTGAGAAC
TTGAGAAG	TTGAGAAC
TTGAGAAT	TTGAGAAC
TTGAGAAN	TTGAGAAC
TTGTTTGA	TTGTTTAA
TTGAGACC	TTGAGAAC
TTGAGACG	TTGAGAAC
TTGAGACT	TTGAGAAC
TTGAGACN	TTGAGAAC
TTGTTTTA	TTGTTTAA
TTGTTTNA	TTGTTTAA
TTGTTNAA	TTGTTTAA
TTGAGAGA	TTGAGAAC
TTGAGAGC	TTGAGAAC
TTGAGATC	TTGAGAAC
TTGTTNTA	TTGTTTAA
TTGAGANA	TTGAGAAC
TTGAGANC	TTGAGAAC
TTGAGCAA	TTGAGAAC
TTGAGCAC	TTGAGAAC
TGTNTAGC	TGTCTAGC
TTTCCGTC	TTTGCGTC
TTTCCTGA	TTTGCTGA
TTTGNCGT	TTTGCGTC
TTTGNCTG	TTTGCTGA
TGTNTCGG	TGTTCGGC
TTGAGCGT	TTGGCGTA
TTTGNGTC	TTTGCGTC
TTGAGGAA	TTGAGAAC
TTGAGGAC	TTGAGAAC
TTTGNTGA	TTTGCTGA
TNCTTTGT	TCTTTGTA
TTGTNTAA	TTGTTTAA
TTTCGATG	TTCGATGG
TTGAGGTT	TAGAGGTT
TTGTNTTA	TTGTTTAA
TTGAGTAA	TTGAGAAC
TTGAGTAC	TTGAGAAC
TTTTAACC	TTTTAGCC
TTTTAAGC	TTTTAGCC
TTTCGCGT	TTTGCGTC
TTTCGCTG	TTTGCTGA
TTTTACCA	TTTTAGCC
TTTTACCC	TTTTAGCC
TTTTACCG	TTTTAGCC
TTTTACCT	TTTTAGCC
TTTTACCN	TTTTAGCC
TTTCGGCA	TGTTCGGC
TTTCGGCC	TGTTCGGC
TTTCGGCG	TGTTCGGC
TTTCGGCT	TGTTCGGC
TTTCGGCN	TGTTCGGC
TTTTACGC	TTTTAGCC
TTGAGNAA	TTGAGAAC
TTGAGNAC	TTGAGAAC
TTTCGTCA	TTTGCGTC
TTTCGTCC	TTTGCGTC
TTTCGTCG	TTTGCGTC
TTTCGTCT	TTTGCGTC
TTTCGTCN	TTTGCGTC
TTTTAGCA	TTTTAGCC
TTTTAGCC	TTTTAGCC
TTTTAGCG	TTTTAGCC
TTTTAGCT	TTTTAGCC
TTTTAGCN	TTTTAGCC
TTTTAGGC	TTTTAGCC
TTGANAAC	TTGAGAAC
TTTTAGTC	TTTTAGCC
TTGATAAA	CTGATAAA
TTGATAAC	TTGAGAAC
TTTTAGNC	TTTTAGCC
TTTTATAC	TTCTATAC
TTTTATCC	TTTTAGCC
TTTTATGC	TTTTAGCC
TTTCTATA	TTCTATAC
TTTTANCC	TTTTAGCC
TTTTANGC	TTTTAGCC
TNAACTCA	TAACTCAG
TNAACTTC	TCAACTTC
TTTCTGAA	TTTGCTGA
TTTTCAGC	TTTTAGCC
TTTCTGAC	TTTGCTGA
TTTCTGAG	TTTGCTGA
TTTCTGAT	TTTGCTGA
TTTCTGAN	TTTGCTGA
TTGANGAA	TTGAGAAC
TTGATGAA	TTGAGAAC
TTGATGGA	TTCGATGG
TNAAGACG	TCAAGACG
TTGATGGC	TTCGATGG
TTGATGGG	TTCGATGG
TTGATGGT	TTCGATGG
TTGATGGN	TTCGATGG
TTTTCGCC	TTTTAGCC
TTCCACCG	TGCCACCG
TTTTCGGC	TGTTCGGC
TTGATTAA	TTGTTTAA
TTTTCGTC	TTTGCGTC
TTGATTTA	TTGTTTAA
TTCCAGAT	TTCAGATA
TTTTCTGA	TTTGCTGA
TTCCATAC	TTCTATAC
TTCCATGG	TTCGATGG
TTTTGACA	TTTAGACA
TTNGAGAA	TTGAGAAC
TTCCCAGA	CTTCCCAG
TTCCCAGC	CTTCCCAG
TTCCCAGG	CTTCCCAG
TTCCCAGT	CTTCCCAG
TTCCCAGN	CTTCCCAG
TTTTGAGC	TTTTAGCC
TNAATCGA	TAATCGAT
TTCCCGCA	TACCCGCA
TTNGATGG	TTCGATGG
TTTTGCCA	TTTTAGCC
TTTTGCCC	TTTTAGCC
TTTTGCCG	TTTTAGCC
TTTTGCCT	TTTTAGCC
TTTTGCCN	TTTTAGCC
TTCCCTCT	ATCCCTCT
TTTTGCGT	TTTGCGTC
TTTTGCTG	TTTGCTGA
TNTAGACA	TTTAGACA
TTGCAGAA	TTGAGAAC
TTGCAGAT	TTCAGATA
TTTTGGCC	TTTTAGCC
TTTGACAA	TTTAGACA
TTTGACAC	TTTAGACA
TTTGACAG	TTTAGACA
TTTGACAT	TTTAGACA
TTTGACAN	TTTAGACA
TTTGACGT	TTTGCGTC
TTTTGTAA	TCTTTGTA
TTTGACTG	TTTGCTGA
TTTGAGAA	TTGAGAAC
TTTTGTAC	TCTTTGTA
TTTTGTAG	TCTTTGTA
TTTGAGAC	TTTAGACA
TTTTGTAT	TCTTTGTA
TTTTGTAN	TCTTTGTA
TTTGAGCC	TTTTAGCC
TTGCATGG	ATGCATGG
TTCCGATA	TTCAGATA
TTCCGATG	TTCGATGG
TTTGAGTC	TTTGCGTC
TTNGCGTA	TTGGCGTA
TTNGCGTC	TTTGCGTC
TTNGCTGA	TTTGCTGA
TTTGATGA	TTTGCTGA
TTGCCACC	TGCCACCG
TTTTTAAA	TTGTTTAA
TTTTTAAC	TTGTTTAA
TTTTTAAG	TTGTTTAA
TTTTTAAT	TTGTTTAA
TTTTTAAN	TTGTTTAA
TTTGATGG	TTCGATGG
TTTTTAGC	TTTTAGCC
TTCCGGGA	TCCGGGAC
TTGCCGTA	TTGGCGTA
TTTTTGCC	TTTTAGCC
TTNGGCGT	TTGGCGTA
TTTTTGTA	TCTTTGTA
TTGCCTTT	CTGCCTTT
TTTTTTAA	TTGTTTAA
TTCCTATA	TTCTATAC
TTGCGAAC	TTGAGAAC
TTGCGACT	TGGCGACT
TTGCGATG	TTCGATGG
TTGCGCGT	TTGGCGTA
TTCCTGGC	ATCCTGGC
TTGCGGGT	TGCGGGTT
TTGCGTAA	TTGGCGTA
TTGCGTAC	TTGGCGTA
TTGCGTAG	TTGGCGTA
TTGCGTAT	TTGGCGTA
TTGCGTAN	TTGGCGTA
TTGCGTCA	TTTGCGTC
TTGCGTCC	TTTGCGTC
TTGCGTCG	TTTGCGTC
TTGCGTCT	TTTGCGTC
TTGCGTCN	TTTGCGTC
TTNGTTTA	TTGTTTAA
TNCAACTT	TCAACTTC
TNCAAGAC	TCAAGACG
TTGCTATA	TTCTATAC
TTGCTGAA	TTTGCTGA
TTGCTGAC	TTTGCTGA
TTGCTGAG	TTTGCTGA
TTGCTGAT	TTTGCTGA
TTGCTGAN	TTTGCTGA
TNACCCGC	TACCCGCA
TTGCTTAA	TTGTTTAA
TTGCTTTA	TTGTTTAA
TNTCAGAT	TTCAGATA
TTNTAGAC	TTTAGACA
TTNTAGCC	TTTTAGCC
TTNTATAC	TTCTATAC
TTCGAAGG	TTCGATGG
TTCGAATG	TTCGATGG
TTCGACAA	TGTCGACA
TTCGACAC	TGTCGACA
TTCGACAG	TGTCGACA
TTCGACAT	TGTCGACA
TTCGACAN	TGTCGACA
TTCGACGG	TTCGATGG
TTCGACTG	TTCGATGG
NAAGGAGT	AAGGAGTG
TTCGAGAA	TTGAGAAC
TTCGAGAT	TTCAGATA
TNCAGATA	TTCAGATA
TTGGAACA	TTGAGAAC
TTGGAACC	TTGAGAAC
TTGGAACG	TTGAGAAC
TTCGAGGA	TTCGATGG
TTCGAGGC	TTCGATGG
TTCGAGGG	TTCGATGG
TTCGAGGT	TTCGATGG
TTCGAGGN	TTCGATGG
TTGGAACT	TTGAGAAC
TTGGAACN	TTGAGAAC
TTCGAGTG	TTCGATGG
TTCGATAA	TTCAGATA
TTCGATAT	TTCAGATA
TTCGATAN	TTCAGATA
TTCGATCG	TTCGATGG
TTCGATGA	TTCGATGG
TTCGATGC	TTCGATGG
TTCGATGG	TTCGATGG
NAAGGGGA	AAGGGGAC
TTCGATGT	TTCGATGG
TTCGATGN	TTCGATGG
TTCGATTG	TTCGATGG
TTCGATNG	TTCGATGG
TTGGACGT	TTGGCGTA
TTCGANGG	TTCGATGG
TTCGANTG	TTCGATGG
TTGGAGAA	TTGAGAAC
TTGGAGTA	TTGGCGTA
TTCGCATG	TTCGATGG
TTGGATGG	TTCGATGG
TTCGCGTA	TTGGCGTA
TTCGCGTC	TTTGCGTC
NAAGTGCT	AAGTGCTG
NAAGTGGT	AAGTGGTG
TTCGCTGA	TTTGCTGA
TTCGCTGG	TTCGATGG
TTGGCAGT	TTGGCGTA
TTGGCATA	TTGGCGTA
TTNTGCGT	TTTGCGTC
TTNTGCTG	TTTGCTGA
TTGGCCGT	TTGGCGTA
TTCGGATA	TTCAGATA
TTCGGATG	TTCGATGG
TTGGCCTA	TTGGCGTA
TNACTCAG	TAACTCAG
TTGGCGAA	TTGGCGTA
TTGGCGAG	TTGGCGTA
TTGGCGAT	TTGGCGTA
TTGGCGAN	TTGGCGTA
TTGGCGCA	TTGGCGTA
TTGGCGCT	TTGGCGTA
TTGGCGGA	TTGGCGTA
TTGGCGGT	TTGGCGTA
TTGGCGTA	TTGGCGTA
TTGGCGTG	TTGGCGTA
TTGGCGTT	TTGGCGTA
TTGGCGTN	TTGGCGTA
TTGGCGNA	TTGGCGTA
TTCGGCGT	TTGGCGTA
TTGGCGNT	TTGGCGTA
TTGGCTAA	TTGGCGTA
TTGGCTAC	TTGGCGTA
TTGGCTAG	TTGGCGTA
TTGGCTAT	TTGGCGTA
TTGGCTAN	TTGGCGTA
TTCGGGAC	TCCGGGAC
TTGGCTGA	TTTGCTGA
TTGGCTGT	TTGGCGTA
TTGGCTTA	TTGGCGTA
TTCGGGGG	TCGGGGGA
TTCGGGTT	TGCGGGTT
TTGGCNGT	TTGGCGTA
TTGGCNTA	TTGGCGTA
TTNTTAGC	TTTTAGCC
TTCGGTGG	TTCGATGG
TTNTTTAA	TTGTTTAA
TTTTNAGC	TTTTAGCC
TTTTNGCC	TTTTAGCC
TNGAAGAG	TAGAAGAG
NAATCACC	AATCACCC
TNCCACCG	TGCCACCG
NAATCGAT	TAATCGAT
NAATCGCT	AAATCGCT
TTTNAGAC	TTTAGACA
TTTNAGCC	TTTTAGCC
TNGTCGAC	TGTCGACA
TNGTCTAG	TGTCTAGC
TNGAGAAC	TTGAGAAC
TNTCGACA	TGTCGACA
TNTCGATG	TTCGATGG
TTTNCGTC	TTTGCGTC
TNCCCGCA	TACCCGCA
TNGAGGTT	TAGAGGTT
TTTNCTGA	TTTGCTGA
NAATTTTC	GAATTTTC
TNGTTCGG	TGTTCGGC
TNGTTTAA	TTGTTTAA
TTTNGACA	TTTAGACA
TTTNGCGT	TTTGCGTC
TTTNGCTG	TTTGCTGA
TNTCTAGC	TGTCTAGC
TNTCTATA	TTCTATAC
TTTNTAGC	TTTTAGCC
TNCCGGGA	TCCGGGAC
NATATCAT	GATATCAT
NATATCGG	CATATCGG
NATATCTC	ATATCTCT
TNTTAGAC	TTTAGACA
TNTTAGCC	TTTTAGCC
TNGCCACC	TGCCACCG
TNTGAGAA	TTGAGAAC
TNTTCGGC	TGTTCGGC
TNTTGCGT	TTTGCGTC
TNTTGCTG	TTTGCTGA
NATCACCC	AATCACCC
TNTTTAGC	TTTTAGCC
TNTTTGTA	TCTTTGTA
TNTGCGTC	TTTGCGTC
TNTGCTGA	TTTGCTGA
NATCCCTC	ATCCCTCT
TNTGGCGT	TTGGCGTA
NATCCTGG	ATCCTGGC
TNTGTTTA	TTGTTTAA
TNGCGACT	TGGCGACT
TNCGATGG	TTCGATGG
TNGCGGGT	TGCGGGTT
NATCTGAG	ATCTGAGC
NACATCCT	ACATCCTT
NAACCGAA	CAACCGAA
TNCGGGAC	TCCGGGAC
TNCGGGGG	TCGGGGGA
TNCGGGTT	TGCGGGTT
NCATATCG	CATATCGG
NAACGCAT	AACGCATG
NAGAAGAG	TAGAAGAG
NAGAATAA	AAGAATAA
NAACTCAG	TAACTCAG
NCATCCTT	ACATCCTT
NAACTGGG	AACTGGGA
NCATGACG	CATGACGC
TNCTATAC	TTCTATAC
NAAGAATA	AAGAATAA
NCATTCCC	CATTCCCT
NACCCGCA	TACCCGCA
NACACAAG	ACACAAGT
TNGGCGAC	TGGCGACT
NCATTTTT	CATTTTTT
TNGGCGTA	TTGGCGTA
NACCGGTT	ACCGGTTG
TNGGGGGA	TCGGGGGA
NACAGTTA	GACAGTTA
NAGAGGTT	TAGAGGTT
NACGAAAC	ACGAAACT
NATGACGC	CATGACGC
NACGATCT	ACGATCTG
NATGCATG	ATGCATGG
NCTCACTA	CTCACTAC
NATTTTTT	CATTTTTT
NATGGTCC	ATGGTCCG
NCGAAACT	ACGAAACT
NCGAACAT	CCGAACAT
NCTCGTTC	GCTCGTTC
NACGCAGC	ACGCAGCC
NACGCATG	AACGCATG
NACGCCCT	ACGCCCTA
NCGACGCT	CGACGCTG
NACGCGCT	CACGCGCT
NAGCTTGC	CAGCTTGC
NATTCCCT	CATTCCCT
NAAAAAGC	GAAAAAGC
NATAAAGT	ATAAAGTC
NACGGCCA	ACGGCCAG
NCGATCTG	ACGATCTG
NCGATTAA	CCGATTAA
NCTGATAA	CTGATAAA
NACGTATT	ACGTATTA
NCACGCGC	CACGCGCT
NACGTGGG	CACGTGGG
NCTGCCTT	CTGCCTTT
NCACGTGG	CACGTGGG
NCCCCTTC	CCCCTTCA
NCCAAATG	CCAAATGC
NACTAATT	ACTAATTT
NCCCTTCA	CCCCTTCA
NACTATGT	GACTATGT
NCCAGAGT	CCAGAGTC
NCAGAGTC	CCAGAGTC
NAAAGTAC	GAAAGTAC
NAAATAGG	GAAATAGG
NCCGAACA	CCGAACAT
NAAATCGC	AAATCGCT
NCAGCTTG	CAGCTTGC
NACTGGGA	AACTGGGA
NCCGATTA	CCGATTAA
NAGGACAT	AGGACATT
NAGGAGTG	AAGGAGTG
NCCCAGTC	GCCCAGTC
NCCGGGAC	TCCGGGAC
NCCGGTTG	ACCGGTTG
NAGGCCGC	AGGCCGCC
NCGCAGCC	ACGCAGCC
NCGCCCTA	ACGCCCTA
NAGGGGAC	AAGGGGAC
NGCAAAAT	GGCAAAAT
NGGAAAAG	GGAAAAGA
NCTTACGG	GCTTACGG
NGTCGACA	TGTCGACA
NCTTCCCA	CTTCCCAG
NGGACATT	AGGACATT
NGTCTAGC	TGTCTAGC
NGGACCCG	GGGACCCG
NCGGCCAG	ACGGCCAG
NCTAATTT	ACTAATTT
NCTTTACC	GCTTTACC
NCGGGGGA	TCGGGGGA
NCTACGGT	CCTACGGT
NCTTTGTA	TCTTTGTA
NCGGGTTC	CGGGTTCG
NCCTACGG	CCTACGGT
NCTAGCGA	CTAGCGAC
NAGTGCTG	AAGTGCTG
NAGTGGTG	AAGTGGTG
NGGATGAA	GGATGAAC
NCAAATGC	CCAAATGC
NGTGTCCA	CGTGTCCA
NCAACCGA	CAACCGAA
NGTGTTTC	GGTGTTTC
NGGCAAAA	GGCAAAAT
NCAACTTC	TCAACTTC
NCAAGACG	TCAAGACG
NGGCCGCC	AGGCCGCC
NGCCACCG	TGCCACCG
NGGCGACT	TGGCGACT
NGCCCAGT	GCCCAGTC
NCACAAGT	ACACAAGT
NGCGGGTT	TGCGGGTT
NGATATCA	GATATCAT
NGCGTAAA	GCGTAAAT
NGAAAAAG	GAAAAAGC
NGAAAAGA	GGAAAAGA
NGAAAGTA	GAAAGTAC
NGAAATAG	GAAATAGG
NGCGTTAA	GCGTTAAC
NGATGAAC	GGATGAAC
NGTTAGCA	GTTAGCAA
NTCAACTT	TCAACTTC
NTCAAGAC	TCAAGACG
NGTTCCAA	CGTTCCAA
NGTTCGGC	TGTTCGGC
NTCACTAC	CTCACTAC
NGTACCCG	GTACCCGG
NGCTCGTT	GCTCGTTC
NGTTGTAT	GTTGTATT
NTCAGATA	TTCAGATA
NCGTAAAT	GCGTAAAT
NGTAGAAC	GTAGAACC
NTGATAAA	CTGATAAA
NCGTATTA	ACGTATTA
NGGGACCC	GGGACCCG
NGTATACG	GTATACGA
NTTGAGAA	TTGAGAAC
NCGTGTCC	CGTGTCCA
NCGTTAAC	GCGTTAAC
NGGGTTCG	CGGGTTCG
NCGTTCCA	CGTTCCAA
NTGCATGG	ATGCATGG
NTTGCGTC	TTTGCGTC
NTGCCACC	TGCCACCG
NTTGCTGA	TTTGCTGA
NGCTTACG	GCTTACGG
NTGCCTTT	CTGCCTTT
NGCTTTAC	GCTTTACC
NTTGGCGT	TTGGCGTA
NTGCGGGT	TGCGGGTT
NTTGTATT	GTTGTATT
NTATACGA	GTATACGA
NTCCCTCT	ATCCCTCT
NTTGTTTA	TTGTTTAA
NTCCGGGA	TCCGGGAC
NTAAAGTC	ATAAAGTC
NTCCTGGC	ATCCTGGC
NTATCTCT	ATATCTCT
NGAATTTT	GAATTTTC
NTTTAGAC	TTTAGACA
NTTTAGCC	TTTTAGCC
NTAACTCA	TAACTCAG
NTCGGGGG	TCGGGGGA
NTCGATGG	TTCGATGG
NTTTGCGT	TTTGCGTC
NGACAGTT	GACAGTTA
NTTTGCTG	TTTGCTGA
NTAATCGA	TAATCGAT
NTTTTAGC	TTTTAGCC
NGACGCTG	CGACGCTG
NTGGCGAC	TGGCGACT
NTGGCGTA	TTGGCGTA
NGACTATG	GACTATGT
NTTAGACA	TTTAGACA
NTTAGCAA	GTTAGCAA
NTCTATAC	TTCTATAC
NTGGTCCG	ATGGTCCG
NTCTGAGC	ATCTGAGC
NGGTGTTT	GGTGTTTC
NTTCAGAT	TTCAGATA
NTGTCGAC	TGTCGACA
NTTCCCAG	CTTCCCAG
NTCTTTGT	TCTTTGTA
NTGTCTAG	TGTCTAGC
NTTCGATG	TTCGATGG
NTTCTATA	TTCTATAC
NTGTTCGG	TGTTCGGC
NTGTTTAA	TTGTTTAA
NTACCCGC	TACCCGCA
NTACCCGG	GTACCCGG
NTGAGAAC	TTGAGAAC
NTAGAACC	GTAGAACC
NTAGAAGA	TAGAAGAG
NTAGAGGT	TAGAGGTT
NTAGCGAC	CTAGCGAC
