AACCGAAA	CAACCGAA
AACCGAAC	CAACCGAA
AACCGAAG	CAACCGAA
AACCGAAT	CAACCGAA
AACCGAAN	CAACCGAA
AAATCACC	AATCACCC
AAATCACT	AAATCGCT
AAAAAAGC	GAAAAAGC
AAATCAGC	AAATCGCT
AACTAATT	ACTAATTT
AAACTCAG	TAACTCAG
AACCGCAT	AACGCATG
AAATCCCT	AAATCGCT
AAACTCGC	AAATCGCT
AAATCCGC	AAATCGCT
AAATCCTA	AAATCGCT
AAGCCCTA	ACGCCCTA
AAATCCTC	AAATCGCT
AAATCCTG	AAATCGCT
AAAAAGCA	GAAAAAGC
AAAAAGCC	GAAAAAGC
AAATCCTN	AAATCGCT
AAAAAGCG	GAAAAAGC
AAAAAGCT	GAAAAAGC
AAAAAGCN	GAAAAAGC
AAATCGAC	AAATCGCT
AAAAAGTC	ATAAAGTC
AAATCGCA	AAATCGCT
AAATCGCC	AAATCGCT
AAGCCGCC	AGGCCGCC
AAATCGCG	AAATCGCT
AACCGGGA	AACTGGGA
AAATCGCT	AAATCGCT
AAATCGCN	AAATCGCT
AAACTGGG	AACTGGGA
AAATCGGC	AAATCGCT
AACNTGGG	AACTGGGA
AACTAGGA	AACTGGGA
AAATCGGT	AAATCGCT
AACTAGGG	AACTGGGA
AAATCGTA	AAATCGCT
AACCGGTT	ACCGGTTG
AAATCGTC	AAATCGCT
AAATCGTG	AAATCGCT
AAATCGTT	AAATCGCT
AAATCGTN	AAATCGCT
AAATCGNC	AAATCGCT
AAATCGNT	AAATCGCT
AAATCTGC	AAATCGCT
AAATCNCT	AAATCGCT
AAATCNGC	AAATCGCT
AACTCACC	AATCACCC
AAGCGAGT	AAGGAGTG
AACTCAGA	TAACTCAG
AACTCAGC	TAACTCAG
AACTCAGG	TAACTCAG
AACTCAGT	TAACTCAG
AACTCAGN	TAACTCAG
AACTCATG	AACGCATG
AAGCGCAT	AACGCATG
AAAACGCT	AAATCGCT
AAATGCGC	AAATCGCT
AAGCGCTG	AAGTGCTG
AAATGCTA	AAATCGCT
AAATGCTC	AAATCGCT
AAGCGGAC	AAGGGGAC
AAATGCTT	AAATCGCT
AAATGCTN	AAATCGCT
AACCTGGC	ATCCTGGC
AACCTGGG	AACTGGGA
AAGCGGGA	AAGGGGAC
AACAAGTA	ACACAAGT
AACAAGTC	ACACAAGT
AACAAGTG	ACACAAGT
AACAAGTT	ACACAAGT
AACAAGTN	ACACAAGT
AAATGGCT	AAATCGCT
AAGCGGTG	AAGTGGTG
AAATGGGA	AACTGGGA
AACAATAA	AAGAATAA
AACTCGCT	AAATCGCT
AAATGGTG	AAGTGGTG
AACTCGGA	AACTGGGA
AACTCGGG	AACTGGGA
AACACAAG	ACACAAGT
AAAGAATA	AAGAATAA
AACACATG	AACGCATG
AACTGAGA	AACTGGGA
AACTGAGC	ATCTGAGC
AACTGAGG	AACTGGGA
AACACCCA	AATCACCC
AACACCCC	AATCACCC
AACACCCG	AATCACCC
AACACCCT	AATCACCC
AACACCCN	AATCACCC
AACTGCAT	AACGCATG
AACTGCGA	AACTGGGA
AAAGAGTG	AAGGAGTG
AACTGCGG	AACTGGGA
AAATTCGC	AAATCGCT
AACTGCTG	AAGTGCTG
AAGCTGCT	AAGTGCTG
AAGCTGGG	AACTGGGA
AAGCTGGT	AAGTGGTG
AACTGGAA	AACTGGGA
AACTGGAC	AACTGGGA
AACTGGAG	AACTGGGA
AACTGGAT	AACTGGGA
AACTGGAN	AACTGGGA
AACTGGCA	AACTGGGA
AACTGGCG	AACTGGGA
AAATTGCT	AAATCGCT
AACTGGGA	AACTGGGA
AACTGGGC	AACTGGGA
AACTGGGG	AACTGGGA
AACTGGGT	AACTGGGA
AAGCTTGC	CAGCTTGC
AACTGGGN	AACTGGGA
AACTGGTA	AACTGGGA
AACTGGNA	AACTGGGA
AACTGGNG	AACTGGGA
AAAAGTAC	GAAAGTAC
AACTGTGA	AACTGGGA
AAATTTTC	GAATTTTC
AAAAGTCA	ATAAAGTC
AACTGTGG	AACTGGGA
AAAAGTCC	ATAAAGTC
AAAAGTCG	ATAAAGTC
AAAAGTCT	ATAAAGTC
AAAAGTCN	ATAAAGTC
AACGAAAC	ACGAAACT
AAAGCATG	AACGCATG
AACTGNGA	AACTGGGA
AAGAAAAC	AAGAATAA
AACGAATA	AAGAATAA
AACTGNGG	AACTGGGA
AAGAAAAG	AAGAATAA
AAGAAAAT	AAGAATAA
AACGAATG	AACGCATG
AAGAAAAN	AAGAATAA
AAGAAACT	ACGAAACT
AAGAAATA	AAGAATAA
AACGACAT	AACGCATG
AAGAACAA	AAGAATAA
AACAGCAT	AACGCATG
AAAGCGCT	AAATCGCT
AAGAACTA	AAGAATAA
AAATNCGC	AAATCGCT
AAGAAGAA	AAGAATAA
AAAATAAC	AAGAATAA
AAGAAGAG	TAGAAGAG
AAAATAAG	AAGAATAA
AAAATAAT	AAGAATAA
AAAATAAN	AAGAATAA
AACGAGTG	AAGGAGTG
AACAGGGA	AACTGGGA
AAAATAGG	GAAATAGG
AAATNGCT	AAATCGCT
AAGAAGTA	AAGAATAA
AAGAAGTG	AAGGAGTG
AACTTGGA	AACTGGGA
AAGAATAA	AAGAATAA
AAGAATAC	AAGAATAA
AAGAATAG	AAGAATAA
AAGAATAT	AAGAATAA
AAGAATAN	AAGAATAA
AAGAATCA	AAGAATAA
AACGATGA	AACGCATG
AACTTGGG	AACTGGGA
AACGATGC	AACGCATG
AACGATGG	AACGCATG
AACGATGT	AACGCATG
AAGAATGA	AAGAATAA
AACGATGN	AACGCATG
AAGAATTA	AAGAATAA
AACAGTTA	GACAGTTA
AAGAATNA	AAGAATAA
AAAATCGC	AAATCGCT
AAGAANAA	AAGAATAA
AAAGGAGT	AAGGAGTG
AAGAANTA	AAGAATAA
AAGGAAGT	AAGGAGTG
AAGGAATA	AAGAATAA
AACGCAAG	AACGCATG
AAGGAATG	AAGGAGTG
AACGCAAT	AACGCATG
AACGCACG	AACGCATG
AACGCACT	AACGCATG
AACGCAGA	AACGCATG
AACGCAGG	AACGCATG
AAGGACAT	AGGACATT
AACGCAGT	AACGCATG
AACGCAGN	AACGCATG
AACGCATA	AACGCATG
AAGACATA	AAGAATAA
AACGCATC	AACGCATG
AACGCATG	AACGCATG
AACGCATT	AACGCATG
AAGACATT	AGGACATT
AACGCATN	AACGCATG
AACGCANG	AACGCATG
AAGGACGT	AAGGAGTG
AACGCANT	AACGCATG
AAGGACTG	AAGGAGTG
AACGCCAT	AACGCATG
AACATCCT	ACATCCTT
AACATCGC	AAATCGCT
AACGCCCT	ACGCCCTA
AAGGAGAC	AAGGGGAC
AAGGAGAG	AAGGAGTG
AAGGAGAT	AAGGAGTG
AAGGAGCG	AAGGAGTG
AAAGGGAC	AAGGGGAC
AAGGAGCT	AAGGAGTG
AACGCCTG	AACGCATG
AAGGAGGC	AAGGAGTG
AAGGAGGG	AAGGAGTG
AAGGAGGT	AAGGAGTG
AAGGAGGN	AAGGAGTG
AAGGAGTA	AAGGAGTG
AAGGAGTC	AAGGAGTG
AAGGAGTG	AAGGAGTG
AAGGAGTT	AAGGAGTG
AAGGAGTN	AAGGAGTG
AACGCGAT	AACGCATG
AAGGAGNG	AAGGAGTG
AAAGGGGA	AAGGGGAC
AAGGAGNT	AAGGAGTG
AAGGATAA	AAGAATAA
AACGCGCT	CACGCGCT
AACATGGG	AACTGGGA
AACTNGGA	AACTGGGA
AAGGATGA	AAGGAGTG
AACGCGTG	AACGCATG
AAGGATGC	AAGGAGTG
AACTNGGG	AACTGGGA
AAGGATGG	AAGGAGTG
AAGGATGT	AAGGAGTG
AAGGATGN	AAGGAGTG
AAGACTAA	AAGAATAA
AAGGATTG	AAGGAGTG
AACGCTAT	AACGCATG
AACGCTGA	AACGCATG
AACGCTGC	AACGCATG
AACGCTGG	AACGCATG
AACGCTGT	AACGCATG
AACGCTGN	AACGCATG
AACGCTTG	AACGCATG
AAGGANGT	AAGGAGTG
AAGGANTG	AAGGAGTG
AACGCNAT	AACGCATG
AAGGCAGT	AAGGAGTG
AACGCNTG	AACGCATG
AAGGCATG	AACGCATG
AAGGCCAG	ACGGCCAG
AAGAGAGT	AAGGAGTG
AAGAGATA	AAGAATAA
AAGGCCGC	AGGCCGCC
AACGGAGT	AAGGAGTG
AACGGATG	AACGCATG
AAGGCGAC	AAGGGGAC
AACGGCAT	AACGCATG
AAAGTACA	GAAAGTAC
AAAGTACC	GAAAGTAC
AACGGCCA	ACGGCCAG
AAAGTACG	GAAAGTAC
AAAGTACT	GAAAGTAC
AAAGTACN	GAAAGTAC
AAGAGCTG	AAGTGCTG
AAGGCGGA	AAGGGGAC
AAACAAGT	ACACAAGT
AAGGCGTG	AAGGAGTG
AAGAGGAC	AAGGGGAC
AACGGGAA	AACTGGGA
AACGGGAG	AACTGGGA
AACGGGAT	AACTGGGA
AACGGGAN	AACTGGGA
AAGAGGGA	AAGGGGAC
AAACACCC	AATCACCC
AAGAGGTG	AAGTGGTG
AAGGCTGA	AAGTGCTG
AAGAGGTT	TAGAGGTT
AAGGCTGC	AAGTGCTG
AAGGCTGG	AAGTGCTG
AAGGCTGT	AAGTGCTG
AAANCGCT	AAATCGCT
AAGGCTGN	AAGTGCTG
AAGAGTAA	AAGAATAA
AAAGTCGC	AAATCGCT
AAGAGTGA	AAGGAGTG
AAGAGTGC	AAGGAGTG
AAAGTGCT	AAGTGCTG
AAAGTGGT	AAGTGGTG
AACGGTTG	ACCGGTTG
AAGGGAAC	AAGGGGAC
AAGGGACA	AAGGGGAC
AAGGGACC	AAGGGGAC
AAGGGACG	AAGGGGAC
AAGGGACT	AAGGGGAC
AAGGGACN	AAGGGGAC
AAGAGTGG	AAGGAGTG
AAGGGAGA	AAGGGGAC
AAGAGTGT	AAGGAGTG
AAGAGTGN	AAGGAGTG
AAGGGAGT	AAGGAGTG
AAGGGCAC	AAGGGGAC
AAGGGCGA	AAGGGGAC
AAGGGCTG	AAGTGCTG
AACNCATG	AACGCATG
AAGGGGAA	AAGGGGAC
AAGGGGAC	AAGGGGAC
AACCACCC	AATCACCC
AAGGGGAG	AAGGGGAC
AAGGGGAT	AAGGGGAC
AAGGGGAN	AAGGGGAC
AAGGGGCA	AAGGGGAC
AAGGGGCC	AAGGGGAC
AAGGGGCG	AAGGGGAC
AAGGGGCT	AAGGGGAC
AACGTATG	AACGCATG
AAGGGGCN	AAGGGGAC
AACGTATT	ACGTATTA
AAGGGGGA	AAGGGGAC
AAGGGGGC	AAGGGGAC
AAGGGGTA	AAGGGGAC
AAGATAAA	AAGAATAA
AAGGGGTC	AAGGGGAC
AAGATAAC	AAGAATAA
AAGATAAG	AAGAATAA
AAGATAAT	AAGAATAA
AAGATAAN	AAGAATAA
AAGGGGNA	AAGGGGAC
AAGGGGNC	AAGGGGAC
AACGTCAT	AACGCATG
AAGGGTAC	AAGGGGAC
AACGTGCT	AAGTGCTG
AAACCGAA	CAACCGAA
AAGGGNAC	AAGGGGAC
AAGATATA	AAGAATAA
AACGTGGT	AAGTGGTG
AACCATGA	AACGCATG
AACCATGC	AACGCATG
AACCATGG	AACGCATG
AAACCGCT	AAATCGCT
AACCATGT	AACGCATG
AAGGGNGA	AAGGGGAC
AACCATGN	AACGCATG
AAGGTAGT	AAGGAGTG
AAGATCGC	AAATCGCT
AAGGTCCG	ATGGTCCG
AACCCATG	AACGCATG
AAGGTGAC	AAGGGGAC
AAGGTGCT	AAGTGCTG
AACGNATG	AACGCATG
AAGGTGGA	AAGGGGAC
AAGGTGGT	AAGTGGTG
AACNGCAT	AACGCATG
AAGGTGTG	AAGGAGTG
AACGNCAT	AACGCATG
AACCCGCA	TACCCGCA
AAGATGCT	AAGTGCTG
AAACGCAT	AACGCATG
AAATACGC	AAATCGCT
AAACGCTA	AAATCGCT
AAACGCTC	AAATCGCT
AAACGCTG	AAATCGCT
AAACGCTT	AAATCGCT
AAACGCTN	AAATCGCT
AAGATGGT	AAGTGGTG
AACNGGGA	AACTGGGA
AACCCTCT	ATCCCTCT
AAGATTAA	AAGAATAA
AAATAGCT	AAATCGCT
AAATAGGA	GAAATAGG
AAATAGGC	GAAATAGG
AAATAGGG	GAAATAGG
AAATAGGT	GAAATAGG
AAATAGGN	GAAATAGG
AAGANATA	AAGAATAA
AAGGNAGT	AAGGAGTG
AATNCACC	AATCACCC
AATGTGCT	AAGTGCTG
AATGTGGT	AAGTGGTG
AAGANTAA	AAGAATAA
AAGGNGAC	AAGGGGAC
AAGNGAGT	AAGGAGTG
AAANTCGC	AAATCGCT
AAGGNGGA	AAGGGGAC
AAGGNGTG	AAGGAGTG
AAGNGCTG	AAGTGCTG
AAGNGGAC	AAGGGGAC
AAGNGGGA	AAGGGGAC
AAGNGGTG	AAGTGGTG
AAGCAATA	AAGAATAA
AAGCACCC	AATCACCC
AAGTAATA	AAGAATAA
AANCACCC	AATCACCC
AAGCAGCC	ACGCAGCC
AAGCAGTG	AAGGAGTG
AATCAACC	AATCACCC
AAGTACTG	AAGTGCTG
AAGCATAA	AAGAATAA
AAGCATGA	AACGCATG
AAGCATGC	AACGCATG
AAGCATGT	AACGCATG
AAGCATGN	AACGCATG
AATCACAC	AATCACCC
AATCACCA	AATCACCC
AATCACCC	AATCACCC
AATCACCG	AATCACCC
AATCACCT	AATCACCC
AATCACCN	AATCACCC
AATCACGC	AATCACCC
AATCACTC	AATCACCC
AATCACNC	AATCACCC
AAGTAGCT	AAGTGCTG
AATCAGCC	AATCACCC
AAGTAGGT	AAGTGGTG
AAGTATAA	AAGAATAA
AATCATCC	AATCACCC
AAGNTGCT	AAGTGCTG
AAGTATTA	ACGTATTA
AAGNTGGT	AAGTGGTG
AATCANCC	AATCACCC
AAGTCACC	AATCACCC
AATCCACC	AATCACCC
AATTACCC	AATCACCC
AATCCCCA	AATCACCC
AATCCCCC	AATCACCC
AATCCCCG	AATCACCC
AATCCCCT	AATCACCC
AATCCCCN	AATCACCC
AATCCCTC	ATCCCTCT
AANGGAGT	AAGGAGTG
AAGTCCTG	AAGTGCTG
AANGGGAC	AAGGGGAC
AAGTCGGT	AAGTGGTG
AATCCTGG	ATCCTGGC
AAGTCGTG	AAGTGGTG
AATCCTTA	ACATCCTT
AANGGGGA	AAGGGGAC
AATCCTTC	ACATCCTT
AATCCTTG	ACATCCTT
AATCCTTT	ACATCCTT
AATCCTTN	ACATCCTT
AANCGCAT	AACGCATG
AATCGACC	AATCACCC
AATTCACC	AATCACCC
AAGTCTGA	AAGTGCTG
AAGTCTGC	AAGTGCTG
AAGTCTGG	AAGTGCTG
AAGTCTGT	AAGTGCTG
AAGTCTGN	AAGTGCTG
AATCGATA	TAATCGAT
AATCGATC	TAATCGAT
AATCGATG	TAATCGAT
AATCGATT	TAATCGAT
AATCGATN	TAATCGAT
AATCGCAT	AACGCATG
AATCGCCC	AATCACCC
AATCGCTA	AAATCGCT
AATCGCTC	AAATCGCT
AATTCCCT	CATTCCCT
AATCGCTG	AAATCGCT
AATCGCTT	AAATCGCT
AATCGCTN	AAATCGCT
AATTCGCT	AAATCGCT
AAGTGACT	AAGTGCTG
AAGTGCAG	AAGTGCTG
AAGTGCAT	AAGTGCTG
AAGTGCCG	AAGTGCTG
AAGTGCCT	AAGTGCTG
AAGTGCGA	AAGTGCTG
AAGTGCGC	AAGTGCTG
AAGTGCGG	AAGTGCTG
AAGTGCGN	AAGTGCTG
AAGTGCTA	AAGTGCTG
AAGTGCTC	AAGTGCTG
AAGTGCTG	AAGTGCTG
AAGTGCTT	AAGTGCTG
AAGTGCTN	AAGTGCTG
AAGTGCNG	AAGTGCTG
AAGTGCNT	AAGTGCTG
AATCTACC	AATCACCC
AAGTGGAC	AAGGGGAC
AAGTGGAG	AAGTGGTG
AAGTGGAT	AAGTGGTG
AANGTGCT	AAGTGCTG
AAGTGGCG	AAGTGGTG
AANCTGGG	AACTGGGA
AANGTGGT	AAGTGGTG
AATCTCCC	AATCACCC
AATCTCTA	ATATCTCT
AATCTCTC	ATATCTCT
AATCTCTG	ATATCTCT
AATCTCTT	ATATCTCT
AATCTCTN	ATATCTCT
AATCTGAG	ATCTGAGC
AATCTGGG	AACTGGGA
AATAAAGT	ATAAAGTC
AAGTGGGC	AAGTGGTG
AAGTGGGG	AAGTGGTG
AAGTGGGT	AAGTGGTG
AAGTGGGN	AAGTGGTG
AAGTGGTA	AAGTGGTG
AAGTGGTC	AAGTGGTG
AAGTGGTG	AAGTGGTG
AAGTGGTT	AAGTGGTG
AATTGCTG	AAGTGCTG
AAGTGGTN	AAGTGGTG
AATAACCC	AATCACCC
AAGTGGNG	AAGTGGTG
AAGTGGNT	AAGTGGTG
AAGTGTCT	AAGTGCTG
AATTGGGA	AACTGGGA
AATTGGTG	AAGTGGTG
AATCNACC	AATCACCC
AATAATAA	AAGAATAA
ACAAAACT	ACGAAACT
ACAAAAGT	ACACAAGT
AAGTGNCT	AAGTGCTG
AANAATAA	AAGAATAA
AAGTGNGT	AAGTGGTG
AATAATTT	ACTAATTT
AATCNCCC	AATCACCC
ACAAACTA	ACGAAACT
ACAAACTC	ACGAAACT
ACAAACTG	ACGAAACT
ACAAACTT	ACGAAACT
ACAAACTN	ACGAAACT
AATACACC	AATCACCC
ACAAAGTA	ACACAAGT
ACAAAGTG	ACACAAGT
ACAAAGTT	ACACAAGT
ACAAAGTN	ACACAAGT
AATACCCA	AATCACCC
AATACCCC	AATCACCC
AATACCCG	AATCACCC
AATACCCT	AATCACCC
AATACCCN	AATCACCC
ACAAATGC	CCAAATGC
AANGAATA	AAGAATAA
ACAAATTT	ACTAATTT
AAGTTCTG	AAGTGCTG
AATGAATA	AAGAATAA
AAGTTGCT	AAGTGCTG
AAGTTGGT	AAGTGGTG
AAGTTGTG	AAGTGGTG
ACAACAAG	ACACAAGT
AATGACCC	AATCACCC
AATGACGC	CATGACGC
AATGAGTG	AAGGAGTG
ACAACCGA	CAACCGAA
AANGAGTG	AAGGAGTG
ACAACCTT	ACATCCTT
AANTCACC	AATCACCC
ACAACTTC	TCAACTTC
AATGCACC	AATCACCC
AAGTNCTG	AAGTGCTG
AANTCGCT	AAATCGCT
AAGTNGCT	AAGTGCTG
AAGTNGGT	AAGTGGTG
AAGTNGTG	AAGTGGTG
AATTTTCA	GAATTTTC
AATTTTCC	GAATTTTC
AATTTTCG	GAATTTTC
AATTTTCT	GAATTTTC
AATTTTCN	GAATTTTC
AATTTTTT	CATTTTTT
ACAAGACG	TCAAGACG
AATGCTGA	AAGTGCTG
AATGCTGC	AAGTGCTG
AANGCATG	AACGCATG
AATGCTGG	AAGTGCTG
AATGCTGT	AAGTGCTG
AATGCTGN	AAGTGCTG
AATATCAT	GATATCAT
AANATCGC	AAATCGCT
AATATCGC	AAATCGCT
AATATCGG	CATATCGG
AANTGCTG	AAGTGCTG
AATGGAGT	AAGGAGTG
AATATCTC	ATATCTCT
AANTGGGA	AACTGGGA
AANTGGTG	AAGTGGTG
AATGGGAA	AACTGGGA
AATGGGAG	AACTGGGA
AATGGGAT	AACTGGGA
AATGGGAN	AACTGGGA
AAGNAATA	AAGAATAA
AATGGGGA	AAGGGGAC
AATGGTCC	ATGGTCCG
AATGGTGA	AAGTGGTG
ACCGAAAC	ACGAAACT
AATGGTGC	AAGTGGTG
AATGGTGG	AAGTGGTG
AATGGTGT	AAGTGGTG
AATGGTGN	AAGTGGTG
ACCGAACA	CCGAACAT
ACGCNAGC	ACGCAGCC
AAGNAGTG	AAGGAGTG
AATNACCC	AATCACCC
AAGNATAA	AAGAATAA
ACGCNCCT	ACGCCCTA
ACGCNCTA	ACGCCCTA
ACGCNGCC	ACGCAGCC
ACCGAGTT	ACCGGTTG
ACATNCCT	ACATCCTT
ACATNCTT	ACATCCTT
ACCGATTA	CCGATTAA
ACCGATTG	ACCGGTTG
ACCGCAGC	ACGCAGCC
ACCGCATG	AACGCATG
ACGGAAAC	ACGAAACT
ACAGCAAG	ACACAAGT
ACCGCCAG	ACGGCCAG
ACGGAACT	ACGAAACT
ACAGCAGC	ACGCAGCC
ACCGCCCT	ACGCCCTA
ACAGCCAG	ACGGCCAG
ACGGACAG	ACGGCCAG
ACGGACAT	AGGACATT
ACGGACCA	ACGGCCAG
ACAGCCCT	ACGCCCTA
ACANAAGT	ACACAAGT
ACCGCGTT	ACCGGTTG
ACCAGAGT	CCAGAGTC
ACAGCCTT	ACATCCTT
ACGGAGCC	ACGCAGCC
ACGGAGTG	AAGGAGTG
ACCGCTTG	ACCGGTTG
ACCAGCCA	ACGCAGCC
ACCAGCCC	ACGCAGCC
ACCAGCCG	ACGCAGCC
ACCAGCCT	ACGCAGCC
ACCAGCCN	ACGCAGCC
ACGACAAC	ACGAAACT
ACGACAAG	ACACAAGT
ACGACACT	ACGAAACT
ACGACAGC	ACGCAGCC
ACGGATTA	ACGTATTA
ACAGCTTG	CAGCTTGC
ACAATCCT	ACATCCTT
ACAATCGC	AAATCGCT
ACCAGGTT	ACCGGTTG
ACGACATT	AGGACATT
ACCGGATG	ACCGGTTG
ACCGGATT	ACCGGTTG
ACGGCAAG	ACGGCCAG
ACGACCAG	ACGGCCAG
ACGGCACA	ACGGCCAG
ACCAGTTG	ACCGGTTG
ACCGGCCA	ACGGCCAG
ACGACCCT	ACGCCCTA
ACGGCAGA	ACGGCCAG
ACGGCAGG	ACGGCCAG
ACGGCAGT	ACGGCCAG
ACGGCAGN	ACGGCCAG
ACCGGCTG	ACCGGTTG
ACCGGCTT	ACCGGTTG
ACGGCCAA	ACGGCCAG
ACANCAAG	ACACAAGT
ACGGCCAC	ACGGCCAG
ACGGCCAG	ACGGCCAG
ACAGGAGT	AAGGAGTG
ACGGCCAT	ACGGCCAG
ACGGCCAN	ACGGCCAG
ACGGCCCA	ACGGCCAG
ACCGGGAC	TCCGGGAC
ACGGCCCG	ACGGCCAG
ACGGCCCT	ACGCCCTA
ACGGCCGA	ACGGCCAG
ACGGCCGG	ACGGCCAG
ACGACCTA	ACGCCCTA
ACGGCCGT	ACGGCCAG
ACGGCCGN	ACGGCCAG
ACGGCCTG	ACGGCCAG
ACCGGGTG	ACCGGTTG
ACGGCCNA	ACGGCCAG
ACAGGCCA	ACGGCCAG
ACCGGGTT	ACCGGTTG
ACGGCCNG	ACGGCCAG
ACAATTTA	ACTAATTT
ACGGCGAG	ACGGCCAG
ACAATTTC	ACTAATTT
ACGACGCT	CGACGCTG
ACAATTTG	ACTAATTT
ACCGGTAG	ACCGGTTG
ACAATTTT	ACTAATTT
ACCGGTAT	ACCGGTTG
ACGGCGCA	ACGGCCAG
ACAATTTN	ACTAATTT
ACCGGTCG	ACCGGTTG
ACCGGTCT	ACCGGTTG
ACCGGTGA	ACCGGTTG
ACCGGTGC	ACCGGTTG
ACCGGTGG	ACCGGTTG
ACCGGTGT	ACCGGTTG
ACCGGTGN	ACCGGTTG
ACCGGTTA	ACCGGTTG
ACCGGTTC	ACCGGTTG
ACANCCTT	ACATCCTT
ACCGGTTG	ACCGGTTG
ACCGGTTT	ACCGGTTG
ACCATCCT	ACATCCTT
ACCGGTTN	ACCGGTTG
ACCGGTNG	ACCGGTTG
ACCGGTNT	ACCGGTTG
ACAGGGGA	AAGGGGAC
ACGGCTAG	ACGGCCAG
ACGGCTCA	ACGGCCAG
ACCGGNTG	ACCGGTTG
ACCGGNTT	ACCGGTTG
ACGGCNAG	ACGGCCAG
ACAGGTTG	ACCGGTTG
ACGGCNCA	ACGGCCAG
ACCGTATT	ACGTATTA
ACGAGAAC	ACGAAACT
ACGAGACT	ACGAAACT
ACGGGCAG	ACGGCCAG
ACGGGCCA	ACGGCCAG
ACAGTATT	ACGTATTA
ACGAGCCC	ACGCAGCC
ACGAGCCG	ACGCAGCC
ACGAGCCT	ACGCAGCC
ACGAGCCN	ACGCAGCC
ACAGTCCT	ACATCCTT
ACCGTGTT	ACCGGTTG
ACGGGGAC	AAGGGGAC
ACGGGGGA	TCGGGGGA
ACCGTTGA	ACCGGTTG
ACAGTGCT	AAGTGCTG
ACCGTTGC	ACCGGTTG
ACCGTTGG	ACCGGTTG
ACCGTTGT	ACCGGTTG
ACCGTTGN	ACCGGTTG
ACAGTGGT	AAGTGGTG
ACCGTTTG	ACCGGTTG
ACAGTTAA	GACAGTTA
ACAGTTAC	GACAGTTA
ACGGGTTC	CGGGTTCG
ACAGTTAG	GACAGTTA
ACGGGTTG	ACCGGTTG
ACAGTTAT	GACAGTTA
ACAGTTAN	GACAGTTA
ACACAAAG	ACACAAGT
ACACAAAT	ACACAAGT
ACACAACG	ACACAAGT
ACACAACT	ACACAAGT
ACACAAGA	ACACAAGT
ACACAAGC	ACACAAGT
ACACAAGG	ACACAAGT
ACACAAGT	ACACAAGT
ACACAAGN	ACACAAGT
ACACAATA	ACACAAGT
ACACAATC	ACACAAGT
ACACAATG	ACACAAGT
ACACAATT	ACACAAGT
ACACAATN	ACACAAGT
ACACAANG	ACACAAGT
ACACAANT	ACACAAGT
ACACACAG	ACACAAGT
ACGATAAC	ACGAAACT
ACACACGT	ACACAAGT
ACGATACT	ACGAAACT
ACGGTATT	ACGTATTA
ACACAGAG	ACACAAGT
ACGATATT	ACGTATTA
ACACAGCC	ACGCAGCC
ACGGTCAG	ACGGCCAG
ACGGTCCA	ACGGCCAG
ACACAGGT	ACACAAGT
ACGGTCCG	ATGGTCCG
ACACAGTA	ACACAAGT
ACACAGTC	ACACAAGT
ACACAGTG	ACACAAGT
ACACAGTT	ACACAAGT
ACGATCCT	ACATCCTT
ACACAGTN	ACACAAGT
ACCCAAGT	ACACAAGT
ACACATAG	ACACAAGT
ACACATGT	ACACAAGT
ACANTCCT	ACATCCTT
ACACANAG	ACACAAGT
ACCGNGTT	ACCGGTTG
ACACANGT	ACACAAGT
ACGGTTGA	ACCGGTTG
ACGGTTGC	ACCGGTTG
ACGGTTGG	ACCGGTTG
ACGGTTGT	ACCGGTTG
ACGGTTGN	ACCGGTTG
ACCCAGCC	ACGCAGCC
ACACCAAG	ACACAAGT
ACCGNTTG	ACCGGTTG
ACCCAGTC	GCCCAGTC
ACACCAGT	ACACAAGT
ACGATTAC	ACGTATTA
ACGATTAG	ACGTATTA
ACGATTAT	ACGTATTA
ACGATTAN	ACGTATTA
ACCNGGTT	ACCGGTTG
ACACCCTA	ACGCCCTA
ACACCCTT	ACATCCTT
ACGGNCAG	ACGGCCAG
ACGGNCCA	ACGGCCAG
ACCNGTTG	ACCGGTTG
ACCTAATT	ACTAATTT
ACGANAAC	ACGAAACT
ACGANACT	ACGAAACT
ACATAAGT	ACACAAGT
ACCTACGG	CCTACGGT
ACATAATT	ACTAATTT
ACACCTTA	ACATCCTT
ACACCTTC	ACATCCTT
ACACCTTG	ACATCCTT
ACACCTTT	ACATCCTT
ACACCTTN	ACATCCTT
ACATACCT	ACATCCTT
ACATACTT	ACATCCTT
ACACGAAG	ACACAAGT
ACACGAGT	ACACAAGT
ACCTATTA	ACGTATTA
ACGTAAAC	ACGAAACT
ACGTAAAT	GCGTAAAT
ACGTAACT	ACGAAACT
ACATATCG	CATATCGG
ACACGCAT	AACGCATG
ACGTAATA	ACGTATTA
ACATATTA	ACGTATTA
ACACGCGC	CACGCGCT
ACGCAAAC	ACGAAACT
ACCAAACT	ACGAAACT
ACGTACTA	ACGTATTA
ACGCAACC	ACGCAGCC
ACGTACTT	ACGTATTA
ACGCAACT	ACGAAACT
ACGCAAGC	ACGCAGCC
ACCAAATG	CCAAATGC
ACGCAAGT	ACACAAGT
ACCCCCTA	ACGCCCTA
ACGTAGCC	ACGCAGCC
ACACGGTT	ACCGGTTG
ACATCAAG	ACACAAGT
ACATCACC	AATCACCC
ACATCACT	ACATCCTT
ACGTAGTA	ACGTATTA
ACGCACCA	ACGCAGCC
ACGTAGTT	ACGTATTA
ACGCACCC	ACGCAGCC
ACGCACCG	ACGCAGCC
ACGCACCN	ACGCAGCC
ACATCATT	ACATCCTT
ACGCACGC	ACGCAGCC
ACGTATAA	ACGTATTA
ACGTATAC	ACGTATTA
ACGTATAG	ACGTATTA
ACACGTGG	CACGTGGG
ACGTATAT	ACGTATTA
ACGCACTA	ACGCCCTA
ACGTATAN	ACGTATTA
ACGTATCA	ACGTATTA
ACGTATCT	ACGTATTA
ACATCCAT	ACATCCTT
ACGTATGA	ACGTATTA
ACGTATGT	ACGTATTA
ACGCAGAC	ACGCAGCC
ACGTATTA	ACGTATTA
ACATCCCT	ACATCCTT
ACGTATTC	ACGTATTA
ACGTATTG	ACGTATTA
ACGCAGCA	ACGCAGCC
ACGTATTT	ACGTATTA
ACCCCTAA	ACGCCCTA
ACGCAGCC	ACGCAGCC
ACCCCTAC	ACGCCCTA
ACGTATTN	ACGTATTA
ACGCAGCG	ACGCAGCC
ACATCCGT	ACATCCTT
ACCCCTAG	ACGCCCTA
ACGTATNA	ACGTATTA
ACGCAGCT	ACGCAGCC
ACCCCTAT	ACGCCCTA
ACGCAGCN	ACGCAGCC
ACATCCTA	ACATCCTT
ACCCCTAN	ACGCCCTA
ACCAAGTA	ACACAAGT
ACATCCTC	ACATCCTT
ACCAAGTC	ACACAAGT
ACGCAGGC	ACGCAGCC
ACATCCTG	ACATCCTT
ACGTATNT	ACGTATTA
ACCAAGTG	ACACAAGT
ACATCCTT	ACATCCTT
ACCAAGTT	ACACAAGT
ACCTCCTT	ACATCCTT
ACATCCTN	ACATCCTT
ACCCCTCT	ATCCCTCT
ACCAAGTN	ACACAAGT
ACGCAGTC	ACGCAGCC
ACATCCNT	ACATCCTT
ACGCAGNC	ACGCAGCC
ACCCCTTC	CCCCTTCA
ACACTAAG	ACACAAGT
ACGTANTA	ACGTATTA
ACGCATCC	ACGCAGCC
ACGCATGA	AACGCATG
ACATCGTT	ACATCCTT
ACGCATGT	AACGCATG
ACCAATTT	ACTAATTT
ACGCATGN	AACGCATG
ACGCATTA	ACGTATTA
ACGTANTT	ACGTATTA
ACACTAGT	ACACAAGT
ACGCANCC	ACGCAGCC
ACATCTTA	ACATCCTT
ACATCTTC	ACATCCTT
ACGCANGC	ACGCAGCC
ACGTCAGC	ACGCAGCC
ACATCTTG	ACATCCTT
ACATCTTT	ACATCCTT
ACATCTTN	ACATCCTT
ACGTCATT	ACGTATTA
ACCACAAG	ACACAAGT
ACATCNCT	ACATCCTT
ACACTCCT	ACATCCTT
ACGTCCAG	ACGGCCAG
ACCCGCAA	TACCCGCA
ACGCCACT	ACGCCCTA
ACCCGCAC	TACCCGCA
ACCCGCAG	TACCCGCA
ACCCGCAT	TACCCGCA
ACGCCAGA	ACGGCCAG
ACCCGCAN	TACCCGCA
ACGTCCCT	ACGCCCTA
ACGCCAGG	ACGGCCAG
ACGCCAGT	ACGGCCAG
ACGCCAGN	ACGGCCAG
ACATCNTT	ACATCCTT
ACGCCATA	ACGCCCTA
ACGTCCTA	ACGCCCTA
ACGTCCTT	ACATCCTT
ACGCCCAA	ACGCCCTA
ACGCCCAC	ACGCCCTA
ACGCCCAT	ACGCCCTA
ACATGACG	CATGACGC
ACGCCCAN	ACGCCCTA
ACGCCCCA	ACGCCCTA
ACGCCCCT	ACGCCCTA
ACGCCCGA	ACGCCCTA
ACGCCCGT	ACGCCCTA
ACGCCCTA	ACGCCCTA
ACGCCCTC	ACGCCCTA
ACGCCCTG	ACGCCCTA
ACGCCCTT	ACGCCCTA
ACGCCCTN	ACGCCCTA
ACGCCCNA	ACGCCCTA
ACCTGAGC	ATCTGAGC
ACGCCCNT	ACGCCCTA
ACCCGGTT	ACCGGTTG
ACGAAAAC	ACGAAACT
ACGAAAAT	ACGAAACT
ACGAAACA	ACGAAACT
ACATGCCT	ACATCCTT
ACGAAACC	ACGAAACT
ACGCCGCT	ACGCCCTA
ACGAAACG	ACGAAACT
ACGAAACT	ACGAAACT
ACGAAACN	ACGAAACT
ACGAAAGC	ACGAAACT
ACACTGGG	AACTGGGA
ACGAAAGT	ACGAAACT
ACGCCGTA	ACGCCCTA
ACGAAATA	ACGAAACT
ACGAAATC	ACGAAACT
ACATGCTT	ACATCCTT
ACGAAATG	ACGAAACT
ACGAAATT	ACGAAACT
ACGAAATN	ACGAAACT
ACGTCTTA	ACGTATTA
ACGAAANC	ACGAAACT
ACGAAANT	ACGAAACT
ACCCGTTG	ACCGGTTG
ACGCCTAA	ACGCCCTA
ACGAACAC	ACGAAACT
ACGCCTAC	ACGCCCTA
ACGCCTAG	ACGCCCTA
ACGAACAT	CCGAACAT
ACGCCTAT	ACGCCCTA
ACGCCTAN	ACGCCCTA
ACGAACCT	ACGAAACT
ACGCCTCT	ACGCCCTA
ACGAACTA	ACGAAACT
ACGAACTC	ACGAAACT
ACGAACTG	ACGAAACT
ACGCCTTA	ACGCCCTA
ACGAACTT	ACGAAACT
ACGAACTN	ACGAAACT
ACGAAGAC	ACGAAACT
ACGAAGCC	ACGCAGCC
ACCTGGCA	ATCCTGGC
ACGAAGCT	ACGAAACT
ACCTGGCC	ATCCTGGC
ACCTGGCG	ATCCTGGC
ACCTGGCT	ATCCTGGC
ACGCCNCT	ACGCCCTA
ACCTGGCN	ATCCTGGC
ACCTGGGA	AACTGGGA
ACGCCNTA	ACGCCCTA
ACCTGGTT	ACCGGTTG
ACGAATAA	AAGAATAA
ACGAATAC	ACGAAACT
ACGAATCT	ACGAAACT
ACGAATTA	ACGTATTA
ACGCGAGC	ACGCAGCC
ACGAATTT	ACTAATTT
ACCCTCTA	ATCCCTCT
ACCCTCTC	ATCCCTCT
ACGAANAC	ACGAAACT
ACCCTCTG	ATCCCTCT
ACCCTCTT	ATCCCTCT
ACCTGTTG	ACCGGTTG
ACCCTCTN	ATCCCTCT
ACGCGCCC	ACGCAGCC
ACGCGCCG	ACGCAGCC
ACGCGCCN	ACGCAGCC
ACGAANCT	ACGAAACT
ACGCGCTC	CACGCGCT
ACGCGCTG	CACGCGCT
ACACNAAG	ACACAAGT
ACGCGCTT	CACGCGCT
ACCCTGGC	ATCCTGGC
ACGCGCTN	CACGCGCT
ACTCTGAG	ATCTGAGC
ACGCGGCC	ACGCAGCC
ACATTCCC	CATTCCCT
ACACNAGT	ACACAAGT
ACATTCCT	ACATCCTT
ACGCGGTT	ACCGGTTG
ACATTCTT	ACATCCTT
ACCCTTCA	CCCCTTCA
ACNCGGTT	ACCGGTTG
ACATTTTT	CATTTTTT
ACGCTAGC	ACGCAGCC
ACGCTATT	ACGTATTA
ACGCTCCT	ACGCCCTA
ACTAAACT	ACGAAACT
ACTAAAGT	ATAAAGTC
ACGCTCTA	ACGCCCTA
ACTAAATT	ACTAATTT
ACGCTGCC	ACGCAGCC
ACAGAAAC	ACGAAACT
ACAGAAGT	ACACAAGT
ACTAACTT	ACTAATTT
ACAGAATA	AAGAATAA
ACNAAACT	ACGAAACT
ACTAAGTT	ACTAATTT
AGAAAAAG	GAAAAAGC
ACTAATAT	ACTAATTT
ACTAATCT	ACTAATTT
AGAAAAGA	GGAAAAGA
ACTAATGT	ACTAATTT
ACTGAAAC	ACGAAACT
ACTAATTA	ACTAATTT
ACTAATTC	ACTAATTT
ACTAATTG	ACTAATTT
ACTAATTT	ACTAATTT
ACTAATTN	ACTAATTT
ACAGAGTC	CCAGAGTC
ACTAATNT	ACTAATTT
ACTGAATT	ACTAATTT
AGAAACTA	ACGAAACT
AGAAACTC	ACGAAACT
AGAAACTG	ACGAAACT
ACTAANTT	ACTAATTT
AGAAACTT	ACGAAACT
AGAAACTN	ACGAAACT
ACTACAAG	ACACAAGT
ACTGAGCA	ATCTGAGC
ACTGAGCC	ATCTGAGC
ACTGAGCG	ATCTGAGC
AGAAAGTA	GAAAGTAC
ACTGAGCT	ATCTGAGC
ACTACATT	ACTAATTT
ACTGAGCN	ATCTGAGC
AGAAAGTC	ATAAAGTC
ACNAATTT	ACTAATTT
AGAAATAG	GAAATAGG
ACTGATAA	CTGATAAA
ACNTAATT	ACTAATTT
ACGTGATT	ACGTATTA
ACTTCCCA	CTTCCCAG
ACTGATTT	ACTAATTT
ACGTGCCA	ACGGCCAG
ACTTCCTT	ACATCCTT
ACTACGGT	CCTACGGT
ACNACAAG	ACACAAGT
ACGTGCTG	AAGTGCTG
ACTGCAGC	ACGCAGCC
ACTACTTT	ACTAATTT
ACGTGGGA	CACGTGGG
ACTGCATG	ATGCATGG
ACGTGGGC	CACGTGGG
ACGTGGGG	CACGTGGG
AGAACATT	AGGACATT
ACGTGGGT	CACGTGGG
ACGTGGGN	CACGTGGG
ACGTGGTG	AAGTGGTG
ACTGCCAG	ACGGCCAG
ACNTATTA	ACGTATTA
ACTGCCCT	ACGCCCTA
ACTGCCTT	CTGCCTTT
ACGTGTCC	CGTGTCCA
ACTAGATT	ACTAATTT
ACGTGTTA	ACGTATTA
ACNGAAAC	ACGAAACT
ACNTCCTT	ACATCCTT
ACGTTAAC	GCGTTAAC
ACGTTATT	ACGTATTA
ACTAGTTT	ACTAATTT
ACGTTCCA	CGTTCCAA
AGAAGAGA	TAGAAGAG
AGAAGAGC	TAGAAGAG
AGAAGAGG	TAGAAGAG
AGAAGAGT	TAGAAGAG
AGAAGAGN	TAGAAGAG
ACTGGCCA	ACGGCCAG
ACTGGGAA	AACTGGGA
ACTGGGAC	AACTGGGA
ACTGGGAG	AACTGGGA
ACTGGGAT	AACTGGGA
ACTGGGAN	AACTGGGA
ACGTTTAA	ACGTATTA
ACGTTTAC	ACGTATTA
ACGTTTAG	ACGTATTA
ACGTTTAT	ACGTATTA
ACGTTTAN	ACGTATTA
ACTTTACC	GCTTTACC
ACTATATT	ACTAATTT
ACGTTTTA	ACGTATTA
ACTGGTCC	ATGGTCCG
ACTATCCT	ACATCCTT
ACTGGTTG	ACCGGTTG
ACTATCTC	ATATCTCT
ACNGCAGC	ACGCAGCC
ACNGCCAG	ACGGCCAG
ACTTTGTA	TCTTTGTA
ACNGCCCT	ACGCCCTA
ACTATTAA	ACGTATTA
ACTATTAC	ACGTATTA
ACTATTAG	ACGTATTA
ACTATTAT	ACGTATTA
ACTATTAN	ACGTATTA
ACGTNATT	ACGTATTA
ACTGTATT	ACGTATTA
ACTATTTA	ACTAATTT
ACTATTTC	ACTAATTT
ACTATTTG	ACTAATTT
ACTATTTT	ACTAATTT
ACTATTTN	ACTAATTT
AGAATAAA	AAGAATAA
AGAATAAC	AAGAATAA
AGAATAAG	AAGAATAA
AGAATAAT	AAGAATAA
AGAATAAN	AAGAATAA
AGAATCGC	AAATCGCT
ACNATCCT	ACATCCTT
ACTANATT	ACTAATTT
ACGTNTTA	ACGTATTA
ACGNAAAC	ACGAAACT
AGAATTTT	GAATTTTC
ACGNAACT	ACGAAACT
ACNGGCCA	ACGGCCAG
ACTANTTT	ACTAATTT
ACNGGTTG	ACCGGTTG
ACTNAATT	ACTAATTT
ACGNAGCC	ACGCAGCC
ACTCAAGT	ACACAAGT
ACTCAATT	ACTAATTT
ACTCACCC	AATCACCC
ACTCACTA	CTCACTAC
ACNGTATT	ACGTATTA
ACTCAGCC	ACGCAGCC
ACGNATTA	ACGTATTA
ACTTAATT	ACTAATTT
ACTNATTT	ACTAATTT
ACTTACGG	GCTTACGG
ACTCATTT	ACTAATTT
ACGNCAGC	ACGCAGCC
ACGNCCAG	ACGGCCAG
ACNCAAGT	ACACAAGT
ACGNCCCT	ACGCCCTA
ACTTATTA	ACGTATTA
ACTTATTT	ACTAATTT
ACGNCCTA	ACGCCCTA
AGACAAGT	ACACAAGT
ACTCCCTA	ACGCCCTA
ACTCCCTC	ATCCCTCT
ACNCAGCC	ACGCAGCC
AGACAGTT	GACAGTTA
ACTCCTGG	ATCCTGGC
ACTCCTTA	ACATCCTT
ACTCCTTC	ACATCCTT
ACTCCTTG	ACATCCTT
ACTCCTTT	ACATCCTT
ACTCCTTN	ACATCCTT
AGACATTA	AGGACATT
AGACATTC	AGGACATT
AGACATTG	AGGACATT
AGACATTT	AGGACATT
AGACATTN	AGGACATT
ACGNGCCA	ACGGCCAG
AGGGGACA	AAGGGGAC
AGGGGACC	AAGGGGAC
AGGGGACG	AAGGGGAC
AGGGGACT	AAGGGGAC
AGGGGACN	AAGGGGAC
ACNCCCTA	ACGCCCTA
AGGGGGAC	AAGGGGAC
AGCGTAAA	GCGTAAAT
ACGNTATT	ACGTATTA
AGCGTATT	ACGTATTA
ACTCGGTT	ACCGGTTG
AGGGTCCG	ATGGTCCG
ACTCGTTC	GCTCGTTC
AGCGTTAA	GCGTTAAC
AGGGTTCG	CGGGTTCG
AGCCACCG	TGCCACCG
AGCAAAAT	GGCAAAAT
AGCCCAGT	GCCCAGTC
AGCCCGCC	AGGCCGCC
AGCTAATT	ACTAATTT
AGACCGCC	AGGCCGCC
AGGANATT	AGGACATT
AGCCCTAA	ACGCCCTA
AGGTACAT	AGGACATT
AGCCCTAC	ACGCCCTA
AGCCCTAG	ACGCCCTA
AGCCCTAT	ACGCCCTA
AGCCCTAN	ACGCCCTA
AGCACAAG	ACACAAGT
AGGANCAT	AGGACATT
AGCCCTCT	ATCCCTCT
AGCACATT	AGGACATT
AGATATCA	GATATCAT
AGGTATTA	ACGTATTA
AGCCGCCA	AGGCCGCC
AGCCGCCC	AGGCCGCC
AGCCGCCG	AGGCCGCC
AGCCGCCT	AGGCCGCC
AGCCGCCN	AGGCCGCC
AGACGCAT	AACGCATG
AGATCACC	AATCACCC
AGACGCTG	CGACGCTG
AGGCAAAA	GGCAAAAT
AGGTCATT	AGGACATT
AGCCGGTT	ACCGGTTG
AGGTCCGA	ATGGTCCG
AGGTCCGG	ATGGTCCG
AGGTCCGT	ATGGTCCG
AGGTCCGN	ATGGTCCG
AGGCACAT	AGGACATT
AGGCACGC	AGGCCGCC
AGGTCGCC	AGGCCGCC
AGCAGCCA	ACGCAGCC
AGCAGCCC	ACGCAGCC
AGCAGCCG	ACGCAGCC
AGCAGCCT	ACGCAGCC
AGCAGCCN	ACGCAGCC
AGCTCGTT	GCTCGTTC
AGGCATGG	ATGCATGG
AGGCATTA	AGGACATT
AGGCATTC	AGGACATT
AGGCATTG	AGGACATT
AGGCATTT	AGGACATT
AGATCCTT	ACATCCTT
AGGCATTN	AGGACATT
AGGCCACC	AGGCCGCC
AGATCGCT	AAATCGCT
AGGCCAGA	ACGGCCAG
AGGCCAGG	ACGGCCAG
AGGCCAGT	ACGGCCAG
AGGCCAGN	ACGGCCAG
AGCCTGGC	ATCCTGGC
AGACTGGG	AACTGGGA
AGGCCATT	AGGACATT
AGCTGAGC	ATCTGAGC
AGGAAAAG	GGAAAAGA
AGGAAACT	ACGAAACT
AGGCCCCA	AGGCCGCC
AGATCTCT	ATATCTCT
AGGCCCCC	AGGCCGCC
AGGCCCCG	AGGCCGCC
AGGCCCCT	AGGCCGCC
AGGCCCCN	AGGCCGCC
AGGCCCGC	AGGCCGCC
AGGCCCTA	ACGCCCTA
AGGAAATT	AGGACATT
AGGCCGAC	AGGCCGCC
AGGCCGCA	AGGCCGCC
AGGAACAT	AGGACATT
AGGCCGCC	AGGCCGCC
AGGCCGCG	AGGCCGCC
AGGTGCTG	AAGTGCTG
AGGCCGCT	AGGCCGCC
AGGCCGCN	AGGCCGCC
AGGCCGGC	AGGCCGCC
AGCATCCT	ACATCCTT
AGGCCGTC	AGGCCGCC
AGCTGGGA	AACTGGGA
AGGCCGNC	AGGCCGCC
AGGTGGTG	AAGTGGTG
AGGCCTCC	AGGCCGCC
AGATGAAC	GGATGAAC
AGGCCTGC	AGGCCGCC
AGCATGGA	ATGCATGG
AGCATGGC	ATGCATGG
AGCATGGG	ATGCATGG
AGCATGGT	ATGCATGG
AGCATGGN	ATGCATGG
AGGTGTTT	GGTGTTTC
AGGAATAA	AAGAATAA
AGGCCNCC	AGGCCGCC
AGGCCNGC	AGGCCGCC
AGGAATTA	AGGACATT
AGGAATTC	AGGACATT
AGGAATTG	AGGACATT
AGGAATTT	AGGACATT
AGGAATTN	AGGACATT
AGGCGACT	TGGCGACT
AGCTTACG	GCTTACGG
AGGCGCCA	AGGCCGCC
AGGCGCCC	AGGCCGCC
AGGCGCCG	AGGCCGCC
AGGCGCCT	AGGCCGCC
AGGCGCCN	AGGCCGCC
AGGCGCGC	AGGCCGCC
AGGACAAT	AGGACATT
AGGACACT	AGGACATT
AGGCGGCC	AGGCCGCC
AGGACAGT	AGGACATT
AGGACATA	AGGACATT
AGGACATC	AGGACATT
AGGACATG	AGGACATT
AGGACATT	AGGACATT
AGGACATN	AGGACATT
AGGACANT	AGGACATT
AGCTTGCA	CAGCTTGC
AGGACCAT	AGGACATT
AGCTTGCC	CAGCTTGC
AGCTTGCG	CAGCTTGC
AGCTTGCT	CAGCTTGC
AGCTTGCN	CAGCTTGC
AGGACCCG	GGGACCCG
AGGACCGC	AGGCCGCC
AGGACCTT	AGGACATT
AGCGAAAC	ACGAAACT
AGAGAATA	AAGAATAA
AGCTTTAC	GCTTTACC
AGGACGAT	AGGACATT
AGGACGCC	AGGCCGCC
AGAGACAT	AGGACATT
AGGACGTT	AGGACATT
AGCGACAT	AGGACATT
AGGACTAT	AGGACATT
AGGACTTA	AGGACATT
AGGACTTC	AGGACATT
AGGACTTG	AGGACATT
AGGACTTT	AGGACATT
AGGACTTN	AGGACATT
AGGCTCGC	AGGCCGCC
AGGACNAT	AGGACATT
AGTGCATG	ATGCATGG
AGGCTGCC	AGGCCGCC
AGGACNTT	AGGACATT
AGTGCCGC	AGGCCGCC
AGGAGATT	AGGACATT
AGGAGCAT	AGGACATT
AGCGCAGC	ACGCAGCC
AGAGCCGC	AGGCCGCC
AGTGCTGA	AAGTGCTG
AGTGCTGC	AAGTGCTG
AGTGCTGG	AAGTGCTG
AGTGCTGT	AAGTGCTG
AGCGCATG	AACGCATG
AGTGCTGN	AAGTGCTG
AGCGCCCT	ACGCCCTA
AGCGCCGC	AGGCCGCC
ATAACAGT	ATAAAGTC
AGGAGTGA	AAGGAGTG
AGGAGTGC	AAGGAGTG
AGGAGTGG	AAGGAGTG
AGGAGTGT	AAGGAGTG
AGGCNCGC	AGGCCGCC
AGGAGTGN	AAGGAGTG
AGGCNGCC	AGGCCGCC
ATAACGTC	ATAAAGTC
ATAACTCA	TAACTCAG
ATAACTCT	ATATCTCT
AGGATATT	AGGACATT
AGAGGAGT	AAGGAGTG
AGGATCAT	AGGACATT
AGTGGTCC	ATGGTCCG
AGTGGTGA	AAGTGGTG
AGTGGTGC	AAGTGGTG
AGTGGTGG	AAGTGGTG
AGTGGTGT	AAGTGGTG
AGTGGTGN	AAGTGGTG
AGGATGAA	GGATGAAC
AGCGGCCA	ACGGCCAG
AGAGGGGA	AAGGGGAC
ATAAGAGT	ATAAAGTC
AGGGACAT	AGGACATT
AGGGACCC	GGGACCCG
AGCGGGTT	TGCGGGTT
AGAGGTTA	TAGAGGTT
AGAGGTTC	TAGAGGTT
AGAGGTTG	TAGAGGTT
AGAGGTTT	TAGAGGTT
AGAGGTTN	TAGAGGTT
AGTGTCCA	CGTGTCCA
ATAAGGTC	ATAAAGTC
AGCGGTTG	ACCGGTTG
AGGGAGTG	AAGGAGTG
ATAAGTCA	ATAAAGTC
ATAAGTCC	ATAAAGTC
ATAAGTCG	ATAAAGTC
ATAAGTCT	ATAAAGTC
ATAAGTCN	ATAAAGTC
AGNGACAT	AGGACATT
AGTGTTTC	GGTGTTTC
ATAATAGT	ATAAAGTC
AGGGCATT	AGGACATT
AGGGCCAG	ACGGCCAG
ATAATCGA	TAATCGAT
ATAATCGC	AAATCGCT
AGGGCCGC	AGGCCGCC
ATAATCTC	ATATCTCT
AGAGTGCT	AAGTGCTG
AGGGCGCC	AGGCCGCC
AGAGTGGT	AAGTGGTG
ATAATGTC	ATAAAGTC
AGNGCCGC	AGGCCGCC
ATAATTTA	ACTAATTT
ATAATTTC	ACTAATTT
ATAATTTG	ACTAATTT
ATAATTTT	ACTAATTT
ATAATTTN	ACTAATTT
ATAANAGT	ATAAAGTC
AGTATACG	GTATACGA
ATAANGTC	ATAAAGTC
AGGNACAT	AGGACATT
AGTATCTC	ATATCTCT
AGTTAGCA	GTTAGCAA
AGTATTAA	ACGTATTA
AGTATTAC	ACGTATTA
AGTATTAG	ACGTATTA
AGTATTAT	ACGTATTA
AGTATTAN	ACGTATTA
AGGNCATT	AGGACATT
AGGNCCGC	AGGCCGCC
AGTTCCAA	CGTTCCAA
ATACAGTC	ATAAAGTC
AGGNCGCC	AGGCCGCC
AGTTCGGC	TGTTCGGC
ATACATGG	ATGCATGG
ATACCCGC	TACCCGCA
ATACCCGG	GTACCCGG
ATACCCTC	ATCCCTCT
AGTCACCC	AATCACCC
AGNCCGCC	AGGCCGCC
AGTTGTAT	GTTGTATT
ATACCTGG	ATCCTGGC
ATACGCAT	AACGCATG
AGTCCCTC	ATCCCTCT
AGTCCGCC	AGGCCGCC
AGTCCTGG	ATCCTGGC
ATCAAAGT	ATAAAGTC
ATCAACTT	TCAACTTC
ATCAAGAC	TCAAGACG
ATCAAGTC	ATAAAGTC
ATACTCTA	ATATCTCT
ATACTCTC	ATATCTCT
ATACTCTG	ATATCTCT
ATACTCTT	ATATCTCT
ATACTCTN	ATATCTCT
ATACTGAG	ATCTGAGC
ATACTGGC	ATCCTGGC
ATCACAAG	ACACAAGT
ATACTGGG	AACTGGGA
ATCACCCA	AATCACCC
ATCACCCC	AATCACCC
ATCACCCG	AATCACCC
ATCACCCT	AATCACCC
ATCACCCN	AATCACCC
AGTAAAGT	ATAAAGTC
ATCACCTC	ATCCCTCT
AGTCTAGC	TGTCTAGC
AGNACATT	AGGACATT
ATCACTAC	CTCACTAC
ATCACTCT	ATCCCTCT
ATCACTGG	ATCCTGGC
AGTCTGAG	ATCTGAGC
ATCAGAGC	ATCTGAGC
ATCAGATA	TTCAGATA
AGTAATTT	ACTAATTT
AGTACATT	AGGACATT
ATGTATGG	ATGCATGG
ATGTATTA	ACGTATTA
ATCTCAGC	ATCTGAGC
AGTACCCG	GTACCCGG
ATCCTAGC	ATCCTGGC
ATCCTAGG	ATCCTGGC
ATGAAACT	ACGAAACT
ATGAAAGT	ATAAAGTC
ATCTCCTC	ATCCCTCT
ATAAAAGT	ATAAAGTC
ATAAAATC	ATAAAGTC
ATCCTCGC	ATCCTGGC
ATCCTCGG	ATCCTGGC
ATCCTCTA	ATCCCTCT
ATCCTCTC	ATCCCTCT
ATCCTCTG	ATCCCTCT
ATCTCGAG	ATCTGAGC
ATCCTCTT	ATCCCTCT
ATCCTCTN	ATCCCTCT
ATCCTGAC	ATCCTGGC
ATGTCATG	ATGCATGG
ATCCTGCA	ATCCTGGC
ATCCTGCC	ATCCTGGC
ATCCTGCG	ATCCTGGC
ATCCTGCT	ATCCTGGC
ATAAACGT	ATAAAGTC
ATCCTGCN	ATCCTGGC
ATCCTGGA	ATCCTGGC
ATCCTGGC	ATCCTGGC
ATAAACTC	ATAAAGTC
ATCCTGGG	ATCCTGGC
ATCCTGGT	ATCCTGGC
ATCCTGGN	ATCCTGGC
ATCCTGTC	ATCCTGGC
ATCCTGTG	ATCCTGGC
ATCCTGNC	ATCCTGGC
ATCCTGNG	ATCCTGGC
ATGTCCGA	ATGGTCCG
ATGTCCGC	ATGGTCCG
ATGTCCGG	ATGGTCCG
ATGTCCGT	ATGGTCCG
ATCTCTGG	ATCCTGGC
ATGTCCGN	ATGGTCCG
ATAAAGAC	ATAAAGTC
ATCCTTCT	ATCCCTCT
ATAAAGAT	ATAAAGTC
ATCCTTGC	ATCCTGGC
ATCCTTGG	ATCCTGGC
ATAAAGCA	ATAAAGTC
ATGAAGTC	ATAAAGTC
ATAAAGCC	ATAAAGTC
ATAAAGCG	ATAAAGTC
ATCATCCT	ACATCCTT
ATAAAGCT	ATAAAGTC
ATAAAGCN	ATAAAGTC
ATAAAGGC	ATAAAGTC
ATAAAGGT	ATAAAGTC
ATAAAGTA	ATAAAGTC
ATCATCTC	ATATCTCT
ATAAAGTC	ATAAAGTC
ATAAAGTG	ATAAAGTC
ATAAAGTT	ATAAAGTC
ATAAAGTN	ATAAAGTC
ATGAATAA	AAGAATAA
ATAAAGNC	ATAAAGTC
ATAAAGNT	ATAAAGTC
AGTAGAAC	GTAGAACC
ATCATGAG	ATCTGAGC
ATCCTNGC	ATCCTGGC
ATCCTNGG	ATCCTGGC
ATAAATCA	ATAAAGTC
ATGAATGG	ATGCATGG
ATAAATCC	ATAAAGTC
ATAAATCG	ATAAAGTC
ATAAATCT	ATAAAGTC
ATCATGGA	ATGCATGG
ATAAATCN	ATAAAGTC
ATCATGGG	ATGCATGG
ATCATGGT	ATGCATGG
ATCTGAAC	ATCTGAGC
ATCATGGN	ATGCATGG
ATAAATGT	ATAAAGTC
ATCTGAAG	ATCTGAGC
AGTGACAT	AGGACATT
ATAAATTC	ATAAAGTC
ATGTCTAG	TGTCTAGC
ATCTGACA	ATCTGAGC
ATCTGACC	ATCTGAGC
ATCTGACG	ATCTGAGC
ATGTCTCT	ATATCTCT
ATCTGACT	ATCTGAGC
ATCTGACN	ATCTGAGC
ATCTGAGA	ATCTGAGC
ATCTGAGC	ATCTGAGC
ATCTGAGG	ATCTGAGC
ATCTGAGT	ATCTGAGC
ATCTGAGN	ATCTGAGC
ATCTGATC	ATCTGAGC
ATCTGATG	ATCTGAGC
ATCTGANC	ATCTGAGC
ATCTGANG	ATCTGAGC
ATAAANGT	ATAAAGTC
ATAAANTC	ATAAAGTC
ATCTGCAG	ATCTGAGC
ATCTGCGC	ATCTGAGC
ATGACATG	ATGCATGG
ATGACATT	AGGACATT
ATCCNCTC	ATCCCTCT
ATCTGGAG	ATCTGAGC
ATCTGGGA	AACTGGGA
ATGCGATG	ATGCATGG
ATCTGGGC	ATCTGAGC
ATCCNGGC	ATCCTGGC
ATCTGTAG	ATCTGAGC
ATGACGCA	CATGACGC
ATGACGCC	CATGACGC
ATGACGCG	CATGACGC
ATGACGCT	CATGACGC
ATGACGCN	CATGACGC
ATCTGTGC	ATCTGAGC
ATCCNTCT	ATCCCTCT
ATGTGAGC	ATCTGAGC
ATCCNTGG	ATCCTGGC
ATCTGNAG	ATCTGAGC
ATATGAGC	ATCTGAGC
ATGCGGGT	TGCGGGTT
ATCTGNGC	ATCTGAGC
ATGCGTCC	ATGGTCCG
ATATGCTC	ATATCTCT
ATGCGTGG	ATGCATGG
ATCTTAGC	ATCTGAGC
ATCGAAAC	ACGAAACT
ATGAGAAC	TTGAGAAC
ATGTGCTG	AAGTGCTG
ATATGTCT	ATATCTCT
ATCTTGAG	ATCTGAGC
ATGTGGTG	AAGTGGTG
ATGCTATG	ATGCATGG
ATCTTGGC	ATCCTGGC
ATCGAGCA	ATCTGAGC
ATCGAGCC	ATCTGAGC
ATCGAGCG	ATCTGAGC
ATCGAGCT	ATCTGAGC
ATCGAGCN	ATCTGAGC
ATGCTCCG	ATGGTCCG
ATCCACTC	ATCCCTCT
ATCTTTGT	TCTTTGTA
ATGAGTCC	ATGGTCCG
ATGCTGAG	ATCTGAGC
ATCCAGGC	ATCCTGGC
ATCGATGG	TTCGATGG
ATAGAACC	GTAGAACC
ATGCTGGA	ATGCATGG
ATGTGTCC	ATGGTCCG
ATGCTGGG	ATGCATGG
ATGCTGGT	ATGCATGG
ATGCTGGN	ATGCATGG
ATAGAAGA	TAGAAGAG
ATAGAAGT	ATAAAGTC
ATAGAATA	AAGAATAA
ATATTCTA	ATATCTCT
ATATTCTC	ATATCTCT
ATATTCTG	ATATCTCT
ATATTCTT	ATATCTCT
ATATTCTN	ATATCTCT
ATCCATCT	ATCCCTCT
ATGCTTGG	ATGCATGG
ATCTNAGC	ATCTGAGC
ATGATAAA	CTGATAAA
ATATTTCT	ATATCTCT
ATCGCAGC	ACGCAGCC
ATAGAGGT	TAGAGGTT
ATAGAGTC	ATAAAGTC
ATCCCACT	ATCCCTCT
ATGATCCG	ATGGTCCG
ATCCCATC	ATCCCTCT
ATCTNGAG	ATCTGAGC
ATGATCTC	ATATCTCT
ATCGCCCT	ACGCCCTA
ATCGCCTC	ATCCCTCT
ATCCCCCT	ATCCCTCT
ATGTTCCG	ATGGTCCG
ATGCNATG	ATGCATGG
ATGATGGA	ATGCATGG
ATGTTCGG	TGTTCGGC
ATCCCCTA	ATCCCTCT
ATGATGGC	ATGCATGG
ATCCCCTC	ATCCCTCT
ATGATGGG	ATGCATGG
ATCCCCTG	ATCCCTCT
ATGATGGT	ATGCATGG
ATCCCCTT	ATCCCTCT
ATGATGGN	ATGCATGG
ATCCCCTN	ATCCCTCT
ATCCCGCT	ATCCCTCT
ATCCCGGC	ATCCTGGC
ATCCCGTC	ATCCCTCT
ATCCCTAC	ATCCCTCT
ATGTTTAA	TTGTTTAA
ATCCCTAT	ATCCCTCT
ATATNCTC	ATATCTCT
ATCCCTCA	ATCCCTCT
ATCGCTCT	ATCCCTCT
ATCCCTCC	ATCCCTCT
ATCCCTCG	ATCCCTCT
ATCCCTCT	ATCCCTCT
ATCCCTCN	ATCCCTCT
ATAGCATG	ATGCATGG
ATCGCTGG	ATCCTGGC
ATCCCTGC	ATCCCTCT
ATCCCTGG	ATCCTGGC
ATCCCTGT	ATCCCTCT
ATCCCTTA	ATCCCTCT
ATCCCTTC	ATCCCTCT
ATCCCTTG	ATCCCTCT
ATCCCTTT	ATCCCTCT
ATCCCTTN	ATCCCTCT
ATCCCTNC	ATCCCTCT
ATCCCTNT	ATCCCTCT
ATCCCNCT	ATCCCTCT
ATGCNTGG	ATGCATGG
ATCCCNTC	ATCCCTCT
ATATNTCT	ATATCTCT
ATCGGAGC	ATCTGAGC
ATCCGAGC	ATCTGAGC
ATAGCTCT	ATATCTCT
ATCGGCCA	ACGGCCAG
ATANAAGT	ATAAAGTC
ATCCGCTC	ATCCCTCT
ATCGGGGG	TCGGGGGA
ATCCGGCA	ATCCTGGC
ATGGACAT	AGGACATT
ATCCGGCC	ATCCTGGC
ATCCGGCG	ATCCTGGC
ATCCGGCT	ATCCTGGC
ATCCGGCN	ATCCTGGC
ATGGACCG	ATGGTCCG
ATCCGGGA	TCCGGGAC
ATCGGTCC	ATGGTCCG
ATCCGGGC	ATCCTGGC
ATAGGAGT	AAGGAGTG
ATCCGGTT	ACCGGTTG
ATCGGTTG	ACCGGTTG
ATCCGTCT	ATCCCTCT
ATCCGTGG	ATCCTGGC
ATANAGTC	ATAAAGTC
ATGGAGTG	AAGGAGTG
ATGCAAGG	ATGCATGG
ATGGATCC	ATGGTCCG
ATGCAATG	ATGCATGG
ATAGGGGA	AAGGGGAC
ATGGATGG	ATGCATGG
ATCGTATT	ACGTATTA
ATCNCCTC	ATCCCTCT
ATGCACGG	ATGCATGG
ATCGTCCG	ATGGTCCG
ATAGGTCC	ATGGTCCG
ATGCACTG	ATGCATGG
ATGCAGCC	ACGCAGCC
ATCGTGAG	ATCTGAGC
ATGCAGGA	ATGCATGG
ATGCAGGC	ATGCATGG
ATGCAGGG	ATGCATGG
ATGCAGGT	ATGCATGG
ATGCAGGN	ATGCATGG
ATGCAGTG	ATGCATGG
ATCGTGGC	ATCCTGGC
ATGGCATG	ATGCATGG
ATCNCTCT	ATCCCTCT
ATGCATAG	ATGCATGG
ATCNCTGG	ATCCTGGC
ATGCATCG	ATGCATGG
ATGCATGA	ATGCATGG
ATGGCCAG	ACGGCCAG
ATGCATGC	ATGCATGG
ATGCATGG	ATGCATGG
ATGCATGT	ATGCATGG
ATGCATGN	ATGCATGG
ATGGCCCG	ATGGTCCG
ATGCATTG	ATGCATGG
ATGGCCGA	ATGGTCCG
ATGGCCGG	ATGGTCCG
ATGGCCGT	ATGGTCCG
ATGCATNG	ATGCATGG
ATGGCCGN	ATGGTCCG
ATGGCGAC	TGGCGACT
ATGCANGG	ATGCATGG
ATAGTCCG	ATGGTCCG
ATGCANTG	ATGCATGG
ATGGCGTA	TTGGCGTA
ATAGTCTC	ATATCTCT
ATANCTCT	ATATCTCT
ATGCCACC	TGCCACCG
ATCNGAGC	ATCTGAGC
ATGGCTCC	ATGGTCCG
ATAGTGCT	AAGTGCTG
ATGCCATG	ATGCATGG
ATAGTGGT	AAGTGGTG
ATGCCCTA	ACGCCCTA
ATGCCCTC	ATCCCTCT
ATGCCGCC	AGGCCGCC
ATGNATGG	ATGCATGG
ATGCCTCT	ATCCCTCT
ATGGGCCG	ATGGTCCG
ATTTAGAC	TTTAGACA
ATGCCTTT	CTGCCTTT
ATTTAGCC	TTTTAGCC
ATGGGGAC	AAGGGGAC
ATGNCATG	ATGCATGG
ATGGGTCC	ATGGTCCG
ATCTAAGC	ATCTGAGC
ATNGTCCG	ATGGTCCG
ATCTAATT	ACTAATTT
ATCNTGAG	ATCTGAGC
ATCNTGGC	ATCCTGGC
ATCTAGAG	ATCTGAGC
ATCTAGCA	ATCTGAGC
ATGGTACC	ATGGTCCG
ATGGTACG	ATGGTCCG
ATCTAGCC	ATCTGAGC
ATCTAGCG	ATCTGAGC
ATCTAGCT	ATCTGAGC
ATCTAGCN	ATCTGAGC
ATATAAGT	ATAAAGTC
ATGGTCAC	ATGGTCCG
ATGGTCAG	ATGGTCCG
ATCTATAC	TTCTATAC
ATGGTCCA	ATGGTCCG
ATATACGA	GTATACGA
ATTTCTCT	ATATCTCT
ATANTCTC	ATATCTCT
ATATACTC	ATATCTCT
ATGGTCCC	ATGGTCCG
ATGGTCCG	ATGGTCCG
ATATAGTC	ATAAAGTC
ATGGTCCT	ATGGTCCG
ATGGTCCN	ATGGTCCG
ATGGTCGA	ATGGTCCG
ATGGTCGC	ATGGTCCG
ATGGTCGG	ATGGTCCG
ATGGTCGT	ATGGTCCG
ATGGTCGN	ATGGTCCG
ATGGTCTC	ATGGTCCG
ATGGTCTG	ATGGTCCG
ATATATCT	ATATCTCT
ATGGTCNC	ATGGTCCG
ATGNGTCC	ATGGTCCG
ATGGTCNG	ATGGTCCG
ATTTGAGC	ATCTGAGC
ATGGTGCC	ATGGTCCG
ATGGTGCG	ATGGTCCG
ATATCACC	AATCACCC
ATTTGCGT	TTTGCGTC
ATATCACT	ATATCTCT
ATTTGCTG	TTTGCTGA
ATATCATA	GATATCAT
ATATCATG	GATATCAT
ATATCATT	GATATCAT
ATATCATN	GATATCAT
ATNCATGG	ATGCATGG
ATATCCCT	ATATCTCT
ATGGTTCC	ATGGTCCG
ATATCCTA	ATATCTCT
ATATCCTC	ATATCTCT
ATGGTTCG	ATGGTCCG
ATATCCTG	ATATCTCT
ATATCCTN	ATATCTCT
ATATCGGA	CATATCGG
ATATCGGC	CATATCGG
ATATCGGG	CATATCGG
ATATCGGT	CATATCGG
ATATCGGN	CATATCGG
ATATCGTC	ATATCTCT
ATATCTAC	ATATCTCT
ATATCTAT	ATATCTCT
ATATCTCA	ATATCTCT
ATATCTCC	ATATCTCT
ATATCTCG	ATATCTCT
ATATCTCT	ATATCTCT
ATATCTCN	ATATCTCT
ATATCTGC	ATATCTCT
ATATCTGT	ATATCTCT
ATATCTTA	ATATCTCT
ATATCTTC	ATATCTCT
ATATCTTG	ATATCTCT
ATATCTTT	ATATCTCT
ATATCTTN	ATATCTCT
ATATCTNC	ATATCTCT
ATATCTNT	ATATCTCT
ATGGTNCC	ATGGTCCG
ATGGTNCG	ATGGTCCG
ATNCCCTC	ATCCCTCT
ATATCNCT	ATATCTCT
ATTTTAGC	TTTTAGCC
ATATCNTC	ATATCTCT
ANACAAGT	ACACAAGT
ATNCCTCT	ATCCCTCT
ATGNTCCG	ATGGTCCG
ATNCCTGG	ATCCTGGC
ATGGNCCG	ATGGTCCG
ATTTTTTA	CATTTTTT
ATTTTTTC	CATTTTTT
ATTTTTTG	CATTTTTT
ATTTTTTN	CATTTTTT
ATNTCTCT	ATATCTCT
ATGGNTCC	ATGGTCCG
ATTCCCAG	CTTCCCAG
ATNAAAGT	ATAAAGTC
ATTCCCTA	CATTCCCT
ATTCCCTG	CATTCCCT
ATTCCCTT	CATTCCCT
ATTCCCTN	CATTCCCT
ATNTGAGC	ATCTGAGC
ATTCCTCT	ATCCCTCT
ATNAAGTC	ATAAAGTC
ATTCCTGG	ATCCTGGC
ATNCTGAG	ATCTGAGC
ATNCTGGC	ATCCTGGC
ATTCGATG	TTCGATGG
ANACGCAT	AACGCATG
ATTAAAGT	ATAAAGTC
ATTCTATA	TTCTATAC
ATTAAGTC	ATAAAGTC
ATTCTCTA	ATATCTCT
ATTCTCTC	ATATCTCT
ATTCTCTG	ATATCTCT
ATTCTCTT	ATATCTCT
ATTCTCTN	ATATCTCT
ANACTGGG	AACTGGGA
ATTAATTT	ACTAATTT
ATTCTGAG	ATCTGAGC
ATTCTGGC	ATCCTGGC
ANCATCCT	ACATCCTT
ATNGCATG	ATGCATGG
ATNATCTC	ATATCTCT
ANAGAATA	AAGAATAA
ANAAAGTC	ATAAAGTC
ATTAGACA	TTTAGACA
ATNGGTCC	ATGGTCCG
ATTGAGAA	TTGAGAAC
ATTGAGCA	ATCTGAGC
ATTGAGCC	ATCTGAGC
ATTGAGCG	ATCTGAGC
ATTGAGCT	ATCTGAGC
ATTGAGCN	ATCTGAGC
ANCGCAGC	ACGCAGCC
ATTAGCAA	GTTAGCAA
ANCGCATG	AACGCATG
ANCGCCCT	ACGCCCTA
ATTGCATG	ATGCATGG
ANCCCTCT	ATCCCTCT
ATTGCGTC	TTTGCGTC
ATTATCTC	ATATCTCT
ATTGCTGA	TTTGCTGA
ANCGGCCA	ACGGCCAG
ATTGGCGT	TTGGCGTA
ANCCGGTT	ACCGGTTG
ANCGGTTG	ACCGGTTG
ATTGGTCC	ATGGTCCG
ANAATCGC	AAATCGCT
ANCGTATT	ACGTATTA
ANGCAGCC	ACGCAGCC
ATTGTATT	GTTGTATT
ATTGTCCG	ATGGTCCG
ANGCATGG	ATGCATGG
ANGGACAT	AGGACATT
ATTGTTTA	TTGTTTAA
ANCCTGGC	ATCCTGGC
ANGCCCTA	ACGCCCTA
ANGGAGTG	AAGGAGTG
ANGCCGCC	AGGCCGCC
ANGGCCAG	ACGGCCAG
ANGGCCGC	AGGCCGCC
ANCTAATT	ACTAATTT
ATTCACCC	AATCACCC
ATTCAGAT	TTCAGATA
ATTCATGG	ATGCATGG
ANCGAAAC	ACGAAACT
ANGGGGAC	AAGGGGAC
ANAGGAGT	AAGGAGTG
ANAGGGGA	AAGGGGAC
ANGGTCCG	ATGGTCCG
ANCTGAGC	ATCTGAGC
ANCTGGGA	AACTGGGA
ANAGTGCT	AAGTGCTG
ANAGTGGT	AAGTGGTG
ANGAAACT	ACGAAACT
ANGAATAA	AAGAATAA
ANGACATT	AGGACATT
ANGTATTA	ACGTATTA
ANTAAAGT	ATAAAGTC
ANATCACC	AATCACCC
ANCACAAG	ACACAAGT
ANATCCTT	ACATCCTT
ANATCGCT	AAATCGCT
ANTAATTT	ACTAATTT
ANATCTCT	ATATCTCT
CAACGAAA	CAACCGAA
CAACGAAC	CAACCGAA
CAACGAAG	CAACCGAA
CAACGAAT	CAACCGAA
CAACGAAN	CAACCGAA
ANGTGCTG	AAGTGCTG
CAACGCAT	AACGCATG
CAACGCGA	CAACCGAA
CAACGCGC	CACGCGCT
CAACGCTG	CGACGCTG
ANGTGGTG	AAGTGGTG
CAACGGAA	CAACCGAA
CAACGTGG	CACGTGGG
CAACTCAG	TAACTCAG
CAACTCGA	CAACCGAA
CAACTGAA	CAACCGAA
CAACTGGG	AACTGGGA
CAACTTCA	TCAACTTC
CAACTTCC	TCAACTTC
CAACTTCG	TCAACTTC
CAACTTCT	TCAACTTC
CAACTTCN	TCAACTTC
CAACTTGC	CAGCTTGC
CAAAAAGC	GAAAAAGC
CAAAATGC	CCAAATGC
CAACNCGA	CAACCGAA
CAAACCGA	CAACCGAA
CAACNGAA	CAACCGAA
CAAACGAA	CAACCGAA
ANTGCATG	ATGCATGG
CAAGAATA	AAGAATAA
CAAGACGA	TCAAGACG
CAAGACGG	TCAAGACG
CAAGACGT	TCAAGACG
CAAGACGN	TCAAGACG
CAAGAGTC	CCAGAGTC
CAAAGTAC	GAAAGTAC
ANTGGTCC	ATGGTCCG
CAAATAGG	GAAATAGG
CAAATCGC	AAATCGCT
CAAATCGG	CATATCGG
CAAGCCGA	CAACCGAA
CAAGCGAA	CAACCGAA
CAAATGCA	CCAAATGC
CAAATGCC	CCAAATGC
CAAATGCG	CCAAATGC
CAAATGCT	CCAAATGC
CAAGCGCT	CACGCGCT
CAAATGCN	CCAAATGC
ANTATCTC	ATATCTCT
CACCCGAA	CAACCGAA
CACCCGCA	TACCCGCA
CACCCGCT	CACGCGCT
CAAGCTTG	CAGCTTGC
CACCCTTC	CCCCTTCA
CAAGGAGT	AAGGAGTG
CAGCATGC	CAGCTTGC
CAGCATTG	CAGCTTGC
CACCGAAA	CAACCGAA
CACCGAAC	CAACCGAA
CACCGAAG	CAACCGAA
CACCGAAT	CAACCGAA
CACCGAAN	CAACCGAA
CAACACGA	CAACCGAA
CAGCCGAA	CAACCGAA
CAAGGGGA	AAGGGGAC
CACGNCGC	CACGCGCT
CAACAGAA	CAACCGAA
ANTCACCC	AATCACCC
CACNGCGC	CACGCGCT
CACGNGCT	CACGCGCT
CACCGCGC	CACGCGCT
CAGCCTGC	CAGCTTGC
CACCGCTA	CACGCGCT
CACCGCTC	CACGCGCT
CAGCCTTG	CAGCTTGC
CAGCCTTT	CTGCCTTT
CACCGCTG	CACGCGCT
CACGNGGG	CACGTGGG
CACCGCTT	CACGCGCT
CACCGCTN	CACGCGCT
CACGNTGG	CACGTGGG
CAACCAAA	CAACCGAA
CAACCAAC	CAACCGAA
CAACCAAG	CAACCGAA
CAGCGCGC	CACGCGCT
CAACCAAT	CAACCGAA
CAACCAAN	CAACCGAA
CAGCGCTA	CACGCGCT
CAGCGCTC	CACGCGCT
CACCGGTT	ACCGGTTG
CAGCGCTG	CACGCGCT
CAGCGCTT	CACGCGCT
CAACCAGA	CAACCGAA
CAGCGCTN	CACGCGCT
CAAGTGCT	AAGTGCTG
CACCGTGG	CACGTGGG
CAACCCAA	CAACCGAA
CAAGTGGG	CACGTGGG
CACTAATT	ACTAATTT
CAAGTGGT	AAGTGGTG
CACNGTGG	CACGTGGG
CAACCCGA	CAACCGAA
CACTACGG	CCTACGGT
CAGCGTGC	CAGCTTGC
ANTCCCTC	ATCCCTCT
CAGCGTGG	CACGTGGG
CAGCGTTG	CAGCTTGC
CAACCGAA	CAACCGAA
CAACCGAC	CAACCGAA
CAACCGAG	CAACCGAA
CAACCGAT	CAACCGAA
CAACCGAN	CAACCGAA
CAACCGCA	CAACCGAA
CAACCGGA	CAACCGAA
CAACCGTA	CAACCGAA
CAACCGNA	CAACCGAA
CAACCTAA	CAACCGAA
CAACCTGA	CAACCGAA
ANTCCTGG	ATCCTGGC
CAGCTAGC	CAGCTTGC
CACTATCG	CATATCGG
CAGCTATG	CAGCTTGC
CAACCNAA	CAACCGAA
CAACCNGA	CAACCGAA
CAGCTCGC	CAGCTTGC
CAGCTCTG	CAGCTTGC
CAGCTGCA	CAGCTTGC
CAGCTGCC	CAGCTTGC
CAGCTGCG	CAGCTTGC
CAGCTGCT	CAGCTTGC
CAGCTGCN	CAGCTTGC
CAGCTGGC	CAGCTTGC
CAGCTGTG	CAGCTTGC
CAGCTTAC	CAGCTTGC
CAGCTTAG	CAGCTTGC
CACCTGGG	CACGTGGG
CAGCTTCA	CAGCTTGC
CAGCTTCC	CAGCTTGC
CAGCTTCG	CAGCTTGC
CAGCTTCT	CAGCTTGC
CAGCTTCN	CAGCTTGC
CAGCTTGA	CAGCTTGC
CAGCTTGC	CAGCTTGC
CAGCTTGG	CAGCTTGC
CAGCTTGT	CAGCTTGC
CAGCTTGN	CAGCTTGC
CAGCTTTC	CAGCTTGC
CAGCTTTG	CAGCTTGC
CACTCCCT	CATTCCCT
CAGCTTNC	CAGCTTGC
CAGCTTNG	CAGCTTGC
CACCTTCA	CCCCTTCA
CACCTTGC	CAGCTTGC
CAGCTNGC	CAGCTTGC
CAGCTNTG	CAGCTTGC
CAGGTGGG	CACGTGGG
CACTCGCT	CACGCGCT
CAGGTTCG	CGGGTTCG
CACNTGGG	CACGTGGG
CAGGTTGC	CAGCTTGC
CAGCNTGC	CAGCTTGC
CAGCNTTG	CAGCTTGC
CACTGACG	CATGACGC
CACTGCGC	CACGCGCT
CAGGACAT	AGGACATT
CAGGACGC	CATGACGC
CACTGGGC	CACGTGGG
CACTGGGG	CACGTGGG
CACTGGGT	CACGTGGG
CACTGGGN	CACGTGGG
CAGNCTTG	CAGCTTGC
CAGGAGTG	AAGGAGTG
CACTGTGG	CACGTGGG
ANTCTGAG	ATCTGAGC
CAGGCCGC	AGGCCGCC
CACTTCCC	CATTCCCT
CACGAAAC	ACGAAACT
CACGAACA	CCGAACAT
CAGGCGCT	CACGCGCT
CACTTGCA	CAGCTTGC
CACTTGCC	CAGCTTGC
CACTTGCG	CAGCTTGC
CACTTGCT	CAGCTTGC
CACTTGCN	CAGCTTGC
CACTTGGG	CACGTGGG
CAGTATCG	CATATCGG
CAGGCTTG	CAGCTTGC
CAGAACAT	CCGAACAT
CACTTTTT	CATTTTTT
CAATATCG	CATATCGG
CAGAAGAG	TAGAAGAG
CAGAATAA	AAGAATAA
CACGAGCT	CACGCGCT
CAGTCCCT	CATTCCCT
CAGGGGAC	AAGGGGAC
CAATCACC	AATCACCC
CACGAGGG	CACGTGGG
CAATCCCT	CATTCCCT
CAGGGTTC	CGGGTTCG
CAATCCGA	CAACCGAA
CAATCGAA	CAACCGAA
CACGATGG	CACGTGGG
CAATCGAT	TAATCGAT
CACGATTA	CCGATTAA
CAATCGCT	AAATCGCT
CAGTCTTG	CAGCTTGC
CAATCGGA	CATATCGG
CAATCGGC	CATATCGG
CAATCGGG	CATATCGG
CAATCGGT	CATATCGG
CAATCGGN	CATATCGG
CAGACCGA	CAACCGAA
CAGACGCA	CATGACGC
CAGACGCC	CATGACGC
CAGACGCG	CATGACGC
CAGACGCN	CATGACGC
CAGTGACG	CATGACGC
CAGACTTG	CAGCTTGC
CAATGACG	CATGACGC
CAGTGCTG	AAGTGCTG
CAGNTTGC	CAGCTTGC
CACGCACT	CACGCGCT
CACGCATG	AACGCATG
CAGTGGGA	CACGTGGG
CAGTGGGC	CACGTGGG
CAGTGGGG	CACGTGGG
CAGTGGGT	CACGTGGG
CAGTGGGN	CACGTGGG
CAGTGGTG	AAGTGGTG
CACGCCGC	CACGCGCT
CACGCCTA	CACGCGCT
CACGCCTC	CACGCGCT
CAGTGTCC	CGTGTCCA
CACGCCTG	CACGCGCT
CACGCCTT	CACGCGCT
CACGCCTN	CACGCGCT
CACAAATG	CCAAATGC
CACGCGAC	CACGCGCT
CACGCGAT	CACGCGCT
CACGCGCA	CACGCGCT
CACGCGCC	CACGCGCT
CACGCGCG	CACGCGCT
CACGCGCT	CACGCGCT
CACGCGCN	CACGCGCT
CAGAGGTT	TAGAGGTT
CACGCGGC	CACGCGCT
CACGCGGG	CACGTGGG
CACGCGGT	CACGCGCT
CACGCGTA	CACGCGCT
CACGCGTC	CACGCGCT
CACGCGTG	CACGCGCT
CACGCGTT	CACGCGCT
CACGCGTN	CACGCGCT
CACGCGNC	CACGCGCT
CACGCGNT	CACGCGCT
CAGAGTCA	CCAGAGTC
CAGAGTCC	CCAGAGTC
CAGAGTCG	CCAGAGTC
CAGAGTCT	CCAGAGTC
CAGAGTCN	CCAGAGTC
CAGTTCCA	CGTTCCAA
CAGTTCCC	CATTCCCT
CAATTCCC	CATTCCCT
CACGCTCT	CACGCGCT
CAGTTGCA	CAGCTTGC
CAGTTGCC	CAGCTTGC
CACGCTGA	CGACGCTG
CAGATAAA	CTGATAAA
CAGTTGCG	CAGCTTGC
CAGTTGCT	CAGCTTGC
CACGCTGT	CGACGCTG
CAGTTGCN	CAGCTTGC
CACGCTGN	CGACGCTG
CACGCTTG	CAGCTTGC
CACGCNCT	CACGCGCT
CACGCNGC	CACGCGCT
CACAAGTA	ACACAAGT
CACAAGTC	ACACAAGT
CACAAGTG	ACACAAGT
CACAAGTT	ACACAAGT
CAGATCGG	CATATCGG
CACAAGTN	ACACAAGT
CAGTTTGC	CAGCTTGC
CAGTTTTT	CATTTTTT
CAATTTTC	GAATTTTC
CAATTTTT	CATTTTTT
CACNCGCT	CACGCGCT
CACGGCCA	ACGGCCAG
CAGATTAA	CCGATTAA
CACGGCGC	CACGCGCT
CACGGCTA	CACGCGCT
CACGGCTC	CACGCGCT
CACGGCTG	CACGCGCT
CACGGCTT	CACGCGCT
CACGGCTN	CACGCGCT
CAGATTGC	CAGCTTGC
CATAAAGT	ATAAAGTC
CACGGGCT	CACGCGCT
CACGGGGA	CACGTGGG
CACGGGGC	CACGTGGG
CACGGGGG	CACGTGGG
CACGGGGT	CACGTGGG
CACGGGGN	CACGTGGG
CATAACGC	CATGACGC
CATAACGG	CATATCGG
CACACAAG	ACACAAGT
CACGGTGG	CACGTGGG
CANATCGG	CATATCGG
CACACCGA	CAACCGAA
CACACGCT	CACGCGCT
CATAATCG	CATATCGG
CACGTAGG	CACGTGGG
CACGTATT	ACGTATTA
CACGTCGC	CACGCGCT
CACGTCGG	CACGTGGG
CACACTAC	CTCACTAC
CANGCGCT	CACGCGCT
CACGTGAG	CACGTGGG
CACGTGCG	CACGTGGG
CACGTGCT	CACGCGCT
CACGTGGA	CACGTGGG
CACGTGGC	CACGTGGG
CACGTGGG	CACGTGGG
CACGTGGT	CACGTGGG
CACGTGGN	CACGTGGG
CACGTGTG	CACGTGGG
CANGCTTG	CAGCTTGC
CACGTGNG	CACGTGGG
CAANCCGA	CAACCGAA
CACGTTGG	CACGTGGG
CCAAGACG	TCAAGACG
CAANCGAA	CAACCGAA
CATACCCT	CATTCCCT
CATACCGA	CAACCGAA
CCAAGAGT	CCAGAGTC
CATACCGG	CATATCGG
CCAAGATG	CCAAATGC
CACAGAGT	CCAGAGTC
CACAGCGC	CACGCGCT
CATACGCA	CATGACGC
CATACGCC	CATGACGC
CATACGCG	CATGACGC
CATACGCT	CATGACGC
CATACGCN	CATGACGC
CATACGGA	CATATCGG
CATACGGC	CATATCGG
CATACGGG	CATATCGG
CATACGGN	CATATCGG
CACGTNGG	CACGTGGG
CCAAAAGC	CCAAATGC
CATACTCG	CATATCGG
CCAAAATG	CCAAATGC
CCAAACAT	CCGAACAT
CCAAACGC	CCAAATGC
CCAAACTG	CCAAATGC
CCAAGTCA	CCAGAGTC
CCAAGTCC	CCAGAGTC
CCAAGTCG	CCAGAGTC
CCAAGTCT	CCAGAGTC
CCAAGTCN	CCAGAGTC
CCAAGTGC	CCAAATGC
CCAAAGCA	CCAAATGC
CCAAAGCC	CCAAATGC
CCAAAGCG	CCAAATGC
CCAAAGCT	CCAAATGC
CCAAAGCN	CCAAATGC
CCAAAGGC	CCAAATGC
CCAAAGTC	CCAGAGTC
CCAAAGTG	CCAAATGC
CATAGACG	CATGACGC
CCAAATAC	CCAAATGC
CCAAATAG	CCAAATGC
CCAAATCA	CCAAATGC
CCAAATCC	CCAAATGC
CCAAATCG	CCAAATGC
CCAAATCT	CCAAATGC
CCAAATCN	CCAAATGC
CCAAATGA	CCAAATGC
CCAAATGC	CCAAATGC
CACAGTGG	CACGTGGG
CCAAATGG	CCAAATGC
CCAAATGT	CCAAATGC
CCAAATGN	CCAAATGC
CACAGTTA	GACAGTTA
CCAAATTC	CCAAATGC
CCAAATTG	CCAAATGC
CATNACGC	CATGACGC
CATAGCGG	CATATCGG
CCAAATNC	CCAAATGC
CCAAATNG	CCAAATGC
CANGTGGG	CACGTGGG
CCAATATG	CCAAATGC
CCAAANGC	CCAAATGC
CATNATCG	CATATCGG
CCAAANTG	CCAAATGC
CACATCCT	ACATCCTT
CACATCGG	CATATCGG
CCAATGCA	CCAAATGC
CCAATGCC	CCAAATGC
CCAATGCG	CCAAATGC
CCAATGCT	CCAAATGC
CCAATGCN	CCAAATGC
CACATGGG	CACGTGGG
CCAACATA	CCGAACAT
CCAACATC	CCGAACAT
CCAACATT	CCGAACAT
CCAACATN	CCGAACAT
CCAATTAA	CCGATTAA
CCAATTGC	CCAAATGC
CCAACCGA	CAACCGAA
CATAGTCG	CATATCGG
CATNCCCT	CATTCCCT
CANCCGAA	CAACCGAA
CATANCGG	CATATCGG
CCAACGGT	CCTACGGT
CATATACG	CATATCGG
CATATAGG	CATATCGG
CCAANATG	CCAAATGC
CATATCAG	CATATCGG
CATATCAT	GATATCAT
CCAACTGC	CCAAATGC
CATATCCC	CATTCCCT
CATATCCG	CATATCGG
CCAACTTC	TCAACTTC
CATATCGA	CATATCGG
CATATCGC	CATATCGG
CATATCGG	CATATCGG
CATATCGT	CATATCGG
CATATCGN	CATATCGG
CATATCTC	ATATCTCT
CATATCTG	CATATCGG
CATATCNG	CATATCGG
CATATGCG	CATATCGG
CATATGGA	CATATCGG
CATATGGC	CATATCGG
CATATGGG	CATATCGG
CATATGGT	CATATCGG
CATATGGN	CATATCGG
CATANTCG	CATATCGG
CATNGACG	CATGACGC
CATATTCG	CATATCGG
CATATTGG	CATATCGG
CANCGCGC	CACGCGCT
CATATTTT	CATTTTTT
CCAANTGC	CCAAATGC
CATATNCG	CATATCGG
CATATNGG	CATATCGG
CCAGAACA	CCGAACAT
CANTATCG	CATATCGG
CCAGAAGT	CCAGAGTC
CCAGAATC	CCAGAGTC
CCAGAATG	CCAAATGC
CANCGTGG	CACGTGGG
CCGCTTAA	CCGATTAA
CCAGACGT	CCAGAGTC
CCGCTTCA	CCCCTTCA
CCAGACTC	CCAGAGTC
CATCACCC	AATCACCC
CCGCTTGC	CAGCTTGC
CATCACGC	CATGACGC
CCAGAGAC	CCAGAGTC
CCAGAGAT	CCAGAGTC
CATCACTA	CTCACTAC
CCAGAGCA	CCAGAGTC
CCAGAGCC	CCAGAGTC
CCAGAGCG	CCAGAGTC
CCACAAGT	ACACAAGT
CCAGAGCT	CCAGAGTC
CCAGAGCN	CCAGAGTC
CCACAATG	CCAAATGC
CCAGAGGC	CCAGAGTC
CCAGAGGT	CCAGAGTC
CCAGAGTA	CCAGAGTC
CCAGAGTC	CCAGAGTC
CCAGAGTG	CCAGAGTC
CCAGAGTT	CCAGAGTC
CCAGAGTN	CCAGAGTC
CCAGAGNC	CCAGAGTC
CCAGAGNT	CCAGAGTC
CCAGATCA	CCAGAGTC
CCAGATCC	CCAGAGTC
CCAGATCG	CCAGAGTC
CCAGATCT	CCAGAGTC
CCAGATCN	CCAGAGTC
CCAGATGC	CCAAATGC
CCAGATGT	CCAGAGTC
CCAGATTA	CCGATTAA
CCAGATTC	CCAGAGTC
CATCATCG	CATATCGG
CCAGANGT	CCAGAGTC
CCAGANTC	CCAGAGTC
CCACAGTC	CCAGAGTC
CANCTTGC	CAGCTTGC
CCAGCAGT	CCAGAGTC
CATCCCAG	CTTCCCAG
CATCCCCT	CATTCCCT
CCACATGC	CCAAATGC
CATCCCTA	CATTCCCT
CATCCCTG	CATTCCCT
CATCCCTT	CATTCCCT
CATCCCTN	CATTCCCT
CATCCGAA	CAACCGAA
CCAGCGTC	CCAGAGTC
CCGGAACA	CCGAACAT
CANTCCCT	CATTCCCT
CATCCTGG	ATCCTGGC
CATCCTTA	ACATCCTT
CATCCTTC	ACATCCTT
CATCCTTG	ACATCCTT
CATCCTTT	ACATCCTT
CATCCTTN	ACATCCTT
CCGGACAT	CCGAACAT
CCAGCTTG	CAGCTTGC
CATCGACG	CATGACGC
CATNTCCC	CATTCCCT
CCGGAGTC	CCAGAGTC
CCAGGAGT	CCAGAGTC
CATNTCGG	CATATCGG
CATCGCGC	CACGCGCT
CCGGATTA	CCGATTAA
CATGGACG	CATGACGC
CCACCGAA	CAACCGAA
CCAGGGTC	CCAGAGTC
CANTGACG	CATGACGC
CCAGGTCA	CCAGAGTC
CCAGGTCC	CCAGAGTC
CATCGTGG	CACGTGGG
CCAGGTCG	CCAGAGTC
CCAGGTCT	CCAGAGTC
CCAGGTCN	CCAGAGTC
CCACCTTC	CCCCTTCA
CANGACGC	CATGACGC
CATGGCGC	CATGACGC
CCGGCCAG	ACGGCCAG
CATNTTTT	CATTTTTT
CCAGTAGT	CCAGAGTC
CATCTCCC	CATTCCCT
CCACGAGT	CCAGAGTC
CATCTCGG	CATATCGG
CATGGTCC	ATGGTCCG
CATCTGAG	ATCTGAGC
CCACGCGC	CACGCGCT
CCACGCTG	CGACGCTG
CCAGTGTC	CCAGAGTC
CCGGGACA	TCCGGGAC
CCGGGACC	TCCGGGAC
CATCTTGC	CAGCTTGC
CCGGGACG	TCCGGGAC
CCGGGACT	TCCGGGAC
CCGGGACN	TCCGGGAC
CATCTTTT	CATTTTTT
CCACGGTA	CCTACGGT
CCACGGTC	CCTACGGT
CCACGGTG	CCTACGGT
CCACGGTT	CCTACGGT
CCACGGTN	CCTACGGT
CANTTCCC	CATTCCCT
CCACGTGG	CACGTGGG
CATGTACG	CATGACGC
CCGGGGGA	TCGGGGGA
CCAGNAGT	CCAGAGTC
CATGTCCA	CGTGTCCA
CATGTCCC	CATTCCCT
CATGTCGC	CATGACGC
CCGGGTTC	CGGGTTCG
CATGTCGG	CATATCGG
CANTTTTT	CATTTTTT
CCACTACA	CTCACTAC
CCACTACC	CTCACTAC
CCACTACG	CTCACTAC
CCACTACT	CTCACTAC
CCACTACN	CTCACTAC
CATGTGGG	CACGTGGG
CCAGNGTC	CCAGAGTC
CCGAAAAT	CCGAACAT
CCGAAACA	CCGAACAT
CCGAAACT	ACGAAACT
CCGAAATA	CCGAACAT
CCGAAATC	CCGAACAT
CCGAAATT	CCGAACAT
CCGAAATN	CCGAACAT
CCGAACAA	CCGAACAT
CCGAACAC	CCGAACAT
CCGAACAG	CCGAACAT
CCGAACAT	CCGAACAT
CCGAACAN	CCGAACAT
CCGAACCA	CCGAACAT
CATGTTTT	CATTTTTT
CCGAACCT	CCGAACAT
CCGAACGA	CCGAACAT
CCGAACGT	CCGAACAT
CCGAACTA	CCGAACAT
CCGAACTC	CCGAACAT
CCGAACTG	CCGAACAT
CCGAACTT	CCGAACAT
CCGAACTN	CCGAACAT
CCGAACNA	CCGAACAT
CCGAACNT	CCGAACAT
CCGAAGAT	CCGAACAT
CCGAAGCA	CCGAACAT
CATGAACG	CATGACGC
CCGGTTAA	CCGATTAA
CATGAAGC	CATGACGC
CCACTTCA	CCCCTTCA
CCGGTTCG	CGGGTTCG
CCGGTTGA	ACCGGTTG
CCGAATAA	CCGATTAA
CCGGTTGC	ACCGGTTG
CCGGTTGG	ACCGGTTG
CATGNACG	CATGACGC
CCGGTTGT	ACCGGTTG
CCGGTTGN	ACCGGTTG
CCGAATAT	CCGAACAT
CCATAATG	CCAAATGC
CCGAATCA	CCGAACAT
CATGACAC	CATGACGC
CATGACAG	CATGACGC
CATGACCA	CATGACGC
CCGAATGC	CCAAATGC
CATGACCC	CATGACGC
CATGACCG	CATGACGC
CATGACCT	CATGACGC
CATGACCN	CATGACGC
CCGAATTA	CCGATTAA
CATGACGA	CATGACGC
CATGACGC	CATGACGC
CATGACGG	CATGACGC
CATGACGT	CATGACGC
CATGACGN	CATGACGC
CATGACTC	CATGACGC
CATGACTG	CATGACGC
CCATACGG	CCTACGGT
CATGACNC	CATGACGC
CATGACNG	CATGACGC
CCGAANAT	CCGAACAT
CCGAANCA	CCGAACAT
CATGAGCA	CATGACGC
CATGAGCC	CATGACGC
CATGAGCG	CATGACGC
CATGAGCT	CATGACGC
CATGAGCN	CATGACGC
CATGAGGC	CATGACGC
CCATAGTC	CCAGAGTC
CCGACACA	CCGAACAT
CATGATAA	CTGATAAA
CCGACATA	CCGAACAT
CCGACATC	CCGAACAT
CATGATGC	CATGACGC
CCATATCG	CATATCGG
CCGACATG	CCGAACAT
CCGACATT	CCGAACAT
CATGNCGC	CATGACGC
CCGACATN	CCGAACAT
CCATATGC	CCAAATGC
CCGACCAT	CCGAACAT
CATGANCG	CATGACGC
CATGANGC	CATGACGC
CCGACGCT	CGACGCTG
CCGACGGT	CCTACGGT
CATGCACG	CATGACGC
CCGACTAA	CCGATTAA
CATGCATG	ATGCATGG
CCGACTTA	CCGATTAA
CCCTTCAA	CCCCTTCA
CCCTTCAC	CCCCTTCA
CANACCGA	CAACCGAA
CCCTTCAG	CCCCTTCA
CATGCCCT	CATTCCCT
CCCTTCAT	CCCCTTCA
CCCTTCAN	CCCCTTCA
CATGCCGC	CATGACGC
CATGCCTT	CTGCCTTT
CCATCCTT	ACATCCTT
CATGCGCA	CATGACGC
CATGCGCC	CATGACGC
CATGCGCG	CATGACGC
CATGCGCN	CATGACGC
CCGAGACA	CCGAACAT
CCGTAAAT	GCGTAAAT
CCGTAACA	CCGAACAT
CCGAGAGT	CCAGAGTC
CCGAGCAT	CCGAACAT
CATGCTTG	CAGCTTGC
CCGTACAT	CCGAACAT
CCCTTTCA	CCCCTTCA
CCGTACGG	CCTACGGT
CATTACCC	CATTCCCT
CATTACCT	CATTCCCT
CATTACGC	CATGACGC
CCATTAAA	CCGATTAA
CCATTAAC	CCGATTAA
CCATTAAG	CCGATTAA
CCATTAAT	CCGATTAA
CCATTAAN	CCGATTAA
CCGAGTAA	CCGATTAA
CCGAGTCA	CCAGAGTC
CCGAGTCC	CCAGAGTC
CCGAGTCG	CCAGAGTC
CCGAGTCT	CCAGAGTC
CCGAGTCN	CCAGAGTC
CCGAGTTA	CCGATTAA
CCATTCCC	CATTCCCT
CATTATCG	CATATCGG
CATTATTT	CATTTTTT
CCATGACG	CATGACGC
CCATGAGT	CCAGAGTC
CCGATAAC	CCGATTAA
CCGATAAG	CCGATTAA
CCGATAAT	CCGATTAA
CCGATAAN	CCGATTAA
CCGATACA	CCGAACAT
CCGATATA	CCGATTAA
CATTCACC	CATTCCCT
CATTCACT	CATTCCCT
CCGATCAA	CCGATTAA
CCGATCAT	CCGAACAT
CCATTTTT	CATTTTTT
CATTCCAA	CGTTCCAA
CCGATCTA	CCGATTAA
CATTCCAC	CATTCCCT
CATTCCAT	CATTCCCT
CATTCCCC	CATTCCCT
CATTCCCG	CATTCCCT
CATTCCCT	CATTCCCT
CATTCCCN	CATTCCCT
CATTCCGC	CATTCCCT
CCGATGAA	CCGATTAA
CATTCCGT	CATTCCCT
CATTCCTA	CATTCCCT
CATTCCTC	CATTCCCT
CATTCCTG	CATTCCCT
CATTCCTT	CATTCCCT
CATTCCTN	CATTCCCT
CATTCCNC	CATTCCCT
CATTCCNT	CATTCCCT
CCGATGTA	CCGATTAA
CCGTGGGA	CACGTGGG
CCGTGGGC	CACGTGGG
CCGTGGGG	CACGTGGG
CCGTGGGT	CACGTGGG
CATTCGCC	CATTCCCT
CCGTGGGN	CACGTGGG
CATTCGCT	CATTCCCT
CATTCGGA	CATATCGG
CCGATTAA	CCGATTAA
CATTCGGC	CATATCGG
CCGATTAC	CCGATTAA
CATTCGGG	CATATCGG
CCGATTAG	CCGATTAA
CATTCGGT	CATATCGG
CCGATTAT	CCGATTAA
CATTCGGN	CATATCGG
CCGATTAN	CCGATTAA
CCGATTCA	CCGATTAA
CCGATTGA	CCGATTAA
CCGTGTCC	CGTGTCCA
CCGATTTA	CCGATTAA
CATTCTCC	CATTCCCT
CCGATTNA	CCGATTAA
CATTCTCT	CATTCCCT
CCGATNAA	CCGATTAA
CATTCTTT	CATTTTTT
CCGATNTA	CCGATTAA
CATTCNCC	CATTCCCT
CATTCNCT	CATTCCCT
CCGANACA	CCGAACAT
CATTGACG	CATGACGC
CCGANCAT	CCGAACAT
CCGTTAAA	CCGATTAA
CCGTTAAG	CCGATTAA
CCGTTAAT	CCGATTAA
CCGTTAAN	CCGATTAA
CATTGCCC	CATTCCCT
CATTGCCT	CATTCCCT
CCGTTCCA	CGTTCCAA
CCANAATG	CCAAATGC
CCCCNTCA	CCCCTTCA
CCCCNTTC	CCCCTTCA
CCGANTAA	CCGATTAA
CATTGTTT	CATTTTTT
CCGTTTAA	CCGATTAA
CCANAGTC	CCAGAGTC
CCGANTTA	CCGATTAA
CCANATGC	CCAAATGC
CCCGAACA	CCGAACAT
CATTTATT	CATTTTTT
CATTTCCC	CATTCCCT
CATTTCCT	CATTCCCT
CATTTCGG	CATATCGG
CATTTCTT	CATTTTTT
CCGCAACA	CCGAACAT
CCCNCTTC	CCCCTTCA
CATTTGTT	CATTTTTT
CCGCACAT	CCGAACAT
CCCGAGTC	CCAGAGTC
CATTTTAT	CATTTTTT
CATTTTCT	CATTTTTT
CATTTTGT	CATTTTTT
CATTTTTA	CATTTTTT
CATTTTTC	CATTTTTT
CATTTTTG	CATTTTTT
CATTTTTT	CATTTTTT
CCTAAATG	CCAAATGC
CATTTTTN	CATTTTTT
CCCGATTA	CCGATTAA
CCTAACAT	CCGAACAT
CCTAACGG	CCTACGGT
CATTTTNT	CATTTTTT
CCGCAGCC	ACGCAGCC
CGAAAAAG	GAAAAAGC
CCTAAGGT	CCTACGGT
CGAAAAGA	GGAAAAGA
CCTAATGC	CCAAATGC
CCTAATTT	ACTAATTT
CCANGAGT	CCAGAGTC
CATTTNTT	CATTTTTT
CGAAACTA	ACGAAACT
CGAAACTC	ACGAAACT
CGAAACTG	ACGAAACT
CGAAACTT	ACGAAACT
CGAAACTN	ACGAAACT
CCGCATTA	CCGATTAA
CCCGCGCT	CACGCGCT
CGAAAGTA	GAAAGTAC
CATTNCCC	CATTCCCT
CATTNCCT	CATTCCCT
CCTACAGG	CCTACGGT
CCTACAGT	CCTACGGT
CGAAATAG	GAAATAGG
CGAAATGC	CCAAATGC
CCCGCTTC	CCCCTTCA
CCTACCGG	CCTACGGT
CCTACCGT	CCTACGGT
CCTACGAG	CCTACGGT
CCTACGAT	CCTACGGT
CCTACGCG	CCTACGGT
CCTACGCT	CCTACGGT
CCTACGGA	CCTACGGT
CCGCCCTA	ACGCCCTA
CCTACGGC	CCTACGGT
CCTACGGG	CCTACGGT
CCTACGGT	CCTACGGT
CCTACGGN	CCTACGGT
CCTACGTA	CCTACGGT
CATTNTTT	CATTTTTT
CCTACGTC	CCTACGGT
CCTACGTG	CCTACGGT
CCGNAACA	CCGAACAT
CCTACGTT	CCTACGGT
CCTACGTN	CCTACGGT
CCTACGNG	CCTACGGT
CCTACGNT	CCTACGGT
CGAACATA	CCGAACAT
CGAACATC	CCGAACAT
CGAACATG	CCGAACAT
CGAACATT	CCGAACAT
CGAACATN	CCGAACAT
CCTACTGG	CCTACGGT
CCTACTGT	CCTACGGT
CCGNACAT	CCGAACAT
CGAACCGA	CAACCGAA
CCGCCTTC	CCCCTTCA
CCGCCTTT	CTGCCTTT
CCTACNGG	CCTACGGT
CCTACNGT	CCTACGGT
CCCGGGAC	TCCGGGAC
CGAACGCT	CGACGCTG
CCCNTTCA	CCCCTTCA
CCTAGAGT	CCAGAGTC
CCGNATTA	CCGATTAA
CCCACGGT	CCTACGGT
CCCGGTTG	ACCGGTTG
CCTAGCGG	CCTACGGT
CCGCGCTA	CACGCGCT
CCGCGCTC	CACGCGCT
CCGCGCTG	CACGCGCT
CCGCGCTT	CACGCGCT
CCGCGCTN	CACGCGCT
CCTAGGGT	CCTACGGT
CCTAGGTA	CCTACGGT
CCTAGGTC	CCTACGGT
CCTAGGTG	CCTACGGT
CCTAGGTT	CCTACGGT
CCTAGGTN	CCTACGGT
CCCACTAC	CTCACTAC
CCCACTTC	CCCCTTCA
CGAAGCTG	CGACGCTG
CCTATGGT	CCTACGGT
CCTATTAA	CCGATTAA
CCCGTGGG	CACGTGGG
CCCAAATG	CCAAATGC
CCCAGAGT	CCAGAGTC
CCCAACAT	CCGAACAT
CCCGTTCA	CCCCTTCA
CCTANCGG	CCTACGGT
CCCAATGC	CCAAATGC
CGAATTTT	GAATTTTC
CCTANGGT	CCTACGGT
CCNTACGG	CCTACGGT
CCCAGTCA	GCCCAGTC
CCCAGTCC	GCCCAGTC
CCCAGTCG	GCCCAGTC
CCCAGTCT	GCCCAGTC
CCCAGTCN	GCCCAGTC
CCNCCTTC	CCCCTTCA
CCTCGGTA	CCTACGGT
CCTCGGTC	CCTACGGT
CCTCGGTG	CCTACGGT
CCTCGGTT	CCTACGGT
CCTCGGTN	CCTACGGT
CCGNTTAA	CCGATTAA
CCTCACGG	CCTACGGT
CCTCACTA	CTCACTAC
CCTCGTTC	GCTCGTTC
CCCATTAA	CCGATTAA
CCCATTCA	CCCCTTCA
CGACACTG	CGACGCTG
CGACAGCT	CGACGCTG
CCCTACGG	CCTACGGT
CCTCCCAG	CTTCCCAG
CCTCTTCA	CCCCTTCA
CGACAGTT	GACAGTTA
CGGGCTCG	CGGGTTCG
CGGGCTTC	CGGGTTCG
CCTCCGGT	CCTACGGT
CCTCCTTC	CCCCTTCA
CCNCTTCA	CCCCTTCA
CGAGTCCA	CGTGTCCA
CGGGGGAA	TCGGGGGA
CGGGGGAC	TCGGGGGA
CGGGGGAG	TCGGGGGA
CGGGGGAT	TCGGGGGA
CGGGGGAN	TCGGGGGA
CGACCCTG	CGACGCTG
CGACCGAA	CAACCGAA
CGACCGCT	CGACGCTG
CGAGTTCG	CGGGTTCG
CCTGAACA	CCGAACAT
CGGGGTCG	CGGGTTCG
CGGGGTTC	CGGGTTCG
CCTGACGC	CATGACGC
CCTGACGG	CCTACGGT
CCCTCTTC	CCCCTTCA
CGACCTGA	CGACGCTG
CGACCTGC	CGACGCTG
CGACCTGG	CGACGCTG
CGACCTGT	CGACGCTG
CGACCTGN	CGACGCTG
CCNGAACA	CCGAACAT
CCTGAGTC	CCAGAGTC
CCTGATAA	CTGATAAA
CCTGATTA	CCGATTAA
CCCCAGTC	GCCCAGTC
CCCCATCA	CCCCTTCA
CGGGTACG	CGGGTTCG
CGACGACT	CGACGCTG
CCCCATTC	CCCCTTCA
CGACGATG	CGACGCTG
CGGGTATC	CGGGTTCG
CGACGCAG	CGACGCTG
CGACGCAT	CGACGCTG
CGACGCCG	CGACGCTG
CGACGCCT	CGACGCTG
CCNGAGTC	CCAGAGTC
CGACGCGA	CGACGCTG
CGACGCGG	CGACGCTG
CGACGCGT	CGACGCTG
CGACGCGN	CGACGCTG
CGACGCTA	CGACGCTG
CGACGCTC	CGACGCTG
CGACGCTG	CGACGCTG
CGACGCTT	CGACGCTG
CGACGCTN	CGACGCTG
CGACGCNG	CGACGCTG
CGACGCNT	CGACGCTG
CCNGATTA	CCGATTAA
CGACGGCT	CGACGCTG
CGGGTCCA	CGTGTCCA
CCTGCCTT	CTGCCTTT
CGGGTCCG	CGGGTTCG
CGGGTCGA	CGGGTTCG
CGGGTCGC	CGGGTTCG
CGACGGTG	CGACGCTG
CGATAAAA	CTGATAAA
CGGGTCGG	CGGGTTCG
CGATAAAC	CTGATAAA
CGATAAAG	CTGATAAA
CGGGTCGT	CGGGTTCG
CGATAAAT	CTGATAAA
CGGGTCGN	CGGGTTCG
CGATAAAN	CTGATAAA
CCTGCGGT	CCTACGGT
CGACGTCT	CGACGCTG
CGACGTGA	CGACGCTG
CGACGTGC	CGACGCTG
CGACGTGT	CGACGCTG
CGACGTGN	CGACGCTG
CGACGTTG	CGACGCTG
CGGGTCTC	CGGGTTCG
CGACGNCT	CGACGCTG
CGACGNTG	CGACGCTG
CCCCCTCA	CCCCTTCA
CGGGTGCG	CGGGTTCG
CCCCCTTC	CCCCTTCA
CGATATCA	GATATCAT
CGATATCG	CATATCGG
CGGGTGTC	CGGGTTCG
CGGGTTAC	CGGGTTCG
CGGGTTAG	CGGGTTCG
CGGGTTCA	CGGGTTCG
CGACTCTG	CGACGCTG
CGGGTTCC	CGGGTTCG
CGGGTTCG	CGGGTTCG
CGGGTTCT	CGGGTTCG
CGGGTTCN	CGGGTTCG
CGGGTTGA	CGGGTTCG
CGGGTTGC	CGGGTTCG
CGGGTTGG	CGGGTTCG
CGGGTTGT	CGGGTTCG
CGGGTTGN	CGGGTTCG
CGGGTTTC	CGGGTTCG
CGGGTTTG	CGGGTTCG
CGGGTTNC	CGGGTTCG
CGGGTTNG	CGGGTTCG
CGACTGCT	CGACGCTG
CGATCCAA	CGTTCCAA
CGGGTNCG	CGGGTTCG
CGGGTNTC	CGGGTTCG
CGATCGCT	CGACGCTG
CGACNCTG	CGACGCTG
CCCCGTCA	CCCCTTCA
CCCCGTTC	CCCCTTCA
CGATGAAC	GGATGAAC
CGACNGCT	CGACGCTG
CGATGACG	CATGACGC
CCCCTACA	CCCCTTCA
CCCCTATC	CCCCTTCA
CGATGCTG	CGACGCTG
CCCCTCAA	CCCCTTCA
CCCCTCAC	CCCCTTCA
CCCCTCAG	CCCCTTCA
CCCCTCAT	CCCCTTCA
CCCCTCAN	CCCCTTCA
CCCCTCCA	CCCCTTCA
CCTGTCCA	CGTGTCCA
CCCCTCTC	CCCCTTCA
CCCCTGCA	CCCCTTCA
CCNAAATG	CCAAATGC
CGATGTCC	CGTGTCCA
CCCCTGTC	CCCCTTCA
CCCCTTAA	CCCCTTCA
CCCCTTAC	CCCCTTCA
CCCCTTAG	CCCCTTCA
CCCCTTAT	CCCCTTCA
CGGGNTCG	CGGGTTCG
CCCCTTAN	CCCCTTCA
CCCCTTCA	CCCCTTCA
CCCCTTCC	CCCCTTCA
CCCCTTCG	CCCCTTCA
CCCCTTCT	CCCCTTCA
CCCCTTCN	CCCCTTCA
CCCCTTGA	CCCCTTCA
CCCCTTGC	CCCCTTCA
CGGGNTTC	CGGGTTCG
CCNAACAT	CCGAACAT
CCCCTTTA	CCCCTTCA
CCCCTTTC	CCCCTTCA
CCCCTTNA	CCCCTTCA
CCCCTTNC	CCCCTTCA
CCCCTNCA	CCCCTTCA
CGATTAAA	CCGATTAA
CGATTAAC	CCGATTAA
CGATTAAG	CCGATTAA
CGATTAAT	CCGATTAA
CGATTAAN	CCGATTAA
CCCCTNTC	CCCCTTCA
CCNAATGC	CCAAATGC
CGATTCCA	CGTTCCAA
CGGATAAA	CTGATAAA
CGATTCCC	CATTCCCT
CGGATGAA	GGATGAAC
CCNACGGT	CCTACGGT
CGATTTTT	CATTTTTT
CGGATTAA	CCGATTAA
CCTTCCAA	CGTTCCAA
CGGATTCG	CGGGTTCG
CGANCGCT	CGACGCTG
CCTTCCCA	CTTCCCAG
CGAGAGTC	CCAGAGTC
CCTTCCCT	CATTCCCT
CCTTCGGT	CCTACGGT
CGANGCTG	CGACGCTG
CGGTCCAC	CGTGTCCA
CGGTCCAG	CGTGTCCA
CGGTCCAT	CGTGTCCA
CGGTCCAN	CGTGTCCA
CCNAGAGT	CCAGAGTC
CGGCAAAA	GGCAAAAT
CGAGCGCT	CGACGCTG
CGAGCTGA	CGACGCTG
CGAGCTGC	CGACGCTG
CGAGCTGG	CGACGCTG
CGAGCTGT	CGACGCTG
CGAGCTGN	CGACGCTG
CGAGCTTG	CAGCTTGC
CCTTTACC	GCTTTACC
CCNATTAA	CCGATTAA
CGAGGCTG	CGACGCTG
CGGTGTCC	CGTGTCCA
CGGTGTTC	CGGGTTCG
CGGTGTTT	GGTGTTTC
CGGCCAGA	ACGGCCAG
CGGCCAGC	ACGGCCAG
CGGCCAGG	ACGGCCAG
CGGCCAGT	ACGGCCAG
CGGCCAGN	ACGGCCAG
CCTTTGTA	TCTTTGTA
CGAGGTTC	CGGGTTCG
CCTTTTTT	CATTTTTT
CGTAGAAC	GTAGAACC
CGGCCGCC	AGGCCGCC
CGGTTCCA	CGTTCCAA
CGGTTCGA	CGGGTTCG
CGCAAAAT	GGCAAAAT
CGGTTCGC	CGGGTTCG
CGGTTCGG	CGGGTTCG
CGGTTCGT	CGGGTTCG
CGGTTCGN	CGGGTTCG
CGGCCTTT	CTGCCTTT
CGCAAATG	CCAAATGC
CGTAGTCC	CGTGTCCA
CGGCGACT	TGGCGACT
CGGTTTCG	CGGGTTCG
CGTATACG	GTATACGA
CGCGGGTT	TGCGGGTT
CCTNACGG	CCTACGGT
CGGCGCTG	CGACGCTG
CGCGGTTC	CGGGTTCG
CGCGTAAA	GCGTAAAT
CGTATCGG	CATATCGG
CGCACGCT	CGACGCTG
CGCGTCCA	CGTGTCCA
CGGCGTTC	CGGGTTCG
CGCACTAC	CTCACTAC
CTAAAGTC	ATAAAGTC
CGCGTGGG	CACGTGGG
CGTATTAA	ACGTATTA
CGTATTAC	ACGTATTA
CGTATTAG	ACGTATTA
CGTATTAT	ACGTATTA
CGTATTAN	ACGTATTA
CGCGTTAA	GCGTTAAC
CGCGTTCG	CGGGTTCG
CTAAATGC	CCAAATGC
CGCAGAGT	CCAGAGTC
CGCAGCCA	ACGCAGCC
CGCAGCCC	ACGCAGCC
CGCAGCCG	ACGCAGCC
CGCAGCCT	ACGCAGCC
CGCAGCCN	ACGCAGCC
CCTNCGGT	CCTACGGT
CGGCTTCG	CGGGTTCG
CTAACCGA	CAACCGAA
CGGCTTGC	CAGCTTGC
CTAACTAC	CTCACTAC
CTAACTCA	TAACTCAG
CGGNGTTC	CGGGTTCG
CGCTACGG	CCTACGGT
CGTCACTA	CTCACTAC
CGCCACCG	TGCCACCG
CGGAAAAG	GGAAAAGA
CGGGACCC	GGGACCCG
CTAATAAA	CTGATAAA
CGGAACAT	CCGAACAT
CGTGACCA	CGTGTCCA
CGTGACGC	CATGACGC
CTAATCGA	TAATCGAT
CGCCCAGT	GCCCAGTC
CGCTCCAA	CGTTCCAA
CGGNTTCG	CGGGTTCG
CGGGATCG	CGGGTTCG
CGTCCAAA	CGTTCCAA
CGTCCAAC	CGTTCCAA
CGTCCAAG	CGTTCCAA
CGTCCAAT	CGTTCCAA
CGTCCAAN	CGTTCCAA
CGTGATAA	CTGATAAA
CGCCCTAA	ACGCCCTA
CGGGATTC	CGGGTTCG
CGCCCTAC	ACGCCCTA
CGCCCTAG	ACGCCCTA
CGCCCTAT	ACGCCCTA
CGTGATCC	CGTGTCCA
CGCCCTAN	ACGCCCTA
CTAATTTA	ACTAATTT
CTAATTTC	ACTAATTT
CGCTCGTT	GCTCGTTC
CTAATTTG	ACTAATTT
CTAATTTT	ACTAATTT
CTAATTTN	ACTAATTT
CGCCCTTC	CCCCTTCA
CGTCCCAA	CGTTCCAA
CGTCCCAG	CTTCCCAG
CGGACATT	AGGACATT
CGGACCCG	GGGACCCG
CGGACGCT	CGACGCTG
CGTGCCAC	CGTGTCCA
CGCCGCTG	CGACGCTG
CGTGCCAG	CGTGTCCA
CGTGCCAT	CGTGTCCA
CGTGCCAN	CGTGTCCA
CGTGCCCA	CGTGTCCA
CGTGCCTT	CTGCCTTT
CGCTGTCC	CGTGTCCA
CGTGCTCC	CGTGTCCA
CGCTTACG	GCTTACGG
CGNTGTCC	CGTGTCCA
CGCTTCCA	CGTTCCAA
CGTAAATA	GCGTAAAT
CGTAAATC	GCGTAAAT
CGTAAATG	GCGTAAAT
CGTAAATT	GCGTAAAT
CGTAAATN	GCGTAAAT
CTACACTA	CTCACTAC
CGCTTGCA	CAGCTTGC
CGCTTGCC	CAGCTTGC
CGCTTGCG	CAGCTTGC
CGCTTGCT	CAGCTTGC
CGCTTGCN	CAGCTTGC
CGCCTTCA	CCCCTTCA
CGCCTTTA	CTGCCTTT
CGCCTTTC	CTGCCTTT
CGCCTTTG	CTGCCTTT
CGCCTTTT	CTGCCTTT
CGCCTTTN	CTGCCTTT
CGCTTTAC	GCTTTACC
CGGAGTTC	CGGGTTCG
CGNTTCCA	CGTTCCAA
CGTCGCTG	CGACGCTG
CGTGGCCA	CGTGTCCA
CGTCGTCC	CGTGTCCA
CTACCCAG	CTTCCCAG
CTACCCGC	TACCCGCA
CTACCCGG	GTACCCGG
CTACCGAA	CAACCGAA
CGTGGTCC	CGTGTCCA
CGTACCAA	CGTTCCAA
CGTGGTTC	CGGGTTCG
CGTACCCG	GTACCCGG
CGTCTAGC	TGTCTAGC
CTACCTTT	CTGCCTTT
CGCGAACA	CCGAACAT
CGTACGCT	CGACGCTG
CGTACGGT	CCTACGGT
CGTGTACA	CGTGTCCA
CGTGTACC	CGTGTCCA
CGTGTCAA	CGTGTCCA
CGTGTCAC	CGTGTCCA
CGTGTCAG	CGTGTCCA
CGTGTCAT	CGTGTCCA
CGTGTCAN	CGTGTCCA
CGTGTCCA	CGTGTCCA
CGTGTCCC	CGTGTCCA
CTACGCGC	CACGCGCT
CGCGATTA	CCGATTAA
CTACGCTG	CGACGCTG
CGTGTCCG	CGTGTCCA
CGTGTCCT	CGTGTCCA
CGTGTCCN	CGTGTCCA
CGNACGCT	CGACGCTG
CTACGGTA	CCTACGGT
CTACGGTC	CCTACGGT
CTACGGTG	CCTACGGT
CTACGGTT	CCTACGGT
CTACGGTN	CCTACGGT
CGTGTCGA	CGTGTCCA
CGTGTCGC	CGTGTCCA
CGTGTCTA	CGTGTCCA
CGTGTCTC	CGTGTCCA
CGTGTCNA	CGTGTCCA
CTACTACA	CTCACTAC
CTACTACC	CTCACTAC
CGTGTCNC	CGTGTCCA
CTACTACG	CTCACTAC
CTACTACT	CTCACTAC
CTACTACN	CTCACTAC
CTACGTGG	CACGTGGG
CGTGTGCA	CGTGTCCA
CGTGTGCC	CGTGTCCA
CGCGCGCT	CACGCGCT
CGTGTTCA	CGTGTCCA
CGTGTTCC	CGTGTCCA
CGTGTTCG	CGGGTTCG
CGTGTTTC	GGTGTTTC
CGCGCTGA	CGACGCTG
CGCGCTGC	CGACGCTG
CGCGCTGG	CGACGCTG
CGCGCTGT	CGACGCTG
CGCGCTGN	CGACGCTG
CGTGTNCA	CGTGTCCA
CGTGTNCC	CGTGTCCA
CGTTTCAA	CGTTCCAA
CGTGNCCA	CGTGTCCA
CGTGNTCC	CGTGTCCA
CTGTAAAA	CTGATAAA
CTGTAAAC	CTGATAAA
CGTTTTTT	CATTTTTT
CTGTAAAG	CTGATAAA
CTGTAAAT	CTGATAAA
CTGTAAAN	CTGATAAA
CTATCCCA	CTTCCCAG
CGTTAACA	GCGTTAAC
CGTTAACC	GCGTTAAC
CGTTAACG	GCGTTAAC
CGTTAACT	GCGTTAAC
CGTTAACN	GCGTTAAC
CGTTACAA	CGTTCCAA
CTATCGGA	CATATCGG
CGTTNCAA	CGTTCCAA
CTATCGGC	CATATCGG
CTATCGGG	CATATCGG
CTATCGGT	CATATCGG
CTAGAACC	GTAGAACC
CTATCGGN	CATATCGG
CGTTACCA	CGTTCCAA
CGTTNCCA	CGTTCCAA
CTAGAAGA	TAGAAGAG
CTATCTCT	ATATCTCT
CTGTATAA	CTGATAAA
CGTTAGCA	GTTAGCAA
CTAGAGGT	TAGAGGTT
CTAGAGTC	CCAGAGTC
CTAGATAA	CTGATAAA
CTATGACG	CATGACGC
CGNGGTTC	CGGGTTCG
CGTTCAAA	CGTTCCAA
CGTTCAAC	CGTTCCAA
CGTTCAAG	CGTTCCAA
CGTTCAAT	CGTTCCAA
CGTTCAAN	CGTTCCAA
CGTTCACA	CGTTCCAA
CTGTCCAA	CGTGTCCA
CTGTCCAC	CGTGTCCA
CTGTCCAG	CGTGTCCA
CTGTCCAT	CGTGTCCA
CTGTCCAN	CGTGTCCA
CTGTCCCA	CTTCCCAG
CGTTCCAA	CGTTCCAA
CTGTCCTT	CTGCCTTT
CGTTCCCT	CATTCCCT
CGTTCCGA	CGTTCCAA
CGTTCCTA	CGTTCCAA
CGNGTCCA	CGTGTCCA
CGTTCCNA	CGTTCCAA
CGTTCGAA	CGTTCCAA
CGTTCGCA	CGTTCCAA
CGTTCGGC	TGTTCGGC
CTAGCCTT	CTGCCTTT
CGTTCTAA	CGTTCCAA
CGTTCTCA	CGTTCCAA
CGNGTTCG	CGGGTTCG
CTGTCTAG	TGTCTAGC
CTAGCTTG	CAGCTTGC
CGTTCNAA	CGTTCCAA
CGTTCNCA	CGTTCCAA
CTGTCTTT	CTGCCTTT
CTATTCCC	CATTCCCT
CGTNCCAA	CGTTCCAA
CGTTGCAA	CGTTCCAA
CGTTGCCA	CGTTCCAA
CTATTTTT	CATTTTTT
CGTTGTAT	GTTGTATT
CGTTGTCC	CGTGTCCA
CTGTGTCC	CGTGTCCA
CTGTTAAA	CTGATAAA
CGTNGTCC	CGTGTCCA
CTGTTCCA	CGTTCCAA
CTGTTCGG	TGTTCGGC
CTGCCACC	TGCCACCG
CTGCCATT	CTGCCTTT
CGNCGCTG	CGACGCTG
CTGCCCAG	CTTCCCAG
CTGTTTAA	TTGTTTAA
CTGCCCTT	CTGCCTTT
CGNTCCAA	CGTTCCAA
CTGCCGTT	CTGCCTTT
CTGCCTAT	CTGCCTTT
CTGCCTCT	CTGCCTTT
CTGCCTGT	CTGCCTTT
CTGCCTTA	CTGCCTTT
CTGCCTTC	CTGCCTTT
CTGCCTTG	CTGCCTTT
CTGCCTTT	CTGCCTTT
CTGCCTTN	CTGCCTTT
CTCAAATG	CCAAATGC
CTGCCTNT	CTGCCTTT
CTGCCNTT	CTGCCTTT
CTCAACTA	CTCACTAC
CTCAACTT	TCAACTTC
CTCAAGAC	TCAAGACG
CTGCGCTT	CTGCCTTT
CTATAAAA	CTGATAAA
CTCAATAC	CTCACTAC
CTATAAAC	CTGATAAA
CTATAAAG	CTGATAAA
CTATAAAT	CTGATAAA
CTATAAAN	CTGATAAA
CTGCGGGT	TGCGGGTT
CTGCGTTT	CTGCCTTT
CTATACGA	GTATACGA
CTGCTAAA	CTGATAAA
CTATATCG	CATATCGG
CTGCTCTT	CTGCCTTT
CTGCTTGC	CAGCTTGC
CTCACAAC	CTCACTAC
CTGCTTTA	CTGCCTTT
CTGCTTTC	CTGCCTTT
CTGCTTTG	CTGCCTTT
CTGCTTTT	CTGCCTTT
CTGCTTTN	CTGCCTTT
CTCACACA	CTCACTAC
CTCACACC	CTCACTAC
CTCACACG	CTCACTAC
CTCACACT	CTCACTAC
CTCACACN	CTCACTAC
CTCACATA	CTCACTAC
CTCACCAC	CTCACTAC
CTCACCTA	CTCACTAC
CTGAAAAA	CTGATAAA
CTGAAAAC	CTGATAAA
CTGAAAAG	CTGATAAA
CTGAAAAT	CTGATAAA
CTGAAAAN	CTGATAAA
CTCACGAC	CTCACTAC
CTCCGGGA	TCCGGGAC
CTGCNCTT	CTGCCTTT
CTCACGTA	CTCACTAC
CTGNATAA	CTGATAAA
CTCACTAA	CTCACTAC
CTCACTAC	CTCACTAC
CTCACTAG	CTCACTAC
CTCACTAT	CTCACTAC
CTCACTAN	CTCACTAC
CTCACTCA	CTCACTAC
CTCACTCC	CTCACTAC
CTCACTCG	CTCACTAC
CTCACTCT	CTCACTAC
CTCACTCN	CTCACTAC
CTCACTGA	CTCACTAC
CTGAACAT	CCGAACAT
CTCACTGC	CTCACTAC
CTCACTTA	CTCACTAC
CTCACTTC	CTCACTAC
CTCTACGG	CCTACGGT
CTCACTNA	CTCACTAC
CTCTACTA	CTCACTAC
CTCACTNC	CTCACTAC
CTCACNAC	CTCACTAC
CTCACNTA	CTCACTAC
CTGCNTTT	CTGCCTTT
CTCTATAC	TTCTATAC
CTCAGAGT	CCAGAGTC
CTGAATAA	CTGATAAA
CTCCTACA	CTCACTAC
CTCCTACC	CTCACTAC
CTCCTACG	CTCACTAC
CTCCTACT	CTCACTAC
CTCCTACN	CTCACTAC
CTCAGATA	TTCAGATA
CTGNCCTT	CTGCCTTT
CTCAGCTA	CTCACTAC
CTCTCCCA	CTTCCCAG
CTGACAAA	CTGATAAA
CTCAGTAC	CTCACTAC
CTCTCTAC	CTCACTAC
CTGNCTTT	CTGCCTTT
CTGNTAAA	CTGATAAA
CTTCACAG	CTTCCCAG
CTTCACCA	CTTCCCAG
CTGACCTT	CTGCCTTT
CTTCACTA	CTCACTAC
CTGACGCA	CATGACGC
CTGACGCC	CATGACGC
CTGACGCG	CATGACGC
CTTCAGAT	TTCAGATA
CTGACGCN	CATGACGC
CTGGATAA	CTGATAAA
CTCTGAGC	ATCTGAGC
CTGACTAA	CTGATAAA
CTGACTAC	CTCACTAC
CTGACTTT	CTGCCTTT
CTCCTGGC	ATCCTGGC
CTTCCAAA	CGTTCCAA
CTTCCAAC	CGTTCCAA
CTTCCAAT	CGTTCCAA
CTTCCAAN	CGTTCCAA
CTCCTTCA	CCCCTTCA
CTTCCACA	CTTCCCAG
CTTCCAGA	CTTCCCAG
CTTCCAGC	CTTCCCAG
CTTCCAGG	CTTCCCAG
CTTCCAGT	CTTCCCAG
CTTCCAGN	CTTCCCAG
CTCCTTTA	CTGCCTTT
CTCCTTTC	CTGCCTTT
CTCATAAA	CTGATAAA
CTCATACA	CTCACTAC
CTCATACC	CTCACTAC
CTCCTTTG	CTGCCTTT
CTCCTTTT	CTGCCTTT
CTCCTTTN	CTGCCTTT
CTGAGAAA	CTGATAAA
CTGAGAAC	TTGAGAAC
CTCATACG	CTCACTAC
CTCATACT	CTCACTAC
CTCATACN	CTCACTAC
CTTCCCAA	CTTCCCAG
CTTCCCAC	CTTCCCAG
CTTCCCAG	CTTCCCAG
CTTCCCAT	CTTCCCAG
CTTCCCAN	CTTCCCAG
CTTCCCCA	CTTCCCAG
CTTCCCCG	CTTCCCAG
CTTCCCGA	CTTCCCAG
CTGGCCTT	CTGCCTTT
CTTCCCGC	CTTCCCAG
CTTCCCGG	CTTCCCAG
CTTCCCGT	CTTCCCAG
CTTCCCGN	CTTCCCAG
CTTCCCTC	CATTCCCT
CTTCCCTT	CATTCCCT
CTTCCCTN	CATTCCCT
CTTCCCNA	CTTCCCAG
CTGGCGAC	TGGCGACT
CTTCCCNG	CTTCCCAG
CTGGCGTA	TTGGCGTA
CTTCCGAG	CTTCCCAG
CTTCCGCA	CTTCCCAG
CTCATCTA	CTCACTAC
CTTCCTAG	CTTCCCAG
CTTCCTCA	CTTCCCAG
CTGGCTTT	CTGCCTTT
CTTCCTTT	CTGCCTTT
CTTCCNAG	CTTCCCAG
CTTCCNCA	CTTCCCAG
CTCATTAC	CTCACTAC
CTGAGTAA	CTGATAAA
CTTCGATG	TTCGATGG
CTTCGCAG	CTTCCCAG
CTTCGCCA	CTTCCCAG
CTCTTTGT	TCTTTGTA
CTCANCTA	CTCACTAC
CTGGGTTC	CGGGTTCG
CTGATAAA	CTGATAAA
CTGATAAC	CTGATAAA
CTGATAAG	CTGATAAA
CTGATAAT	CTGATAAA
CTGATAAN	CTGATAAA
CTCANTAC	CTCACTAC
CTGATACA	CTGATAAA
CTGATAGA	CTGATAAA
CTGATATA	CTGATAAA
CTGATANA	CTGATAAA
CTGGTAAA	CTGATAAA
CTGATCAA	CTGATAAA
CTCGAACA	CCGAACAT
CTGATGAA	CTGATAAA
CTTCTATA	TTCTATAC
CTTCTCAG	CTTCCCAG
CTTCTCCA	CTTCCCAG
CTGGTCCG	ATGGTCCG
CTCGACTA	CTCACTAC
CTTACCAG	CTTCCCAG
CTTACCCA	CTTCCCAG
CTGGTTCG	CGGGTTCG
CTCCACTA	CTCACTAC
CTTACGGA	GCTTACGG
CTTCNCAG	CTTCCCAG
CTTACGGC	GCTTACGG
CTTACGGG	GCTTACGG
CTTCNCCA	CTTCCCAG
CTTACGGN	GCTTACGG
CTCGATAA	CTGATAAA
CTTACTAC	CTCACTAC
CTCGATGG	TTCGATGG
CTCGATTA	CCGATTAA
CTGATNAA	CTGATAAA
CNACCGAA	CAACCGAA
CTTAGACA	TTTAGACA
CTGANAAA	CTGATAAA
CTCCCAGA	CTTCCCAG
CTCCCAGC	CTTCCCAG
CTCCCAGG	CTTCCCAG
CTCCCAGT	CTTCCCAG
CTCCCAGN	CTTCCCAG
CTCNACTA	CTCACTAC
CTTAGCAA	GTTAGCAA
CTTGACGC	CATGACGC
CTTGAGAA	TTGAGAAC
CTCGCCTT	CTGCCTTT
CTTGATAA	CTGATAAA
CTCGCGCT	CACGCGCT
CTCCCCAG	CTTCCCAG
CTCGCTAC	CTCACTAC
CNACGCGC	CACGCGCT
CNACGCTG	CGACGCTG
CTTATAAA	CTGATAAA
CTTGCCAG	CTTCCCAG
CTTGCCCA	CTTCCCAG
CTTGCCTT	CTGCCTTT
CNACGTGG	CACGTGGG
CTGANTAA	CTGATAAA
CTTGCGTC	TTTGCGTC
CTCGGGGG	TCGGGGGA
CTTGCTGA	TTTGCTGA
CTTATCGG	CATATCGG
CTCCCTAC	CTCACTAC
CTCCCTCT	ATCCCTCT
CTCCCTTC	CCCCTTCA
CTCCCTTT	CTGCCTTT
CTCNCTAC	CTCACTAC
CTTGGCGT	TTGGCGTA
CTCGTGGG	CACGTGGG
CTCGTTCA	GCTCGTTC
CTCGTTCC	GCTCGTTC
CTCGTTCG	GCTCGTTC
CTCGTTCT	GCTCGTTC
CTCGTTCN	GCTCGTTC
CTGCACTA	CTCACTAC
CTGCACTT	CTGCCTTT
CTTGTATT	GTTGTATT
CTGCATAA	CTGATAAA
CTTGTCCA	CGTGTCCA
CTGCATGG	ATGCATGG
CTGCATTT	CTGCCTTT
CTTNCCAG	CTTCCCAG
CTTNCCCA	CTTCCCAG
CTTGTTTA	TTGTTTAA
CNAGCTTG	CAGCTTGC
CNAAATGC	CCAAATGC
CNAGAGTC	CCAGAGTC
CNAACCGA	CAACCGAA
CTTTACCA	GCTTTACC
CTTTACCC	GCTTTACC
CTTTACCG	GCTTTACC
CTTTACCT	GCTTTACC
CTTTACCN	GCTTTACC
CTNCACTA	CTCACTAC
CTTTAGAC	TTTAGACA
CTTTAGCC	TTTTAGCC
CTNCCCAG	CTTCCCAG
CNGTGTCC	CGTGTCCA
CTTTCCAA	CGTTCCAA
CTTTCCAG	CTTCCCAG
CTTTCCCA	CTTCCCAG
CTTTCCCT	CATTCCCT
CTNCCTTT	CTGCCTTT
CTNACTAC	CTCACTAC
CTTTGCGT	TTTGCGTC
CTTTGCTG	TTTGCTGA
CTTTGTAA	TCTTTGTA
CTTTGTAC	TCTTTGTA
CTTTGTAG	TCTTTGTA
CTTTGTAT	TCTTTGTA
CTTTGTAN	TCTTTGTA
CNGTTCCA	CGTTCCAA
CTTTTAGC	TTTTAGCC
CTNATAAA	CTGATAAA
CTTTTTTA	CATTTTTT
CTTTTTTC	CATTTTTT
CTTTTTTG	CATTTTTT
CTTTTTTN	CATTTTTT
CNATATCG	CATATCGG
CTNTCCCA	CTTCCCAG
CNCGAACA	CCGAACAT
CNCGATTA	CCGATTAA
CNCAAATG	CCAAATGC
CNCAGAGT	CCAGAGTC
CNCGCGCT	CACGCGCT
CTNGATAA	CTGATAAA
CNATGACG	CATGACGC
CTNGCCTT	CTGCCTTT
CNGGGTTC	CGGGTTCG
CNCGTGGG	CACGTGGG
CNCACTAC	CTCACTAC
CNATTCCC	CATTCCCT
CNGGTTCG	CGGGTTCG
CNGACGCT	CGACGCTG
CNATTTTT	CATTTTTT
GAACCCGG	GTACCCGG
GAACCGAA	CAACCGAA
CNGATAAA	CTGATAAA
CNCTACGG	CCTACGGT
GAACGCAT	AACGCATG
CNGATTAA	CCGATTAA
GAACGTAC	GAAAGTAC
CNTGACGC	CATGACGC
CNCCCTTC	CCCCTTCA
GAACTAGG	GAAATAGG
GAACTCAG	TAACTCAG
CNTACGGT	CCTACGGT
GAACTGGG	AACTGGGA
CNTGATAA	CTGATAAA
GAACTTTC	GAATTTTC
GAACTTTT	GAATTTTC
CNTGCCTT	CTGCCTTT
GAAGAAAG	GAAAAAGC
GAAGAACC	GTAGAACC
GAAGAAGC	GAAAAAGC
GAAGAATA	AAGAATAA
CNCCTTCA	CCCCTTCA
GAAGAGTA	GAAAGTAC
GAAAAAAC	GAAAAAGC
GAAAAAAG	GAAAAAGC
GAAGATAG	GAAATAGG
GAAAAACA	GAAAAAGC
GAAAAACC	GAAAAAGC
GAAAAACG	GAAAAAGC
GAAAAACT	GAAAAAGC
GAAAAACN	GAAAAAGC
GAAAAAGC	GAAAAAGC
GAAAAAGT	GAAAAAGC
GAAAAAGN	GAAAAAGC
GAAAAATC	GAAAAAGC
GAAAAATG	GAAAAAGC
GAAAAANC	GAAAAAGC
GAAAAANG	GAAAAAGC
GAAAACAG	GAAAAAGC
GAAAACGC	GAAAAAGC
GAAAAGAA	GGAAAAGA
GAAAAGAC	GGAAAAGA
GAAAAGAT	GGAAAAGA
GAAAAGAN	GGAAAAGA
GAAAAGCA	GAAAAAGC
GAAAAGCC	GAAAAAGC
GAAAAGCG	GAAAAAGC
GAAAAGCT	GAAAAAGC
GAAAAGCN	GAAAAAGC
GAAAAGGA	GAAATAGG
GAAAAGGG	GAAATAGG
GAAAAGGT	GAAATAGG
GAAAAGGN	GAAATAGG
GAAAAGTA	GAAAGTAC
CNGCCTTT	CTGCCTTT
GAAAATAC	GAAAGTAC
GAAAATGC	GAAAAAGC
CNTATCGG	CATATCGG
GAAAANAG	GAAAAAGC
GAAAANGC	GAAAAAGC
CNTGTCCA	CGTGTCCA
CNTTCCAA	CGTTCCAA
GAAGGAGT	AAGGAGTG
CNTTCCCA	CTTCCCAG
CNTTCCCT	CATTCCCT
GAAACAAG	GAAAAAGC
GAAACAGC	GAAAAAGC
GAAACAGG	GAAATAGG
GAAGGGGA	AAGGGGAC
GAAGGTAC	GAAAGTAC
GAAGTACA	GAAAGTAC
GAAGTACC	GAAAGTAC
GAAGTACG	GAAAGTAC
GAAGTACT	GAAAGTAC
GAAGTACN	GAAAGTAC
GAAGTAGG	GAAATAGG
GAAACGTA	GAAAGTAC
GAAACTAC	GAAAGTAC
GAAACTAG	GAAATAGG
GAAGTGCT	AAGTGCTG
CNGCTTGC	CAGCTTGC
GAAGTGGT	AAGTGGTG
GAAGTTAA	GACAGTTA
GAAGTTAC	GACAGTTA
GAAGTTAG	GACAGTTA
GAAGTTAT	GACAGTTA
GAAGTTAN	GACAGTTA
GAAGTTTC	GAATTTTC
GAAGTTTT	GAATTTTC
GAAAGAAC	GAAAGTAC
GAAAGAAG	GAAAAAGC
GAAAGACA	GAAAGTAC
GAAAGACC	GAAAGTAC
GAAAGACG	GAAAGTAC
GAAAGACT	GAAAGTAC
GAAAGACN	GAAAGTAC
GAAAGAGC	GAAAAAGC
GAAAGAGG	GAAATAGG
GAAAGATA	GAAAGTAC
CNTCACTA	CTCACTAC
GAAAGCAC	GAAAGTAC
CNGAACAT	CCGAACAT
GAAAGCTA	GAAAGTAC
CNTTTTTT	CATTTTTT
GAANGTAC	GAAAGTAC
GAAAGGAC	GAAAGTAC
GAAAGGTA	GAAAGTAC
GAAAGTAA	GAAAGTAC
GAAAGTAC	GAAAGTAC
GAAAGTAT	GAAAGTAC
GAAAGTAN	GAAAGTAC
GAAAGTCA	GAAAGTAC
GAAAGTCC	GAAAGTAC
GAANTAGG	GAAATAGG
GAAAGTCG	GAAAGTAC
GAAAGTCT	GAAAGTAC
GAAAGTCN	GAAAGTAC
GAAAGTGA	GAAAGTAC
GAAAGTGC	GAAAGTAC
GAAAGTTC	GAAAGTAC
GAAAGTNA	GAAAGTAC
GAAAGTNC	GAAAGTAC
GAAAGNAC	GAAAGTAC
CNTCCCAG	CTTCCCAG
GAAAGNTA	GAAAGTAC
GAAATACA	GAAAGTAC
GAAATACC	GAAAGTAC
GAANTTTC	GAATTTTC
GAANTTTT	GAATTTTC
GAAATACT	GAAAGTAC
GAAATACN	GAAAGTAC
GAAATAGA	GAAATAGG
GAAATAGG	GAAATAGG
GAAATAGT	GAAATAGG
GAAATAGN	GAAATAGG
GAAATATG	GAAATAGG
GAAATANG	GAAATAGG
GAAATCAG	GAAATAGG
GAAATCAT	GATATCAT
GAAATCGC	AAATCGCT
GAAATCGG	GAAATAGG
GAAATGAG	GAAATAGG
GAAATGGA	GAAATAGG
GAAATGGC	GAAATAGG
GAAATGGG	GAAATAGG
GAAATGGT	GAAATAGG
GAAATGGN	GAAATAGG
GAAATGTA	GAAAGTAC
GAAATTAC	GAAAGTAC
GAAATTAG	GAAATAGG
GAAATTGG	GAAATAGG
GAAATTTC	GAATTTTC
GAAATTTT	GAATTTTC
GAAATNAG	GAAATAGG
GAAATNGG	GAAATAGG
GAAANAAG	GAAAAAGC
GACAAAAG	GAAAAAGC
GACAAAAT	GGCAAAAT
GACAAAGC	GAAAAAGC
GAAANAGC	GAAAAAGC
GAAANAGG	GAAATAGG
GACAAGTA	GAAAGTAC
GACAAGTT	GACAGTTA
GACAATAG	GAAATAGG
GAAANGTA	GAAAGTAC
GACAATTA	GACAGTTA
GACACAAG	ACACAAGT
GAAANTAC	GAAAGTAC
GAAANTAG	GAAATAGG
GACACGTT	GACAGTTA
GACACTTA	GACAGTTA
GACAGATA	GACAGTTA
GACAGATT	GACAGTTA
GACAGCTA	GACAGTTA
GACAGCTT	GACAGTTA
GAACAAAG	GAAAAAGC
GAACAAGC	GAAAAAGC
GACAGGTA	GACAGTTA
GACAGGTT	GACAGTTA
GACAGTAA	GACAGTTA
GACAGTAG	GACAGTTA
GACAGTAT	GACAGTTA
GACAGTAN	GACAGTTA
GACAGTCA	GACAGTTA
GAATAAAG	GAAAAAGC
GAATAAGC	GAAAAAGC
GACAGTCT	GACAGTTA
GACAGTGA	GACAGTTA
GAACAGTA	GAAAGTAC
GACAGTGT	GACAGTTA
GACAGTTA	GACAGTTA
GACAGTTC	GACAGTTA
GACAGTTG	GACAGTTA
GACAGTTT	GACAGTTA
GACAGTTN	GACAGTTA
GACAGTNA	GACAGTTA
GACAGTNT	GACAGTTA
GAATACGA	GTATACGA
GATAAAAG	GAAAAAGC
GATAAAGC	GAAAAAGC
GATAAAGT	ATAAAGTC
GACAGNTA	GACAGTTA
GAACAGTT	GACAGTTA
GATAACAT	GATATCAT
GACAGNTT	GACAGTTA
GAACATAG	GAAATAGG
GACATAGG	GAAATAGG
GAATAGGA	GAAATAGG
GAATAGGC	GAAATAGG
GAATAGGG	GAAATAGG
GAATAGGT	GAAATAGG
GAATAGGN	GAAATAGG
GAATAGTA	GAAAGTAC
GATAAGTA	GAAAGTAC
GAATATAG	GAAATAGG
GACATCAT	GATATCAT
GAATATCA	GATATCAT
GATAATAG	GAAATAGG
GATAATCA	GATATCAT
GAATATTC	GAATTTTC
GAATATTT	GAATTTTC
GACATCCT	ACATCCTT
GACGTAAA	GCGTAAAT
GACCAGTC	GCCCAGTC
GAATCACC	AATCACCC
GACCAGTT	GACAGTTA
GATACATA	GATATCAT
GATACATC	GATATCAT
GATACATG	GATATCAT
GATACATT	GATATCAT
GATACATN	GATATCAT
GAATCATA	GATATCAT
GAATCATC	GATATCAT
GAATCATG	GATATCAT
GAATCATT	GATATCAT
GAATCATN	GATATCAT
GACGTATT	ACGTATTA
GATACCAT	GATATCAT
GATACCCG	GTACCCGG
GACATGTT	GACAGTTA
GAGGGGAC	AAGGGGAC
GATACGAA	GTATACGA
GACATTAA	GACAGTTA
GATACGAC	GTATACGA
GACATTAC	GACAGTTA
GATACGAG	GTATACGA
GACATTAG	GACAGTTA
GATACGAT	GTATACGA
GACATTAT	GACAGTTA
GATACGAN	GTATACGA
GACATTAN	GACAGTTA
GACGTGGG	CACGTGGG
GACATTTA	GACAGTTA
GAATCGAT	TAATCGAT
GACATTTT	GAATTTTC
GACGTTAC	GACAGTTA
GACGTTAG	GACAGTTA
GACGTTAT	GACAGTTA
GACGTTAN	GACAGTTA
GATACTCA	GATATCAT
GAATCGCT	AAATCGCT
GACCCAGT	GCCCAGTC
GATAGAAC	GTAGAACC
GAATCTTC	GAATTTTC
GAATCTTT	GAATTTTC
GATAGCAA	GTTAGCAA
GATAGCAT	GATATCAT
GACANGTT	GACAGTTA
GACANTTA	GACAGTTA
GATAGTAC	GAAAGTAC
GACCCGCA	TACCCGCA
GATAGTCA	GATATCAT
GACCCGGA	GTACCCGG
GACCCGGC	GTACCCGG
GACCCGGG	GTACCCGG
GACCCGGT	GTACCCGG
GACCCGGN	GTACCCGG
GATAGTTA	GACAGTTA
GATGCATG	ATGCATGG
GAATGAAC	GGATGAAC
GACTAATT	ACTAATTT
GAGCAAAA	GGCAAAAT
GACTAGTT	GACAGTTA
GACTATCA	GATATCAT
GAGCAGTT	GACAGTTA
GAATGTAC	GAAAGTAC
GACCGGTT	ACCGGTTG
GAATGTTC	GAATTTTC
GACCGTTA	GACAGTTA
GAATGTTT	GAATTTTC
GAGTAAAT	GCGTAAAT
GCAGAACC	GTAGAACC
GACTCGTT	GCTCGTTC
GATGGTCC	ATGGTCCG
GAGTATCA	GATATCAT
GAATTAGG	GAAATAGG
GAATTATC	GAATTTTC
GAATTATT	GAATTTTC
GAATTCTC	GAATTTTC
GAATTCTT	GAATTTTC
GAATTGTC	GAATTTTC
GAATTGTT	GAATTTTC
GCAGAGTC	CCAGAGTC
GATGTATT	GTTGTATT
GAATTTAC	GAATTTTC
GAATTTAT	GAATTTTC
GATGTCAT	GATATCAT
GAATTTCA	GAATTTTC
GAATTTCC	GAATTTTC
GAATTTCG	GAATTTTC
GAATTTCT	GAATTTTC
GAATTTCN	GAATTTTC
GAATTTGC	GAATTTTC
GAATTTGT	GAATTTTC
GACTGGGA	AACTGGGA
GAATTTTA	GAATTTTC
GAATTTTC	GAATTTTC
GAATTTTG	GAATTTTC
GAATTTTT	GAATTTTC
GAATTTTN	GAATTTTC
GAATTTNC	GAATTTTC
GAATTTNT	GAATTTTC
GACTGTTA	GACAGTTA
GATGTTTC	GGTGTTTC
GAATTNTC	GAATTTTC
GAATTNTT	GAATTTTC
GAGTGCTG	AAGTGCTG
GACTTACG	GCTTACGG
GAGTGGTG	AAGTGGTG
GAGTGTTT	GGTGTTTC
GACGAAAC	ACGAAACT
GAGTTAAC	GCGTTAAC
GAATNTTC	GAATTTTC
GAATNTTT	GAATTTTC
GCAGCTTG	CAGCTTGC
GACGAGTT	GACAGTTA
GAANAAAG	GAAAAAGC
GAANAAGC	GAAAAAGC
GACTTTAC	GCTTTACC
GAGTTTTC	GAATTTTC
GACTTTTC	GAATTTTC
GACGCAGC	ACGCAGCC
GACGCATG	AACGCATG
GACGCCCT	ACGCCCTA
GAANAGTA	GAAAGTAC
GACGCGCT	CACGCGCT
GAANATAG	GAAATAGG
GAGCTTGC	CAGCTTGC
GATTACGG	GCTTACGG
GATTAGCA	GTTAGCAA
GACNGTTA	GACAGTTA
GATTATCA	GATATCAT
GACGCTGA	CGACGCTG
GACGCTGC	CGACGCTG
GACGCTGG	CGACGCTG
GACGCTGT	CGACGCTG
GACGCTGN	CGACGCTG
GCAGTAAA	GCGTAAAT
GATTCATA	GATATCAT
GATTCATC	GATATCAT
GCAACCGA	CAACCGAA
GATTCATG	GATATCAT
GATTCATT	GATATCAT
GATTCATN	GATATCAT
GATTCCCT	CATTCCCT
GCAGTTAC	GACAGTTA
GCAACTTC	TCAACTTC
GCAGTTAG	GACAGTTA
GCAGTTAT	GACAGTTA
GCAGTTAN	GACAGTTA
GACGGCCA	ACGGCCAG
GATATAAT	GATATCAT
GATATACA	GATATCAT
GATATACG	GTATACGA
GATATAGG	GAAATAGG
GATATATA	GATATCAT
GATATATC	GATATCAT
GATATATG	GATATCAT
GATATATT	GATATCAT
GATATATN	GATATCAT
GATATCAA	GATATCAT
GATATCAC	GATATCAT
GATATCAG	GATATCAT
GATATCAT	GATATCAT
GATATCAN	GATATCAT
GCAAGACG	TCAAGACG
GATATCCA	GATATCAT
GATATCCT	GATATCAT
GATATCGA	GATATCAT
GATATCGG	CATATCGG
GATATCGT	GATATCAT
GATATCTA	GATATCAT
GATATCTG	GATATCAT
GATATCTT	GATATCAT
GATATCTN	GATATCAT
GATATCNA	GATATCAT
GATATCNT	GATATCAT
GATATGAT	GATATCAT
GATATGCA	GATATCAT
GCAAGTAC	GAAAGTAC
GACGGTTA	GACAGTTA
GATATTAT	GATATCAT
GAGGACAT	AGGACATT
GAGGACCC	GGGACCCG
GATATTCA	GATATCAT
GACNAGTT	GACAGTTA
GATATTTT	GAATTTTC
GCAATAGG	GAAATAGG
GATATNAT	GATATCAT
GATTGTAT	GTTGTATT
GATATNCA	GATATCAT
GAGGAGTG	AAGGAGTG
GAGAAAGC	GAAAAAGC
GAGAACCA	GTAGAACC
GAGAACCC	GTAGAACC
GAGAACCG	GTAGAACC
GATTTACC	GCTTTACC
GAGAACCT	GTAGAACC
GAGAACCN	GTAGAACC
GAGAAGAG	TAGAAGAG
GATTTCAT	GATATCAT
GCAATTTT	GAATTTTC
GATANCAT	GATATCAT
GAGAAGTA	GAAAGTAC
GAGAATAA	AAGAATAA
GAGAATAG	GAAATAGG
GAGGCCGC	AGGCCGCC
GCATAAAT	GCGTAAAT
GATTTTCA	GAATTTTC
GATTTTCC	GAATTTTC
GATTTTCG	GAATTTTC
GATTTTCT	GAATTTTC
GATTTTCN	GAATTTTC
GATANTCA	GATATCAT
GATTTTTC	GAATTTTC
GATTTTTT	CATTTTTT
GCATACGA	GTATACGA
GCATACGG	GCTTACGG
GAGACCCG	GGGACCCG
GCCAAAAT	GGCAAAAT
GCATATCA	GATATCAT
GCATATCG	CATATCGG
GCCAAATG	CCAAATGC
GANAGTAC	GAAAGTAC
GANAGTTA	GACAGTTA
GCACAAGT	ACACAAGT
GCCAAGTC	GCCCAGTC
GATCACCC	AATCACCC
GATNATCA	GATATCAT
GCATCCTT	ACATCCTT
GCACAGTC	GCCCAGTC
GCACAGTT	GACAGTTA
GCATCGTT	GCTCGTTC
GATCAGTT	GACAGTTA
GAGAGGTT	TAGAGGTT
GAGAGTAC	GAAAGTAC
GCCACAGT	GCCCAGTC
GANTTTTC	GAATTTTC
GAGAGTTA	GACAGTTA
GCGNTAAA	GCGTAAAT
GCGNTAAC	GCGTTAAC
GATCATCA	GATATCAT
GCCACCGA	TGCCACCG
GANATAGG	GAAATAGG
GCCACCGC	TGCCACCG
GCCACCGG	TGCCACCG
GCCACCGT	TGCCACCG
GCCACCGN	TGCCACCG
GAGATAGG	GAAATAGG
GCACCAGT	GCCCAGTC
GANATCAT	GATATCAT
GAGATCAT	GATATCAT
GAGATGAA	GGATGAAC
GCGNTTAA	GCGTTAAC
GCACCCGG	GTACCCGG
GAGATTTT	GAATTTTC
GATCCCTC	ATCCCTCT
GANATTTT	GAATTTTC
GCCAGAGT	CCAGAGTC
GATCCTGG	ATCCTGGC
GCACGCGC	CACGCGCT
GCCAGTCA	GCCCAGTC
GCCAGTCC	GCCCAGTC
GCCAGTCG	GCCCAGTC
GCCAGTCT	GCCCAGTC
GCCAGTCN	GCCCAGTC
GCCAGTTA	GACAGTTA
GATNTCAT	GATATCAT
GATCGTTC	GCTCGTTC
GCTAAATA	GCGTAAAT
GCTAAATC	GCGTAAAT
GCTAAATG	GCGTAAAT
GCTAAATT	GCGTAAAT
GCACGTGG	CACGTGGG
GCACGTTC	GCTCGTTC
GCTAAATN	GCGTAAAT
GCTAACGG	GCTTACGG
GATCTCAT	GATATCAT
GATCTGAG	ATCTGAGC
GCTAATTT	ACTAATTT
GCTACCCG	GTACCCGG
GANCAGTT	GACAGTTA
GCGTAAAA	GCGTAAAT
GCGTAAAG	GCGTAAAT
GCGTAAAT	GCGTAAAT
GCGTAAAN	GCGTAAAT
GCGTAACC	GCGTTAAC
GCGTAACG	GCGTTAAC
GCGTAACN	GCGTTAAC
GCGTAAGA	GCGTAAAT
GCGTAAGT	GCGTAAAT
GCGTAATA	GCGTAAAT
GCGTAATC	GCGTAAAT
GCGTAATG	GCGTAAAT
GCGTAATT	GCGTAAAT
GCGTAATN	GCGTAAAT
GCGTAANA	GCGTAAAT
GCGTAANT	GCGTAAAT
GCGTACAA	GCGTAAAT
GCGTACAT	GCGTAAAT
GANAAAAG	GAAAAAGC
GCGTACGG	GCTTACGG
GCTACGGA	GCTTACGG
GCTACGGC	GCTTACGG
GCTACGGG	GCTTACGG
GCTACGGN	GCTTACGG
GANAAAGC	GAAAAAGC
GCTACGTT	GCTCGTTC
GCGTAGAA	GCGTAAAT
GCGTAGAT	GCGTAAAT
GCCCAAGT	GCCCAGTC
GCCCAATC	GCCCAGTC
GCGTATAT	GCGTAAAT
GCGTATTA	ACGTATTA
GCGTANAA	GCGTAAAT
GCGTANAT	GCGTAAAT
GCTAGAAC	GTAGAACC
GCCCACGT	GCCCAGTC
GCCCACTC	GCCCAGTC
GANAAGTA	GAAAGTAC
GCCCAGAC	GCCCAGTC
GCCCAGAT	GCCCAGTC
GCCCAGCA	GCCCAGTC
GCCCAGCC	GCCCAGTC
GANAATAG	GAAATAGG
GCCCAGCG	GCCCAGTC
GCTAGCAA	GTTAGCAA
GCCCAGCT	GCCCAGTC
GCGTCAAA	GCGTAAAT
GCGTCAAC	GCGTTAAC
GCCCAGCN	GCCCAGTC
GCGTCAAT	GCGTAAAT
GCCCAGGC	GCCCAGTC
GCCCAGGT	GCCCAGTC
GCCCAGTA	GCCCAGTC
GCCCAGTC	GCCCAGTC
GCCCAGTG	GCCCAGTC
GCCCAGTT	GCCCAGTC
GCCCAGTN	GCCCAGTC
GCCCAGNC	GCCCAGTC
GCCCAGNT	GCCCAGTC
GCCCATCA	GCCCAGTC
GCCCATCC	GCCCAGTC
GCCCATCG	GCCCAGTC
GCCCATCT	GCCCAGTC
GCCCATCN	GCCCAGTC
GCCCATGT	GCCCAGTC
GCCCATTC	GCCCAGTC
GCCCANGT	GCCCAGTC
GCCCANTC	GCCCAGTC
GATGAACA	GGATGAAC
GATGAACC	GGATGAAC
GATGAACG	GGATGAAC
GCTAGTTC	GCTCGTTC
GATGAACT	GGATGAAC
GATGAACN	GGATGAAC
GCGTCGTT	GCTCGTTC
GCCCCAGT	GCCCAGTC
GCGTCTAA	GCGTTAAC
GCTATACC	GCTTTACC
GATGACGC	CATGACGC
GCTATCAT	GATATCAT
GCGTGAAA	GCGTAAAT
GCGTGAAC	GCGTTAAC
GCGTGAAT	GCGTAAAT
GATGATCA	GATATCAT
GANTATCA	GATATCAT
GCGTGTAA	GCGTTAAC
GCCCCGTC	GCCCAGTC
GCGTGTCC	CGTGTCCA
GCATGAAC	GGATGAAC
GCGTGTTT	GGTGTTTC
GCATGACG	CATGACGC
GCCCCTTC	CCCCTTCA
GCGTTAAC	GCGTTAAC
GCGTTAAG	GCGTTAAC
GCGTTAAN	GCGTTAAC
GCGTTACA	GCGTTAAC
GCGTTACT	GCGTTAAC
GCGTTACN	GCGTTAAC
GCGTTAGA	GCGTTAAC
GCTATTAC	GCTTTACC
GCGTTAGC	GCGTTAAC
GCGTTATA	GCGTTAAC
GCGTTATC	GCGTTAAC
GCGTTANA	GCGTTAAC
GCGTTANC	GCGTTAAC
GCGTTCAA	GCGTTAAC
GCGTTCAC	GCGTTAAC
GCGTTCCA	CGTTCCAA
GCCCTAGT	GCCCAGTC
GCGTTGAA	GCGTTAAC
GCGTTGAC	GCGTTAAC
GCCCGAGT	GCCCAGTC
GCGTTTAA	GCGTTAAC
GCGTTNAA	GCGTTAAC
GCGTTNAC	GCGTTAAC
GCGTNAAA	GCGTAAAT
GCGTNAAC	GCGTTAAC
GCGTNAAT	GCGTAAAT
GCCCTGTC	GCCCAGTC
GCCCTTCA	CCCCTTCA
GCCCGGTC	GCCCAGTC
GCATTAAC	GCGTTAAC
GCATTACC	GCTTTACC
GCATTACG	GCTTACGG
GCCCGTCA	GCCCAGTC
GCCCGTCC	GCCCAGTC
GCCCGTCG	GCCCAGTC
GCCCGTCT	GCCCAGTC
GCCCGTCN	GCCCAGTC
GCGTNTAA	GCGTTAAC
GCCCGTTC	GCTCGTTC
GCATTCCC	CATTCCCT
GCCCNAGT	GCCCAGTC
GCGNAAAT	GCGTAAAT
GCATTTAC	GCTTTACC
GCATTTTC	GAATTTTC
GCATTTTT	CATTTTTT
GCCCNGTC	GCCCAGTC
GCAAAAAG	GAAAAAGC
GCTCACGG	GCTTACGG
GCTCACTA	CTCACTAC
GCAAAAGA	GGAAAAGA
GCAAAAGC	GAAAAAGC
GCAAAATA	GGCAAAAT
GCAAAATC	GGCAAAAT
GCAAAATG	GGCAAAAT
GCAAAATT	GGCAAAAT
GCAAAATN	GGCAAAAT
GCCTCAGT	GCCCAGTC
GCTCAGTC	GCCCAGTC
GCTCAGTT	GCTCGTTC
GCTTAAAT	GCGTAAAT
GCTTAACA	GCGTTAAC
GCTTAACT	GCGTTAAC
GCAAAGTA	GAAAGTAC
GCAAATAG	GAAATAGG
GCTCATTC	GCTCGTTC
GCAAATGC	CCAAATGC
GCCTCGTT	GCTCGTTC
GCTTAACN	GCGTTAAC
GCTTAAGG	GCTTACGG
GGAGGAAC	GGATGAAC
GCTTACAG	GCTTACGG
GCTTACCA	GCTTTACC
GCTTACCC	GCTTTACC
GCCGAACA	CCGAACAT
GCTTACCT	GCTTTACC
GCTTACCN	GCTTTACC
GCGAAAAG	GGAAAAGA
GCTTACGA	GCTTACGG
GCGAAAAT	GCGTAAAT
GCTTACGC	GCTTACGG
GCTTACGG	GCTTACGG
GCTTACGT	GCTTACGG
GCTTACGN	GCTTACGG
GCGAAACT	ACGAAACT
GCTTACTG	GCTTACGG
GCGAAATA	GCGTAAAT
GCGAAATC	GCGTAAAT
GCGAAATG	GCGTAAAT
GCGAAATT	GCGTAAAT
GCGAAATN	GCGTAAAT
GCGAACAT	CCGAACAT
GCTTACNG	GCTTACGG
GCTTAGCA	GTTAGCAA
GCTTAGCG	GCTTACGG
GCTTAGGA	GCTTACGG
GCTTAGGC	GCTTACGG
GCTTAGGG	GCTTACGG
GCTTAGGT	GCTTACGG
GCTTAGGN	GCTTACGG
GCTTATAC	GCTTTACC
GCTTATCG	GCTTACGG
GCTTATGG	GCTTACGG
GCTTANCG	GCTTACGG
GCTTANGG	GCTTACGG
GCGCGTTC	GCTCGTTC
GCTTCACC	GCTTTACC
GCTTCACG	GCTTACGG
GCCGAGTC	GCCCAGTC
GCCTTAAC	GCGTTAAC
GCCTTACC	GCTTTACC
GCCTTACG	GCTTACGG
GCGACCCG	GGGACCCG
GCGCTAAA	GCGTAAAT
GCGCTAAC	GCGTTAAC
GCCGATTA	CCGATTAA
GCGACGCT	CGACGCTG
GGAANAAG	GGAAAAGA
GGAANAGA	GGAAAAGA
GCCGCAGT	GCCCAGTC
GCTTCCCA	CTTCCCAG
GCTTCCGG	GCTTACGG
GCCTTTAC	GCTTTACC
GGAGTGAA	GGATGAAC
GCTTCGGA	GCTTACGG
GCTTCGGC	GCTTACGG
GCTTCGGG	GCTTACGG
GCTTCGGT	GCTTACGG
GCTTCGGN	GCTTACGG
GCTTCGTT	GCTCGTTC
GCGCTTAA	GCGTTAAC
GCTTCTAC	GCTTTACC
GGAGTTTC	GGTGTTTC
GGACAAAA	GGCAAAAT
GGACAAAG	GGAAAAGA
GCCGGGAC	TCCGGGAC
GGACAAGA	GGAAAAGA
GCGATAAA	GCGTAAAT
GCGATAAC	GCGTTAAC
GCTTGACC	GCTTTACC
GCTTGACG	GCTTACGG
GCTTGCGG	GCTTACGG
GCCGGTTG	ACCGGTTG
GCGATGAA	GGATGAAC
GCTTGTAC	GCTTTACC
GCTTGTAT	GTTGTATT
GGACAGTT	GACAGTTA
GCTTGTTC	GCTCGTTC
GGACATTA	AGGACATT
GGACATTC	AGGACATT
GGACATTG	AGGACATT
GGACATTT	AGGACATT
GCCGTAAA	GCGTAAAT
GGACATTN	AGGACATT
GCTTTACA	GCTTTACC
GCTTTACC	GCTTTACC
GCTTTACT	GCTTTACC
GCTTTACN	GCTTTACC
GCTTTAGC	GCTTTACC
GCTTTATC	GCTTTACC
GCCNAGTC	GCCCAGTC
GCTTTANC	GCTTTACC
GCTTTCAC	GCTTTACC
GCTTTCCA	GCTTTACC
GCTTTCCC	GCTTTACC
GCTTTCCG	GCTTTACC
GCTTTCCT	GCTTTACC
GCTTTCCN	GCTTTACC
GCTTTCGG	GCTTACGG
GCCGTTAA	GCGTTAAC
GCTTTGAC	GCTTTACC
GCCGTTCA	GCTCGTTC
GGACCCGA	GGGACCCG
GCCGTTCC	GCTCGTTC
GGACCCGC	GGGACCCG
GCCGTTCG	GCTCGTTC
GCCGTTCT	GCTCGTTC
GGACCCGT	GGGACCCG
GCCGTTCN	GCTCGTTC
GCTTTGCC	GCTTTACC
GGACCCGN	GGGACCCG
GCTTTGTA	TCTTTGTA
GCTTTTAC	GCTTTACC
GCTTTTCC	GCTTTACC
GGATAAAC	GGATGAAC
GCTTTNAC	GCTTTACC
GCTTTNCC	GCTTTACC
GCGGAAAT	GCGTAAAT
GGATAAAG	GGAAAAGA
GGATAACA	GGATGAAC
GGATAACC	GGATGAAC
GGATAACG	GGATGAAC
GGATAACT	GGATGAAC
GGATAACN	GGATGAAC
GGATAAGA	GGAAAAGA
GCTTNACC	GCTTTACC
GCTTNACG	GCTTACGG
GGACGAAC	GGATGAAC
GGATACGA	GTATACGA
GCTTNCGG	GCTTACGG
GCCNCAGT	GCCCAGTC
GGACGCTG	CGACGCTG
GCGGACCC	GGGACCCG
GCGCAAAA	GGCAAAAT
GGATAGAA	GGATGAAC
GCGCAAAT	GCGTAAAT
GCTTNTAC	GCTTTACC
GCGCAGCC	ACGCAGCC
GGATATCA	GATATCAT
GCGCAGTC	GCCCAGTC
GGACTGAA	GGATGAAC
GCCTAAAT	GCGTAAAT
GGATCAAC	GGATGAAC
GCTNACGG	GCTTACGG
GCGCCAGT	GCCCAGTC
GCCTAGTC	GCCCAGTC
GCGCCCTA	ACGCCCTA
GGATCGAA	GGATGAAC
GCGGCCAG	ACGGCCAG
GCNGTAAA	GCGTAAAT
GCTNCGTT	GCTCGTTC
GGAGAAAG	GGAAAAGA
GGAGAACA	GGATGAAC
GGAGAACG	GGATGAAC
GGAGAACT	GGATGAAC
GGAGAACN	GGATGAAC
GGAGAAGA	GGAAAAGA
GGATGAAA	GGATGAAC
GGATGAAC	GGATGAAC
GGATGAAG	GGATGAAC
GGATGAAT	GGATGAAC
GGATGAAN	GGATGAAC
GGATGACA	GGATGAAC
GGATGACC	GGATGAAC
GGAGACCC	GGGACCCG
GGATGACG	GGATGAAC
GGATGACT	GGATGAAC
GGATGACN	GGATGAAC
GGATGAGA	GGATGAAC
GGATGAGC	GGATGAAC
GGATGATA	GGATGAAC
GGATGATC	GGATGAAC
GGCATAAA	GGCAAAAT
GGATGANA	GGATGAAC
GGATGANC	GGATGAAC
GGCATAAT	GGCAAAAT
GCGGGGGA	TCGGGGGA
GCNGTTAA	GCGTTAAC
GCTNGTTC	GCTCGTTC
GGATGCAA	GGATGAAC
GGATGCAC	GGATGAAC
GCGGGTTA	TGCGGGTT
GCGGGTTG	TGCGGGTT
GCGGGTTT	TGCGGGTT
GCGGGTTN	TGCGGGTT
GGATGGAA	GGATGAAC
GGCATGAA	GGATGAAC
GGATGGAC	GGATGAAC
GCGGTAAA	GCGTAAAT
GCGGTAAC	GCGTTAAC
GGATGTAA	GGATGAAC
GGATGTAC	GGATGAAC
GCTCCAGT	GCCCAGTC
GCTNTACC	GCTTTACC
GCTNTACG	GCTTACGG
GGATGTTT	GGTGTTTC
GGATGNAA	GGATGAAC
GGATGNAC	GGATGAAC
GGATTAAC	GGATGAAC
GGCANAAA	GGCAAAAT
GGCANAAT	GGCAAAAT
GCGGTTAA	GCGTTAAC
GGATTGAA	GGATGAAC
GCNCAGTC	GCCCAGTC
GCTCCGTT	GCTCGTTC
GGATTTTC	GAATTTTC
GGATNAAC	GGATGAAC
GGGTTAAC	GCGTTAAC
GCTNTTAC	GCTTTACC
GCTCCTTC	GCTCGTTC
GCNCCAGT	GCCCAGTC
GGCCAAAA	GGCAAAAT
GGCCAAAT	GGCAAAAT
GGGTTCGA	CGGGTTCG
GGGTTCGC	CGGGTTCG
GGGTTCGG	CGGGTTCG
GGGTTCGT	CGGGTTCG
GGGTTCGN	CGGGTTCG
GCNTAAAT	GCGTAAAT
GGCCACCG	TGCCACCG
GGATNGAA	GGATGAAC
GCNTACGG	GCTTACGG
GGCCAGTC	GCCCAGTC
GCTCGATC	GCTCGTTC
GCTCGATT	GCTCGTTC
GGGTTTCA	GGTGTTTC
GGGTTTCC	GGTGTTTC
GGGTTTCG	GGTGTTTC
GGGTTTCT	GGTGTTTC
GGGTTTCN	GGTGTTTC
GCTCGCTC	GCTCGTTC
GCTCGCTT	GCTCGTTC
GCTCGGTC	GCTCGTTC
GCTCGGTT	GCTCGTTC
GCTCGTAC	GCTCGTTC
GCTCGTAT	GCTCGTTC
GCTCGTCA	GCTCGTTC
GCTCGTCC	GCTCGTTC
GCTCGTCG	GCTCGTTC
GCTCGTCT	GCTCGTTC
GCTCGTCN	GCTCGTTC
GGCCCAGT	GCCCAGTC
GCTCGTGC	GCTCGTTC
GCTCGTGT	GCTCGTTC
GCTCGTTA	GCTCGTTC
GCTCGTTC	GCTCGTTC
GCTCGTTG	GCTCGTTC
GCTCGTTT	GCTCGTTC
GCTCGTTN	GCTCGTTC
GCTCGTNC	GCTCGTTC
GCTCGTNT	GCTCGTTC
GCTCGNTC	GCTCGTTC
GCTCGNTT	GCTCGTTC
GCTCTACC	GCTTTACC
GCTCTACG	GCTTACGG
GCNCGTTC	GCTCGTTC
GCNTCGTT	GCTCGTTC
GGCCGCCA	AGGCCGCC
GGCCGCCC	AGGCCGCC
GGCCGCCG	AGGCCGCC
GGCCGCCT	AGGCCGCC
GGCCGCCN	AGGCCGCC
GCTCTGTT	GCTCGTTC
GCTCTTAC	GCTTTACC
GCTCTTCA	GCTCGTTC
GCTCTTCC	GCTCGTTC
GCTCTTCG	GCTCGTTC
GCTCTTCT	GCTCGTTC
GCTCTTCN	GCTCGTTC
GCTCTTTC	GCTCGTTC
GGTAGAAC	GTAGAACC
GGTAGCAA	GTTAGCAA
GGGNACCC	GGGACCCG
GGTAGTTT	GGTGTTTC
GCTCNGTT	GCTCGTTC
GCTCNTTC	GCTCGTTC
GGTATACG	GTATACGA
GCNTTAAC	GCGTTAAC
GCNTTACC	GCTTTACC
GCNTTACG	GCTTACGG
GGTATCAT	GATATCAT
GGTATGAA	GGATGAAC
GCTGACGG	GCTTACGG
GGGNCCCG	GGGACCCG
GGTATTTC	GGTGTTTC
GCTGATAA	CTGATAAA
GCNTTTAC	GCTTTACC
GGAAAAAA	GGAAAAGA
GGAAAAAC	GGAAAAGA
GCTGCCTT	CTGCCTTT
GGAAAAAN	GGAAAAGA
GGAAAACA	GGAAAAGA
GGAAAACG	GGAAAAGA
GGAAAAGA	GGAAAAGA
GGAAAAGG	GGAAAAGA
GGAAAAGT	GGAAAAGA
GCTGCGTT	GCTCGTTC
GGAAAAGN	GGAAAAGA
GGAAAATC	GGCAAAAT
GGAAAATT	GGCAAAAT
GGAAAATN	GGCAAAAT
GGAAAANA	GGAAAAGA
GGAAAANG	GGAAAAGA
GGAAACAG	GGAAAAGA
GGAAACGA	GGAAAAGA
GGTCAAAA	GGCAAAAT
GGAAAGAA	GGAAAAGA
GGAAAGAC	GGAAAAGA
GGAAAGAG	GGAAAAGA
GGAAAGAT	GGAAAAGA
GGAAAGAN	GGAAAAGA
GGAAAGGA	GGAAAAGA
GGAAAGTA	GAAAGTAC
GGAAATGA	GGAAAAGA
GGCGAAAA	GGCAAAAT
GGAAANAG	GGAAAAGA
GGCGAAAT	GGCAAAAT
GGAAANGA	GGAAAAGA
GGAACAAG	GGAAAAGA
GGAACAGA	GGAAAAGA
GGCGACCC	GGGACCCG
GGCGACTA	TGGCGACT
GGAACCCG	GGGACCCG
GGCGACTC	TGGCGACT
GGCGACTG	TGGCGACT
GGCGACTT	TGGCGACT
GGCGACTN	TGGCGACT
GCTGGTTC	GCTCGTTC
GCTGTAAA	GCGTAAAT
GCTGTACC	GCTTTACC
GCTGTACG	GCTTACGG
GGTTGAAC	GGATGAAC
GGGAGCCC	GGGACCCG
GGGAGCCG	GGGACCCG
GCTGTATT	GTTGTATT
GGAAGAAC	GGATGAAC
GGAAGAAG	GGAAAAGA
GGAAGAGA	GGAAAAGA
GGCNAAAA	GGCAAAAT
GGCNAAAT	GGCAAAAT
GGTCGTTC	GCTCGTTC
GGTCGTTT	GGTGTTTC
GGAAGTAC	GAAAGTAC
GGTTGTAT	GTTGTATT
GCTGTTAA	GCGTTAAC
GCTGTTAC	GCTTTACC
GGGATCCC	GGGACCCG
GGGATCCG	GGGACCCG
GGTTGTTT	GGTGTTTC
GCTGTTCA	GCTCGTTC
GCTGTTCC	GCTCGTTC
GCTGTTCG	GCTCGTTC
GGGATGAA	GGATGAAC
GCTGTTCT	GCTCGTTC
GCTGTTCN	GCTCGTTC
GCTGTTTC	GGTGTTTC
GGAATAAG	GGAAAAGA
GGTAAAAG	GGAAAAGA
GGTAAAAT	GGCAAAAT
GGAATAGA	GGAAAAGA
GGTAAAGA	GGAAAAGA
GGAATAGG	GAAATAGG
GGTAAATA	GCGTAAAT
GGTTTACC	GCTTTACC
GGTAAATC	GCGTAAAT
GGTAAATG	GCGTAAAT
GGTAAATT	GCGTAAAT
GGTAAATN	GCGTAAAT
GGTCTAGC	TGTCTAGC
GGAATGAA	GGATGAAC
GGANAAAG	GGAAAAGA
GGANAAGA	GGAAAAGA
GGGANCCC	GGGACCCG
GGGANCCG	GGGACCCG
GGTTTTCA	GGTGTTTC
GGTTTTCC	GGTGTTTC
GGTTTTCG	GGTGTTTC
GGTTTTCT	GGTGTTTC
GGTTTTCN	GGTGTTTC
GGTTTTTC	GGTGTTTC
GTACGAAC	GTAGAACC
GGAATTTT	GAATTTTC
GGCGGGTT	TGCGGGTT
GGGCAAAA	GGCAAAAT
GTACGCCG	GTACCCGG
GTACGCGG	GTACCCGG
GGGCACCC	GGGACCCG
GGGGACCC	GGGACCCG
GGTCTTTC	GGTGTTTC
GGCGTAAA	GCGTAAAT
GGGCCCCG	GGGACCCG
GGGCCCGA	GGGACCCG
GGGCCCGC	GGGACCCG
GGGCCCGG	GGGACCCG
GGGCCCGT	GGGACCCG
GGGCCCGN	GGGACCCG
GTATAACC	GTAGAACC
GTATAACG	GTATACGA
GTATAAGA	GTATACGA
GGGCCGCC	AGGCCGCC
GTATACAA	GTATACGA
GTACTACG	GTATACGA
GTATACAC	GTATACGA
GTATACAG	GTATACGA
GTATACAT	GTATACGA
GTATACAN	GTATACGA
GTATACCA	GTATACGA
GTATACCG	GTATACGA
GTATACGA	GTATACGA
GTATACGC	GTATACGA
GTATACGG	GTATACGA
GTATACGT	GTATACGA
GTATACGN	GTATACGA
GTATACTA	GTATACGA
GTATACTG	GTATACGA
GTATACNA	GTATACGA
GTACTCCG	GTACCCGG
GTATACNG	GTATACGA
GGCGTTAA	GCGTTAAC
GTATAGAA	GTATACGA
GTATAGAC	GTATACGA
GTACTCGG	GTACCCGG
GTATAGAG	GTATACGA
GTATAGAT	GTATACGA
GTATAGAN	GTATACGA
GTATAGCA	GTTAGCAA
GTATAGCG	GTATACGA
GTATAGGA	GTATACGA
GGCGTTTC	GGTGTTTC
GTATATCA	GATATCAT
GGANGAAC	GGATGAAC
GTATATCG	GTATACGA
GTATATGA	GTATACGA
GGGCGACT	TGGCGACT
GGGGCCCG	GGGACCCG
GTACNCCG	GTACCCGG
GTACNCGG	GTACCCGG
GTATANCG	GTATACGA
GTATANGA	GTATACGA
GTATCACG	GTATACGA
GTAGAAAC	GTAGAACC
GTAGAACA	GTAGAACC
GTAGAACC	GTAGAACC
GTAGAACG	GTAGAACC
GTAGAACT	GTAGAACC
GTAGAACN	GTAGAACC
GTAGAAGA	TAGAAGAG
GTAGAAGC	GTAGAACC
GTAGAATC	GTAGAACC
GTATCATA	GATATCAT
GTATCATC	GATATCAT
GTATCATG	GATATCAT
GTATCATT	GATATCAT
GTAGAANC	GTAGAACC
GTATCATN	GATATCAT
GTAGACAC	GTAGAACC
GTAGACCA	GTAGAACC
GTAGACCC	GTAGAACC
GTAGACCG	GTAGAACC
GTAGACCT	GTAGAACC
GTAGACCN	GTAGAACC
GTAGACGA	GTATACGA
GTATCCCG	GTACCCGG
GTATCCGA	GTATACGA
GTATCCGG	GTACCCGG
GGTNGTTT	GGTGTTTC
GTAGAGAC	GTAGAACC
GTAGAGCC	GTAGAACC
GTAGAGGT	TAGAGGTT
GTATCGAA	GTATACGA
GTATCGAC	GTATACGA
GTATCGAG	GTATACGA
GTATCGAT	GTATACGA
GGCTAAAA	GGCAAAAT
GTATCGAN	GTATACGA
GGCTAAAT	GGCAAAAT
GTAGATAC	GTAGAACC
GTAGATCC	GTAGAACC
GGANTGAA	GGATGAAC
GTATCTCT	ATATCTCT
GGGAAAAG	GGAAAAGA
GGGAAAAT	GGCAAAAT
GTAGANAC	GTAGAACC
GTAGANCC	GTAGAACC
GGGAAAGA	GGAAAAGA
GGGAACCC	GGGACCCG
GGGAACCG	GGGACCCG
GGTNTTTC	GGTGTTTC
GTATGACG	GTATACGA
GTAGCAAA	GTTAGCAA
GTAGCAAG	GTTAGCAA
GTAGCAAT	GTTAGCAA
GTAGCAAN	GTTAGCAA
GTAGCACC	GTAGAACC
GTATGCGA	GTATACGA
GGGGTTCG	CGGGTTCG
GTAGCCCG	GTACCCGG
GTATGTAT	GTTGTATT
GTAGCCGG	GTACCCGG
GGGGTTTC	GGTGTTTC
GGGACACC	GGGACCCG
GGGACACG	GGGACCCG
GGCTCGTT	GCTCGTTC
GGGACATT	AGGACATT
GGGACCAC	GGGACCCG
GGGACCAG	GGGACCCG
GGGACCCA	GGGACCCG
GGGACCCC	GGGACCCG
GGGACCCG	GGGACCCG
GGGACCCT	GGGACCCG
GGGACCCN	GGGACCCG
GGGACCGA	GGGACCCG
GGGACCGC	GGGACCCG
GGGACCGG	GGGACCCG
GGGACCGT	GGGACCCG
GGGACCGN	GGGACCCG
GGGACCTC	GGGACCCG
GGGACCTG	GGGACCCG
GGGACCNC	GGGACCCG
GGGACCNG	GGGACCCG
GGGACGCC	GGGACCCG
GGGACGCG	GGGACCCG
GTAGGAAC	GTAGAACC
GTAGGACC	GTAGAACC
GGCTGAAC	GGATGAAC
GGCAAAAA	GGCAAAAT
GGCAAAAC	GGCAAAAT
GGCAAAAT	GGCAAAAT
GGCAAAAN	GGCAAAAT
GGGACTCC	GGGACCCG
GGCAAACA	GGCAAAAT
GGGACTCG	GGGACCCG
GGCAAACT	GGCAAAAT
GGCAAAGT	GGCAAAAT
GTATTACG	GTATACGA
GGCAAATA	GGCAAAAT
GGCAAATC	GGCAAAAT
GGCAAATG	GGCAAAAT
GGCAAATT	GGCAAAAT
GGCAAATN	GGCAAAAT
GGCAAANA	GGCAAAAT
GGCAAANT	GGCAAAAT
GGCAACAA	GGCAAAAT
GGCAACAT	GGCAAAAT
GTCCCAGT	GCCCAGTC
GGGACNCC	GGGACCCG
GGGACNCG	GGGACCCG
GGCAAGAA	GGCAAAAT
GTATTCGA	GTATACGA
GGCAAGAT	GGCAAAAT
GGCAATAA	GGCAAAAT
GGCAATAT	GGCAAAAT
GTCCCCGG	GTACCCGG
GGGTAAAT	GCGTAAAT
GGCAANAA	GGCAAAAT
GGCAANAT	GGCAAAAT
GTAGTAAC	GTAGAACC
GGCTGTTT	GGTGTTTC
GTATTTTC	GAATTTTC
GTAGTACC	GTAGAACC
GTAGTACG	GTATACGA
GGCACAAA	GGCAAAAT
GGGTACCC	GGGACCCG
GGCACAAT	GGCAAAAT
GTAGTATT	GTTGTATT
GTCCCGGA	GTACCCGG
GTCCCGGC	GTACCCGG
GGCTTACG	GCTTACGG
GTCCCGGG	GTACCCGG
GTCCCGGT	GTACCCGG
GTCCCGGN	GTACCCGG
GTATNACG	GTATACGA
GGNTGAAC	GGATGAAC
GGCACCCG	GGGACCCG
GTCCCTCT	ATCCCTCT
GTATNCGA	GTATACGA
GGCTTTAC	GCTTTACC
GTAGNAAC	GTAGAACC
GTAGNACC	GTAGAACC
GGCAGAAA	GGCAAAAT
GGCAGAAT	GGCAAAAT
GGGTCCCG	GGGACCCG
GGNTGTTT	GGTGTTTC
GGNAAAAG	GGAAAAGA
GGNAAAAT	GGCAAAAT
GGNAAAGA	GGAAAAGA
GTANAACC	GTAGAACC
GTCCGGGA	TCCGGGAC
GTANACGA	GTATACGA
GGNGACCC	GGGACCCG
GGGTGAAC	GGATGAAC
GGCAGTTA	GACAGTTA
GTANCCCG	GTACCCGG
GGNACCCG	GGGACCCG
GTANCCGG	GTACCCGG
GGGTGTTT	GGTGTTTC
GTCCTGGC	ATCCTGGC
GTANGAAC	GTAGAACC
GGTGAACA	GGATGAAC
GGTGAACC	GGATGAAC
GGTGAACG	GGATGAAC
GGTGAACT	GGATGAAC
GGTGAACN	GGATGAAC
GGTGACCC	GGGACCCG
GTAAAAAG	GAAAAAGC
GTAAAACC	GTAGAACC
GTAAAAGA	GGAAAAGA
GTAAAAGC	GAAAAAGC
GTAAACCA	GTAGAACC
GTAAACCC	GTAGAACC
GTAAACCG	GTAGAACC
GTAAACCT	GTAGAACC
GTAAACCN	GTAGAACC
GTAAACGA	GTATACGA
GGTGATTC	GGTGTTTC
GGTGATTT	GGTGTTTC
GTAAAGTA	GAAAGTAC
GTAAAGTC	ATAAAGTC
GTAAATAG	GAAATAGG
GGNATGAA	GGATGAAC
GTCGAACC	GTAGAACC
GTTANCAA	GTTAGCAA
GTTANGCA	GTTAGCAA
GTAACCCG	GTACCCGG
GTAACCGG	GTACCCGG
GTCGATGG	TTCGATGG
GTAACGAA	GTATACGA
GTAACGAC	GTATACGA
GGTGCTTC	GGTGTTTC
GTAACGAG	GTATACGA
GTAACGAT	GTATACGA
GGTGCTTT	GGTGTTTC
GTAACGAN	GTATACGA
GGNGTTTC	GGTGTTTC
GTAACTCA	TAACTCAG
GTAAGAAC	GTAGAACC
GTTCAGAT	TTCAGATA
GTTCAGCA	GTTAGCAA
GGNCAAAA	GGCAAAAT
GTAAGCAA	GTTAGCAA
GGTGGTTC	GGTGTTTC
GGTGGTTT	GGTGTTTC
GTTCCAAA	CGTTCCAA
GTTCCAAC	CGTTCCAA
GTTCCAAG	CGTTCCAA
GTTCCAAT	CGTTCCAA
GTTCCAAN	CGTTCCAA
GTAAGTAC	GAAAGTAC
GGTGTATC	GGTGTTTC
GTTCCCAG	CTTCCCAG
GGTGTCCA	CGTGTCCA
GTTAACAA	GTTAGCAA
GTTCCCGG	GTACCCGG
GGTGTCTC	GGTGTTTC
GGTGTCTT	GGTGTTTC
GGTGTGTC	GGTGTTTC
GGTGTGTT	GGTGTTTC
GTTAAGCA	GTTAGCAA
GTAATACG	GTATACGA
GTCGGGGG	TCGGGGGA
GTAATAGG	GAAATAGG
GGTGTTAC	GGTGTTTC
GGTGTTAT	GGTGTTTC
GGTGTTCA	GGTGTTTC
GGTGTTCC	GGTGTTTC
GGTGTTCG	GGTGTTTC
GGTGTTCT	GGTGTTTC
GGTGTTCN	GGTGTTTC
GGTGTTGC	GGTGTTTC
GTAATCGA	TAATCGAT
GGTGTTGT	GGTGTTTC
GGTGTTTA	GGTGTTTC
GGTGTTTC	GGTGTTTC
GGTGTTTG	GGTGTTTC
GGTGTTTT	GGTGTTTC
GGTGTTTN	GGTGTTTC
GTCGTAAA	GCGTAAAT
GGTGTTNC	GGTGTTTC
GGTGTTNT	GGTGTTTC
GTTACAAA	GTTAGCAA
GTTACAAC	GTTAGCAA
GTTACAAG	GTTAGCAA
GTTACAAT	GTTAGCAA
GTTACAAN	GTTAGCAA
GTCGTATT	GTTGTATT
GTTCGATG	TTCGATGG
GTTACCAA	GTTAGCAA
GTAATTTT	GAATTTTC
GTTCGCAA	GTTAGCAA
GTTACCCG	GTACCCGG
GTTACGAA	GTATACGA
GTTACGAC	GTATACGA
GTTACGAG	GTATACGA
GTTACGAT	GTATACGA
GGTGTNTC	GGTGTTTC
GTTACGAN	GTATACGA
GTTACGCA	GTTAGCAA
GTTACGGA	GCTTACGG
GTTACGGC	GCTTACGG
GTTACGGG	GCTTACGG
GTTACGGT	GCTTACGG
GTTACGGN	GCTTACGG
GGTGTNTT	GGTGTTTC
GTCGTTAA	GCGTTAAC
GTCGTTCA	GCTCGTTC
GTCGTTCC	GCTCGTTC
GTCGTTCG	GCTCGTTC
GTCGTTCT	GCTCGTTC
GTTCGGCA	TGTTCGGC
GTCGTTCN	GCTCGTTC
GTTCGGCC	TGTTCGGC
GTTCGGCG	TGTTCGGC
GTTCGGCT	TGTTCGGC
GTTCGGCN	TGTTCGGC
GTTCGTAT	GTTGTATT
GTTCGTTC	GCTCGTTC
GTTAGAAA	GTTAGCAA
GTTAGAAG	GTTAGCAA
GTTAGAAT	GTTAGCAA
GTTAGAAN	GTTAGCAA
GTTAGCAA	GTTAGCAA
GTTAGCAC	GTTAGCAA
GTTAGCAG	GTTAGCAA
GTTAGCAT	GTTAGCAA
GTTAGCAN	GTTAGCAA
GTTAGCCA	GTTAGCAA
GTTAGCGA	GTTAGCAA
GTTAGCTA	GTTAGCAA
GTTAGCNA	GTTAGCAA
GTTAGGAA	GTTAGCAA
GTTAGGCA	GTTAGCAA
GTTCTATA	TTCTATAC
GTTCTATT	GTTGTATT
GTTAGTAA	GTTAGCAA
GTACAACC	GTAGAACC
GTTAGTAT	GTTGTATT
GTTAGTCA	GTTAGCAA
GTTNAGCA	GTTAGCAA
GTGCAAAA	GGCAAAAT
GTTAGNAA	GTTAGCAA
GTACACCG	GTACCCGG
GTTAGNCA	GTTAGCAA
GTACACGA	GTATACGA
GTACACGG	GTACCCGG
GTTATACG	GTATACGA
GGTGNTTC	GGTGTTTC
GGTGNTTT	GGTGTTTC
GTTATATT	GTTGTATT
GTACAGTT	GACAGTTA
GTTATCAA	GTTAGCAA
GTTATCAT	GATATCAT
GGTTAACA	GCGTTAAC
GGTTAACC	GCGTTAAC
GGTTAACG	GCGTTAAC
GGTTAACT	GCGTTAAC
GGTTAACN	GCGTTAAC
GTTATGCA	GTTAGCAA
GTGCATGG	ATGCATGG
GTGCCACC	TGCCACCG
GGTTACGG	GCTTACGG
GTGCCCGG	GTACCCGG
GNAGAACC	GTAGAACC
GGTTAGCA	GTTAGCAA
GTACCACG	GTACCCGG
GTACCAGG	GTACCCGG
GTACCCAG	GTACCCGG
GTACCCCG	GTACCCGG
GTACCCGA	GTACCCGG
GTACCCGG	GTACCCGG
GTACCCGT	GTACCCGG
GTACCCGN	GTACCCGG
GTACCCTG	GTACCCGG
GTACCCNG	GTACCCGG
GTACCGCG	GTACCCGG
GTGCCTTT	CTGCCTTT
GTACCGGA	GTACCCGG
GTACCGGC	GTACCCGG
GTACCGGG	GTACCCGG
GTACCGGT	GTACCCGG
GTACCGGN	GTACCCGG
GTACCTCG	GTACCCGG
GTTGAACC	GTAGAACC
GTACCTGG	GTACCCGG
GTTNGCAA	GTTAGCAA
GTTGAATT	GTTGTATT
GTACCNCG	GTACCCGG
GTACCNGG	GTACCCGG
GTTGAGAA	TTGAGAAC
GTGAAAAG	GGAAAAGA
GTGGTATT	GTTGTATT
GTTNGTAT	GTTGTATT
GTTGAGCA	GTTAGCAA
GTGGTCCG	ATGGTCCG
GTGAACCA	GTAGAACC
GTGAACCC	GTAGAACC
GTGAACCG	GTAGAACC
GTGAACCT	GTAGAACC
GTGAACCN	GTAGAACC
GTTGATAT	GTTGTATT
GTTGATTA	GTTGTATT
GTTGATTC	GTTGTATT
GTTGATTG	GTTGTATT
GGTTCCAA	CGTTCCAA
GTTGATTT	GTTGTATT
GTTGATTN	GTTGTATT
GTCTACGA	GTATACGA
GTTNTATT	GTTGTATT
GTGCGGGT	TGCGGGTT
GTCTAGCC	TGTCTAGC
GTCTAGCG	TGTCTAGC
GTCTAGCT	TGTCTAGC
GTCTAGCN	TGTCTAGC
GGTTCGGC	TGTTCGGC
GTTGCAAA	GTTAGCAA
GTTGCAAC	GTTAGCAA
GTTGCAAG	GTTAGCAA
GTTGCAAT	GTTAGCAA
GTTGCAAN	GTTAGCAA
GTCTATAC	TTCTATAC
GTTGCATT	GTTGTATT
GTTGCGTC	TTTGCGTC
GTTGCTAT	GTTGTATT
GTTGCTGA	TTTGCTGA
GTANTACG	GTATACGA
GTCTCGTT	GCTCGTTC
GTGAGCAA	GTTAGCAA
GTGTAAAT	GCGTAAAT
GTCTGAGC	ATCTGAGC
GTGTACGA	GTATACGA
GNATTTTC	GAATTTTC
GTGTAGCA	GTTAGCAA
GTGATAAA	CTGATAAA
GTCTGTAT	GTTGTATT
GTGATACG	GTATACGA
GTGTATTA	GTTGTATT
GTGTATTC	GTTGTATT
GTGTATTG	GTTGTATT
GTGTATTT	GTTGTATT
GTGTATTN	GTTGTATT
GTGGAACC	GTAGAACC
GTGGACCC	GGGACCCG
GTNACCCG	GTACCCGG
GTGATGAA	GGATGAAC
GTCTTACG	GCTTACGG
GTGTCCAA	CGTGTCCA
GTGTCCAC	CGTGTCCA
GTGTCCAG	CGTGTCCA
GTGTCCAT	CGTGTCCA
GTGTCCAN	CGTGTCCA
GTGTCTAG	TGTCTAGC
GTCTTTAC	GCTTTACC
GTCTTTGT	TCTTTGTA
GTNAGAAC	GTAGAACC
GTNAGCAA	GTTAGCAA
GTGGCGAC	TGGCGACT
GTGGCGTA	TTGGCGTA
GTCAAAAT	GGCAAAAT
GTGTGTAT	GTTGTATT
GTGTGTTT	GGTGTTTC
GTGTTAAC	GCGTTAAC
GTCAACTT	TCAACTTC
GTGTTCGG	TGTTCGGC
GTCAAGAC	TCAAGACG
GTGTTTAA	TTGTTTAA
GTGTTTCA	GGTGTTTC
GTGTTTCC	GGTGTTTC
GTGTTTCG	GGTGTTTC
GTGTTTCT	GGTGTTTC
GTGTTTCN	GGTGTTTC
GTNGTATT	GTTGTATT
GNATACGA	GTATACGA
GNATATCA	GATATCAT
GTNATACG	GTATACGA
GTCACCCG	GTACCCGG
GTCACTAC	CTCACTAC
GTCAGAAC	GTAGAACC
GTCAGATA	TTCAGATA
GTCAGCAA	GTTAGCAA
GTNTACGA	GTATACGA
GNAAGTAC	GAAAGTAC
GTNTAGCA	GTTAGCAA
GNAATAGG	GAAATAGG
GTCAGTTA	GACAGTTA
GNATGAAC	GGATGAAC
GTCATACG	GTATACGA
GNCGTAAA	GCGTAAAT
GNAATTTT	GAATTTTC
GNCGTTAA	GCGTTAAC
GNCAAAAT	GGCAAAAT
GTNCCCGG	GTACCCGG
GNTCGTTC	GCTCGTTC
GTCCAGTC	GCCCAGTC
GNACAGTT	GACAGTTA
GNAAAAAG	GAAAAAGC
GNAAAAGA	GGAAAAGA
GNAAAAGC	GAAAAAGC
GNTACCCG	GTACCCGG
GNCTCGTT	GCTCGTTC
GTNTGTAT	GTTGTATT
GTTGGATT	GTTGTATT
GTTGGCAA	GTTAGCAA
GTTGGCGT	TTGGCGTA
GNACCCGG	GTACCCGG
GNAAAGTA	GAAAGTAC
GTTGGTAT	GTTGTATT
GNAAATAG	GAAATAGG
GTTGTAAT	GTTGTATT
GTTGTACT	GTTGTATT
GTTGTAGT	GTTGTATT
GTTGTATA	GTTGTATT
GTTGTATC	GTTGTATT
GTTGTATG	GTTGTATT
GTTGTATT	GTTGTATT
GTTGTATN	GTTGTATT
GTTGTANT	GTTGTATT
GTTGTCAT	GTTGTATT
GNTAGAAC	GTAGAACC
GNTAGCAA	GTTAGCAA
GTTGTCTT	GTTGTATT
GTTGTGAT	GTTGTATT
GTTGTGTT	GTTGTATT
GTTGTTAT	GTTGTATT
GNGAAAAG	GGAAAAGA
GTTGTTTG	GTTGTATT
GTTGTTTT	GTTGTATT
GTTGTTTN	GTTGTATT
GTTGTNAT	GTTGTATT
GTNGAACC	GTAGAACC
GTTGTNTT	GTTGTATT
GTTGNATT	GTTGTATT
GNTATACG	GTATACGA
GNTATCAT	GATATCAT
GTTGNTAT	GTTGTATT
GTTTACCA	GCTTTACC
GTTTACCC	GCTTTACC
GTTTACCG	GCTTTACC
GTTTACCT	GCTTTACC
GTTTACCN	GCTTTACC
GTTTACGA	GTATACGA
GTTTACGG	GCTTACGG
GTTTAGAC	TTTAGACA
GTTTAGCA	GTTAGCAA
GTTTAGCC	TTTTAGCC
GNGACCCG	GGGACCCG
GTTTATTA	GTTGTATT
GTTTATTC	GTTGTATT
GTTTATTG	GTTGTATT
GTTTATTT	GTTGTATT
GTTTATTN	GTTGTATT
GNTGTATT	GTTGTATT
GNCTTACG	GCTTACGG
GNGGACCC	GGGACCCG
GNTGTTTC	GGTGTTTC
GNCTTTAC	GCTTTACC
TAAGTCAG	TAACTCAG
GTTTGCAA	GTTAGCAA
TAAGTCGA	TAATCGAT
GTTTGCGT	TTTGCGTC
GTTTGCTG	TTTGCTGA
TAAGTGCT	AAGTGCTG
GNGATGAA	GGATGAAC
TAAGTGGT	AAGTGGTG
GTTTGTAT	GTTGTATT
GTTTTACC	GCTTTACC
GTTTTAGC	TTTTAGCC
GNGTGTTT	GGTGTTTC
GTTTTATT	GTTGTATT
GNGTTAAC	GCGTTAAC
TAATACGA	TAATCGAT
TAANCGAT	TAATCGAT
TAATAGAT	TAATCGAT
TAANCTCA	TAACTCAG
GNGCAAAA	GGCAAAAT
TAATCAAT	TAATCGAT
TAATCACC	AATCACCC
TAATCAGC	TAACTCAG
TAATCAGG	TAACTCAG
TAATCAGT	TAACTCAG
TAATCAGN	TAACTCAG
TAATCATA	TAATCGAT
TAATCATC	TAATCGAT
TAATCATG	TAATCGAT
TAATCATT	TAATCGAT
TAATCATN	TAATCGAT
TAATCCAT	TAATCGAT
TAATCCGA	TAATCGAT
TAATCGAA	TAATCGAT
TAATCGAC	TAATCGAT
TAATCGAG	TAATCGAT
TAATCGAT	TAATCGAT
TAATCGAN	TAATCGAT
TAATCGCA	TAATCGAT
TAATCGGA	TAATCGAT
TAATCGGT	TAATCGAT
TAATCGTA	TAATCGAT
TAATCGTC	TAATCGAT
TAATCGTG	TAATCGAT
TAATCGTT	TAATCGAT
TAATCGTN	TAATCGAT
TAATCGNA	TAATCGAT
TAATCGNT	TAATCGAT
TAATCTAT	TAATCGAT
TAATCTCA	TAACTCAG
TAATCTGA	TAATCGAT
TAATCNAT	TAATCGAT
TAATCNGA	TAATCGAT
TAANTCAG	TAACTCAG
TAANTCGA	TAATCGAT
TAATGATA	TAATCGAT
TAATGATC	TAATCGAT
TAATGATG	TAATCGAT
TAATGATT	TAATCGAT
TAATGATN	TAATCGAT
TAATGCGA	TAATCGAT
TAATGGAT	TAATCGAT
TACGGCCA	ACGGCCAG
TACGGGAC	TCCGGGAC
TACGGGGG	TCGGGGGA
TACGGGTT	TGCGGGTT
TAATTCAG	TAACTCAG
TAATTCGA	TAATCGAT
TACGTATT	ACGTATTA
GNGTAAAT	GCGTAAAT
TAATTGAT	TAATCGAT
TACAACTT	TCAACTTC
TACAAGAC	TCAAGACG
TACGTGGG	CACGTGGG
TACAAGAG	TAGAAGAG
TAATTTTC	GAATTTTC
TACACAAG	ACACAAGT
GNCAGTTA	GACAGTTA
TACACCGC	TACCCGCA
TACACGCA	TACCCGCA
TAATNCGA	TAATCGAT
TAATNGAT	TAATCGAT
TACACTCA	TAACTCAG
TACTAATT	ACTAATTT
TACAGATA	TTCAGATA
TACTATAC	TTCTATAC
TACAGGTT	TAGAGGTT
TACTCAGA	TAACTCAG
TACTCAGC	TAACTCAG
TACTCAGG	TAACTCAG
TACTCAGT	TAACTCAG
TACTCAGN	TAACTCAG
TACAGTTA	GACAGTTA
TACTCCGC	TACCCGCA
TACTCGAT	TAATCGAT
TACTCGCA	TACCCGCA
TACATCCT	ACATCCTT
TACATCGA	TAATCGAT
TATAGACA	TTTAGACA
TAACACAG	TAACTCAG
TAACATCA	TAACTCAG
TAAAAAGC	GAAAAAGC
TACTGGGA	AACTGGGA
TATAGGTT	TAGAGGTT
GNCCAGTC	GCCCAGTC
TAACCAGA	TAACTCAG
TAACCAGC	TAACTCAG
TAACCAGG	TAACTCAG
TAACCAGT	TAACTCAG
TAACCAGN	TAACTCAG
TAACCCAG	TAACTCAG
TAAAAGAG	TAGAAGAG
TAACCCGC	TACCCGCA
TATGAAGA	TAGAAGAG
TAACCGAA	CAACCGAA
TAACCGAT	TAATCGAT
TAACCGCA	TACCCGCA
GNCCCAGT	GCCCAGTC
TATATCAT	GATATCAT
TATATCGA	TAATCGAT
TATATCGG	CATATCGG
TATATCTC	ATATCTCT
TATGACGC	CATGACGC
TAACCTCA	TAACTCAG
TATGAGAA	TTGAGAAC
TATGAGGT	TAGAGGTT
TAAACGAT	TAATCGAT
TAAACTCA	TAACTCAG
TAACGATA	TAATCGAT
TAACGATC	TAATCGAT
TAACGATG	TAATCGAT
TAACGATT	TAATCGAT
TAACGATN	TAATCGAT
TAAACTTC	TCAACTTC
TAACGCAG	TAACTCAG
TAACGCAT	AACGCATG
TAAAGACG	TCAAGACG
TAAAGAGA	TAGAAGAG
TAAAGAGC	TAGAAGAG
TATGCATG	ATGCATGG
TAAAGAGG	TAGAAGAG
TAAAGAGT	TAGAAGAG
TAAAGAGN	TAGAAGAG
TACTTTGT	TCTTTGTA
TAACGTCA	TAACTCAG
TATGCGTC	TTTGCGTC
TAAAGGTT	TAGAGGTT
TAAAGTAC	GAAAGTAC
TATGCTGA	TTTGCTGA
TAAAGTCA	ATAAAGTC
TAAAGTCC	ATAAAGTC
TAAAGTCG	ATAAAGTC
TAAAGTCT	ATAAAGTC
TAAAGTCN	ATAAAGTC
TAACTAAG	TAACTCAG
TAACTACA	TAACTCAG
TAACTAGA	TAACTCAG
TAACTAGC	TAACTCAG
TAACTAGG	TAACTCAG
TAACTAGT	TAACTCAG
TAACTAGN	TAACTCAG
TAACTCAA	TAACTCAG
TAACTCAC	TAACTCAG
TAACTCAG	TAACTCAG
TAACTCAT	TAACTCAG
TAACTCAN	TAACTCAG
TAACTCCA	TAACTCAG
TAACTCCG	TAACTCAG
TAACTCGC	TAACTCAG
TAACTCGG	TAACTCAG
TAACTCGT	TAACTCAG
TAACTCGN	TAACTCAG
TAACTCTA	TAACTCAG
TAACTCTG	TAACTCAG
TAACTCNA	TAACTCAG
TAACTCNG	TAACTCAG
TAACTGAG	TAACTCAG
TAACTGCA	TAACTCAG
TATCACCC	AATCACCC
TAACTGGG	AACTGGGA
TATGGCGT	TTGGCGTA
TAACTTAG	TAACTCAG
TAACTTCC	TCAACTTC
TAACTTCG	TCAACTTC
TAACTTCT	TCAACTTC
TATCAGAT	TTCAGATA
TAACTTCN	TCAACTTC
TAAATAGG	GAAATAGG
TAACTNAG	TAACTCAG
TAACTNCA	TAACTCAG
TATGGTCC	ATGGTCCG
TAAATCAG	TAACTCAG
TAAATCGA	TAATCGAT
TAAATCGC	AAATCGCT
GNTTACGG	GCTTACGG
GNTTAGCA	GTTAGCAA
TAACNCAG	TAACTCAG
TAACNTCA	TAACTCAG
TATCCCGC	TACCCGCA
TATCCCTC	ATCCCTCT
TATCCGCA	TACCCGCA
TANACTCA	TAACTCAG
TATGTTTA	TTGTTTAA
TAAGAAGA	TAGAAGAG
TAAGAATA	AAGAATAA
TATCCTGG	ATCCTGGC
TAAGACGA	TCAAGACG
TAAGACGC	TCAAGACG
TAAGACGG	TCAAGACG
TAAGACGT	TCAAGACG
TAAGACGN	TCAAGACG
TAAGAGGT	TAGAGGTT
TATCGATA	TAATCGAT
TATCGATC	TAATCGAT
TATCGATT	TAATCGAT
TATCGATN	TAATCGAT
TANAGGTT	TAGAGGTT
GNTTGTAT	GTTGTATT
TATTAGAC	TTTAGACA
TATTAGCC	TTTTAGCC
TAAGCGAT	TAATCGAT
GNTTTACC	GCTTTACC
TAAGCTCA	TAACTCAG
TAGATAGA	TAGAAGAG
TANATCGA	TAATCGAT
TATCTAGC	TGTCTAGC
TATCTATA	TTCTATAC
TATCTCAG	TAACTCAG
TAAGGAGT	AAGGAGTG
TATTCCCT	CATTCCCT
TATCTCTA	ATATCTCT
TATTCGAT	TAATCGAT
TATCTCTC	ATATCTCT
TATCTCTG	ATATCTCT
TATCTCTT	ATATCTCT
TATCTCTN	ATATCTCT
TAGATCGA	TAATCGAT
TATTCGGC	TGTTCGGC
TATCTGAG	ATCTGAGC
TAAGGGGA	AAGGGGAC
TAGGCCGC	AGGCCGCC
TAGGCGAC	TGGCGACT
TAGATGAG	TAGAAGAG
TAAGGTTA	TAGAGGTT
TAAGGTTC	TAGAGGTT
TAAGGTTG	TAGAGGTT
TAAGGTTT	TAGAGGTT
TAGGCGTA	TTGGCGTA
TAAGGTTN	TAGAGGTT
TAGATGGT	TAGAGGTT
TAGATGTT	TAGAGGTT
TATTGCGT	TTTGCGTC
TATTGCTG	TTTGCTGA
TAGGGGAC	AAGGGGAC
TAGGGGGA	TCGGGGGA
TAGGGGTT	TAGAGGTT
TAGGGTTA	TAGAGGTT
TAGGGTTC	TAGAGGTT
TAGGGTTG	TAGAGGTT
TAGGGTTT	TAGAGGTT
TAGGGTTN	TAGAGGTT
TAGANAGA	TAGAAGAG
TAGNAAGA	TAGAAGAG
TAGANGAG	TAGAAGAG
TAGANGGT	TAGAGGTT
TAGNAGAG	TAGAAGAG
TAGANGTT	TAGAGGTT
TCATCCTT	ACATCCTT
TAGNAGGT	TAGAGGTT
TCATCGAT	TAATCGAT
TCATCTTC	TCAACTTC
TAGCAAGA	TAGAAGAG
TAGCAGAG	TAGAAGAG
TAGCAGGT	TAGAGGTT
TCCAAATG	CCAAATGC
TANCCCGC	TACCCGCA
TAGCCACC	TGCCACCG
TAGTAAGA	TAGAAGAG
TCCAACTT	TCAACTTC
TAGCCCGC	TACCCGCA
TCCAAGAC	TCAAGACG
TANCCGCA	TACCCGCA
TAGCCGCA	TACCCGCA
TAGTAGAG	TAGAAGAG
TAGTAGGT	TAGAGGTT
TAGNGGTT	TAGAGGTT
TCATTCCC	CATTCCCT
TAGTCGAT	TAATCGAT
TAGCGACT	TGGCGACT
TAGTCTAG	TGTCTAGC
TACCACCG	TGCCACCG
TACCACGC	TACCCGCA
TCCACCGA	TGCCACCG
TCCACCGC	TGCCACCG
TCCACCGG	TGCCACCG
TCCACCGT	TGCCACCG
TCCACCGN	TGCCACCG
TACCAGCA	TACCCGCA
TCATTGTA	TCTTTGTA
TAGTGCTG	AAGTGCTG
TAGTGGTG	AAGTGGTG
TAGTGGTT	TAGAGGTT
TCCACTTC	TCAACTTC
TCATTTGT	TCTTTGTA
TAGCGGGT	TGCGGGTT
TCATTTTT	CATTTTTT
TAGCGGTT	TAGAGGTT
TACCCACA	TACCCGCA
TANCTCAG	TAACTCAG
TCCAGACG	TCAAGACG
TACCCAGC	TACCCGCA
TCCAGAGT	CCAGAGTC
TCCAGATA	TTCAGATA
TAGTTCGG	TGTTCGGC
TATAAAGT	ATAAAGTC
TACCCCAA	TACCCGCA
TACCCCAC	TACCCGCA
TACCCCAG	TACCCGCA
TACCCCAT	TACCCGCA
TACNCCGC	TACCCGCA
TACCCCAN	TACCCGCA
TCCAGGAC	TCCGGGAC
TACCCCCA	TACCCGCA
TAGTTTAA	TTGTTTAA
TACCCCGC	TACCCGCA
TCCAGGGA	TCCGGGAC
TACCCGAA	TACCCGCA
TACNCGCA	TACCCGCA
TACCCGAC	TACCCGCA
TACCCGAG	TACCCGCA
TACCCGAT	TACCCGCA
TACCCGAN	TACCCGCA
TACCCGCA	TACCCGCA
TACCCGCC	TACCCGCA
TACCCGCG	TACCCGCA
TACCCGCT	TACCCGCA
TACCCGCN	TACCCGCA
TAGCTCAG	TAACTCAG
TACCCGGG	GTACCCGG
TACCCGGT	GTACCCGG
TACCCGGN	GTACCCGG
TACCCGTA	TACCCGCA
TACCCGTC	TACCCGCA
TCAAAACG	TCAAGACG
TACCCGNA	TACCCGCA
TACCCGNC	TACCCGCA
TACCCTCA	TACCCGCA
TATAAGAG	TAGAAGAG
TACCCTGC	TACCCGCA
TCCTACGG	CCTACGGT
TACCCNCA	TACCCGCA
TACCCNGC	TACCCGCA
TAGCTTGC	CAGCTTGC
TCAAACGA	TCAAGACG
TCAAACGC	TCAAGACG
TCAAACGG	TCAAGACG
TCAAACGT	TCAAGACG
TCAAACGN	TCAAGACG
TCCTATAC	TTCTATAC
TCAAACTT	TCAACTTC
TACCGCAA	TACCCGCA
TACCGCAC	TACCCGCA
TACCGCAG	TACCCGCA
TCAAAGAC	TCAAGACG
TACCGCAT	TACCCGCA
TACCGCAN	TACCCGCA
TACCGCGC	TACCCGCA
TCANACTT	TCAACTTC
TCANAGAC	TCAAGACG
TACCGGCA	TACCCGCA
TATACGAA	GTATACGA
TATACGAC	GTATACGA
TATACGAG	GTATACGA
TATACGAT	GTATACGA
TATACGAN	GTATACGA
TACCGGGA	TCCGGGAC
TACCGGTT	ACCGGTTG
TCAAATGC	CCAAATGC
TCAAATTC	TCAACTTC
TATACTCA	TAACTCAG
TCACTACA	CTCACTAC
TCACTACC	CTCACTAC
TCACTACG	CTCACTAC
TCACTACT	CTCACTAC
TCACTACN	CTCACTAC
TCAACACG	TCAAGACG
TCACTCAG	TAACTCAG
TACCTCAG	TAACTCAG
TACCTCGC	TACCCGCA
TCAACATC	TCAACTTC
TCAACATT	TCAACTTC
TACCTGCA	TACCCGCA
TCACTTCA	TCAACTTC
TCACTTCC	TCAACTTC
TCACTTCG	TCAACTTC
TCACTTCT	TCAACTTC
TCACTTCN	TCAACTTC
TCAACCGA	CAACCGAA
TCAACCTC	TCAACTTC
TCAACCTT	TCAACTTC
TAGGAAGA	TAGAAGAG
TCANCTTC	TCAACTTC
TAGGACAT	AGGACATT
TCAACGAC	TCAAGACG
TCAACGTC	TCAACTTC
TCAACGTT	TCAACTTC
TCCCACCG	TGCCACCG
TCCTGGAC	TCCGGGAC
TCCTGGCA	ATCCTGGC
TCANGACG	TCAAGACG
TCCTGGCC	ATCCTGGC
TCCTGGCG	ATCCTGGC
TCCTGGCT	ATCCTGGC
TCCTGGCN	ATCCTGGC
TCCTGGGA	TCCGGGAC
TCCCAGTC	GCCCAGTC
TAGGAGAG	TAGAAGAG
TCAACTAC	TCAACTTC
TCAACTAT	TCAACTTC
TCAACTCC	TCAACTTC
TCAACTCG	TCAACTTC
TCAACTCT	TCAACTTC
TCAACTCN	TCAACTTC
TCAACTGC	TCAACTTC
TAGGAGGT	TAGAGGTT
TCAACTGT	TCAACTTC
TCAACTTA	TCAACTTC
TCAACTTC	TCAACTTC
TCAACTTG	TCAACTTC
TCAACTTT	TCAACTTC
TAGGAGTG	AAGGAGTG
TAGAAAAG	TAGAAGAG
TCAACTTN	TCAACTTC
TAGAAAGA	TAGAAGAG
TAGAAAGC	TAGAAGAG
TCAACTNC	TCAACTTC
TAGAAAGG	TAGAAGAG
TAGAAAGT	TAGAAGAG
TCAACTNT	TCAACTTC
TAGAAAGN	TAGAAGAG
TACCNCGC	TACCCGCA
TAGAACAG	TAGAAGAG
TAGAACCA	GTAGAACC
TAGAACCC	GTAGAACC
TAGAACCG	GTAGAACC
TAGAACCT	GTAGAACC
TAGAACCN	GTAGAACC
TAGAACGA	TAGAAGAG
TACCNGCA	TACCCGCA
TCAACNTC	TCAACTTC
TAGAAGAA	TAGAAGAG
TAGAAGAC	TAGAAGAG
TAGAAGAG	TAGAAGAG
TCAACNTT	TCAACTTC
TAGAAGAT	TAGAAGAG
TAGAAGAN	TAGAAGAG
TAGAAGCA	TAGAAGAG
TAGAAGCG	TAGAAGAG
TCAGAAGA	TAGAAGAG
TAGAAGGA	TAGAAGAG
TCAAGAAC	TCAAGACG
TAGAAGGC	TAGAAGAG
TCAAGAAG	TCAAGACG
TAGAAGGG	TAGAAGAG
TAGAAGGN	TAGAAGAG
TCAAGACA	TCAAGACG
TAGAAGTA	TAGAAGAG
TCAAGACC	TCAAGACG
TCAAGACG	TCAAGACG
TCAAGACT	TCAAGACG
TAGAAGTG	TAGAAGAG
TCAAGACN	TCAAGACG
TAGAAGTT	TAGAGGTT
TCAAGAGA	TCAAGACG
TCAAGAGC	TCAAGACG
TAGAAGNA	TAGAAGAG
TCAAGAGG	TCAAGACG
TAGAAGNG	TAGAAGAG
TCAAGAGT	TCAAGACG
TCAAGAGN	TCAAGACG
TCAAGATC	TCAAGACG
TAGAATAA	AAGAATAA
TCCTTGTA	TCTTTGTA
TAGAATAG	TAGAAGAG
TCAAGATG	TCAAGACG
TCAAGANC	TCAAGACG
TCAGACGA	TCAAGACG
TCAAGANG	TCAAGACG
TCAGACGC	TCAAGACG
TCAGACGG	TCAAGACG
TCAGACGT	TCAAGACG
TAGAATGA	TAGAAGAG
TCAAGCAC	TCAAGACG
TCAGACGN	TCAAGACG
TCAGACTT	TCAACTTC
TCAAGCCG	TCAAGACG
TCAAGCGA	TCAAGACG
TCCTTTGT	TCTTTGTA
TCAGAGAC	TCAAGACG
TACGAAAC	ACGAAACT
TAGAANAG	TAGAAGAG
TCAGAGGT	TAGAGGTT
TACGAAGA	TAGAAGAG
TCAGAGTC	CCAGAGTC
TCAAGCGC	TCAAGACG
TCAAGCGG	TCAAGACG
TCAAGCGT	TCAAGACG
TCAAGCGN	TCAAGACG
TAGAANGA	TAGAAGAG
TCAAGCTT	TCAACTTC
TCAGATAA	TTCAGATA
TCAGATAC	TTCAGATA
TCAGATAG	TTCAGATA
TCAGATAT	TTCAGATA
TCAGATAN	TTCAGATA
TCAAGGAC	TCAAGACG
TCAAGGCG	TCAAGACG
TAGACAGA	TAGAAGAG
TCAAGTAC	TCAAGACG
TACGAGGT	TAGAGGTT
TCCCCGCA	TACCCGCA
TCAAGTCG	TCAAGACG
TCAAGTTC	TCAACTTC
TACGATGG	TTCGATGG
TCAAGNAC	TCAAGACG
TCAAGNCG	TCAAGACG
TCCCCTTC	CCCCTTCA
TCTCACTA	CTCACTAC
TAGACGAG	TAGAAGAG
TAGACGGT	TAGAGGTT
TCTCAGAT	TTCAGATA
TACGCAGC	ACGCAGCC
TACGCATG	AACGCATG
TAGACGTT	TAGAGGTT
TAGACTCA	TAACTCAG
TACGCCCT	ACGCCCTA
TCAATACG	TCAAGACG
TACGCCGC	TACCCGCA
TACGCGCA	TACCCGCA
TACGCGCT	CACGCGCT
TCAATCGA	TAATCGAT
TCAATCTT	TCAACTTC
TCAATGAC	TCAAGACG
TCAGCTTC	TCAACTTC
TCAGCTTG	CAGCTTGC
TAGAGAAC	TTGAGAAC
TAGAGAGA	TAGAAGAG
TAGAGAGC	TAGAAGAG
TAGAGAGG	TAGAAGAG
TAGAGAGN	TAGAAGAG
TAGAGATT	TAGAGGTT
TCAATTCA	TCAACTTC
TCAATTCC	TCAACTTC
TCAATTCG	TCAACTTC
TCAATTCT	TCAACTTC
TCAATTCN	TCAACTTC
TAGAGCGT	TAGAGGTT
TCAATTTC	TCAACTTC
TAGAGCTT	TAGAGGTT
TAGAGGAG	TAGAAGAG
TAGAGGAT	TAGAGGTT
TCAGGACG	TCAAGACG
TCTGTGTA	TCTTTGTA
TAGAGGCT	TAGAGGTT
TAGAGGGT	TAGAGGTT
TAGAGGTA	TAGAGGTT
TAGAGGTC	TAGAGGTT
TAGAGGTG	TAGAGGTT
TAGAGGTT	TAGAGGTT
TAGAGGTN	TAGAGGTT
TATTTAGC	TTTTAGCC
TCTCGATG	TTCGATGG
TAGAGGNT	TAGAGGTT
TCAANACG	TCAAGACG
TCTGTTGT	TCTTTGTA
TCAGGGAC	TCCGGGAC
TCTGTTTA	TTGTTTAA
TAGAGTGT	TAGAGGTT
TAGAGTTA	TAGAGGTT
TCAGGGGA	TCGGGGGA
TCAGGGGG	TCGGGGGA
TCTCGGGA	TCCGGGAC
TATTTGTA	TCTTTGTA
TAGAGTTC	TAGAGGTT
TAGAGTTG	TAGAGGTT
TAGAGTTT	TAGAGGTT
TCTCGTTC	GCTCGTTC
TAGAGTTN	TAGAGGTT
TCAANCTT	TCAACTTC
TCAANGAC	TCAAGACG
TCTCTAGC	TGTCTAGC
TAGAGNGT	TAGAGGTT
TCTCTATA	TTCTATAC
TAGAGNTT	TAGAGGTT
TCAANTTC	TCAACTTC
TCTCTGTA	TCTTTGTA
TCTCTTGT	TCTTTGTA
TCACAAGT	ACACAAGT
TCACACTT	TCAACTTC
TCACAGAC	TCAAGACG
TCTTACGG	GCTTACGG
TCTTAGAC	TTTAGACA
TCCNGGAC	TCCGGGAC
TCTTAGCC	TTTTAGCC
TCCNGGGA	TCCGGGAC
TCTTAGTA	TCTTTGTA
TCACCCGC	TACCCGCA
TCTTATGT	TCTTTGTA
TCTTCCCA	CTTCCCAG
TCACCTTC	TCAACTTC
TCTGAGAA	TTGAGAAC
TCTGAGCA	ATCTGAGC
TCTGAGCC	ATCTGAGC
TCTGAGCG	ATCTGAGC
TCTGAGCT	ATCTGAGC
TCTTCGGC	TGTTCGGC
TANGAAGA	TAGAAGAG
TCTTCGTA	TCTTTGTA
TCACGACG	TCAAGACG
TCTGAGCN	ATCTGAGC
TCATACTT	TCAACTTC
TCATAGAC	TCAAGACG
TCTTCTGT	TCTTTGTA
TCTGATAA	CTGATAAA
TCACGCGC	CACGCGCT
TCATATCG	CATATCGG
TCACGGGA	TCCGGGAC
TCACGTGG	CACGTGGG
TANGAGGT	TAGAGGTT
TCTTGCGT	TTTGCGTC
TCTTGCTG	TTTGCTGA
TCTGCCTT	CTGCCTTT
TCTTGGTA	TCTTTGTA
TCGNGGGA	TCGGGGGA
TCTTGTAA	TCTTTGTA
TCTGCGTC	TTTGCGTC
TCGNGGGG	TCGGGGGA
TCTTGTAC	TCTTTGTA
TCTTGTAG	TCTTTGTA
TCTGCTGA	TTTGCTGA
TCTTGTAT	TCTTTGTA
TCTTGTAN	TCTTTGTA
TCGGNGGA	TCGGGGGA
TCGGNGGG	TCGGGGGA
TCTTGTGT	TCTTTGTA
TCTGGCGT	TTGGCGTA
TCTGGGAC	TCCGGGAC
TCTGGGGA	TCGGGGGA
TCTGGGGG	TCGGGGGA
TCGTAAAT	GCGTAAAT
TCTTTACC	GCTTTACC
TCTTTAGC	TTTTAGCC
TCTTTAGT	TCTTTGTA
TCTTTATA	TCTTTGTA
TCGTATTA	ACGTATTA
TCTTTCGT	TCTTTGTA
TCTTTCTA	TCTTTGTA
TCTTTGAA	TCTTTGTA
TCTTTGAC	TCTTTGTA
TCTTTGAG	TCTTTGTA
TCTTTGAT	TCTTTGTA
TCTTTGAN	TCTTTGTA
TCTTTGCA	TCTTTGTA
TCTTTGCT	TCTTTGTA
TCTTTGGA	TCTTTGTA
TCTTTGGT	TCTTTGTA
TCTTTGTA	TCTTTGTA
TCTTTGTC	TCTTTGTA
TCTTTGTG	TCTTTGTA
TCTTTGTT	TCTTTGTA
TCTTTGTN	TCTTTGTA
TCTTTGNA	TCTTTGTA
TCTTTGNT	TCTTTGTA
TCTTTTAA	TCTTTGTA
TCTTTTAC	TCTTTGTA
TCTTTTAG	TCTTTGTA
TCTTTTAT	TCTTTGTA
TCTTTTAN	TCTTTGTA
TCTTTTGT	TCTTTGTA
TCTTTTTA	TCTTTGTA
TCTTTNGT	TCTTTGTA
TCTTTNTA	TCTTTGTA
TCGCCACC	TGCCACCG
TCGTCTAG	TGTCTAGC
TCGCCCTA	ACGCCCTA
TCTTNGTA	TCTTTGTA
TCGTGGGA	TCGGGGGA
TCGTGGGG	TCGGGGGA
TCGTGTCC	CGTGTCCA
TCTAACTT	TCAACTTC
TCGCGACT	TGGCGACT
TCTAAGAC	TCAAGACG
TANAAGAG	TAGAAGAG
TCTTNTGT	TCTTTGTA
TCGTTAAC	GCGTTAAC
TCTAATTT	ACTAATTT
TCGTTCCA	CGTTCCAA
TCGTTCGG	TGTTCGGC
TCGCGGGG	TCGGGGGA
TCGCGGGT	TGCGGGTT
TCGTTGTA	TCTTTGTA
TCGTTTAA	TTGTTTAA
TCGTTTGT	TCTTTGTA
TCCCGCAA	TACCCGCA
TCCCGCAC	TACCCGCA
TCCCGCAG	TACCCGCA
TCCCGCAT	TACCCGCA
TCCCGCAN	TACCCGCA
TCNCGGGA	TCCGGGAC
TCTACGGT	CCTACGGT
TCCCGGAC	TCCGGGAC
TCTACTTC	TCAACTTC
TCCCGGGA	TCCGGGAC
TCTAGACA	TTTAGACA
TCTAGACG	TCAAGACG
TCTATACA	TTCTATAC
TCTATACC	TTCTATAC
TCTATACG	TTCTATAC
TCTATACT	TTCTATAC
TCTATACN	TTCTATAC
TGCAGATA	TTCAGATA
TCCCTCTA	ATCCCTCT
TCCCTCTC	ATCCCTCT
TCCCTCTG	ATCCCTCT
TCCCTCTT	ATCCCTCT
TCCCTCTN	ATCCCTCT
TGCAGGGT	TGCGGGTT
TGCAGGTT	TGCGGGTT
TCTATGTA	TCTTTGTA
TCCCTTCA	CCCCTTCA
TANTCGAT	TAATCGAT
TCTATTGT	TCTTTGTA
TCGGAGGA	TCGGGGGA
TCGGAGGG	TCGGGGGA
TGAATCGA	TAATCGAT
TGCAAAAT	GGCAAAAT
TGCAACCG	TGCCACCG
TGCATGGA	ATGCATGG
TGCATGGC	ATGCATGG
TGCATGGG	ATGCATGG
TGCATGGT	ATGCATGG
TGCATGGN	ATGCATGG
TGAATTTT	GAATTTTC
TGCAACTT	TCAACTTC
TGCAAGAC	TCAAGACG
TCCGAACA	CCGAACAT
TCGGCCAG	ACGGCCAG
TCGGCGAC	TGGCGACT
TGCACACC	TGCCACCG
TCGGCGGA	TCGGGGGA
TCGGCGGG	TCGGGGGA
TCGGCGTA	TTGGCGTA
TCCGAGAC	TCCGGGAC
TCCGAGGA	TCCGGGAC
TGAGCGAC	TGGCGACT
TGCACCGA	TGCCACCG
TGCACCGC	TGCCACCG
TGCACCGG	TGCCACCG
TGCACCGT	TGCCACCG
TGCACCGN	TGCCACCG
TCCGATGG	TTCGATGG
TCCGATTA	CCGATTAA
TCGAAACT	ACGAAACT
TGACACCG	TGCCACCG
TCGGGACA	TCCGGGAC
TCGGGACC	TCCGGGAC
TGCTTACG	GCTTACGG
TCGGGACG	TCCGGGAC
TCGGGACT	TCCGGGAC
TCGGGACN	TCCGGGAC
TCGGGAGA	TCGGGGGA
TCGGGAGG	TCGGGGGA
TGACAGTT	GACAGTTA
TGCCAACC	TGCCACCG
TCGAACAT	CCGAACAT
TGCCAACG	TGCCACCG
TGCTTCGG	TGTTCGGC
TGCCACAC	TGCCACCG
TGCCACAG	TGCCACCG
TCGAACTT	TCAACTTC
TCGAAGAC	TCAAGACG
TCGAAGAG	TAGAAGAG
TGCCACCA	TGCCACCG
TCCGCGAC	TCCGGGAC
TGCCACCC	TGCCACCG
TGCCACCG	TGCCACCG
TGCCACCT	TGCCACCG
TGCCACCN	TGCCACCG
TCGGGCGA	TCGGGGGA
TGCCACGA	TGCCACCG
TGCCACGC	TGCCACCG
TCGGGCGG	TCGGGGGA
TGCCACGG	TGCCACCG
TGCCACGT	TGCCACCG
TCCGCGGA	TCCGGGAC
TGCCACGN	TGCCACCG
TGCCACTC	TGCCACCG
TGTCTAAC	TGTCTAGC
TGCCACTG	TGCCACCG
TGTCTAAG	TGTCTAGC
TGTCTACA	TGTCTAGC
TGCTTTAC	GCTTTACC
TGCCACNC	TGCCACCG
TGTCTACC	TGTCTAGC
TGCCACNG	TGCCACCG
TGTCTACG	TGTCTAGC
TGTCTACT	TGTCTAGC
TGTCTACN	TGTCTAGC
TGTCTAGA	TGTCTAGC
TGTCTAGC	TGTCTAGC
TGTCTAGG	TGTCTAGC
TGTCTAGT	TGTCTAGC
TGTCTAGN	TGTCTAGC
TGTCTATA	TTCTATAC
TGTCTATC	TGTCTAGC
TGTCTATG	TGTCTAGC
TGCTTTGT	TCTTTGTA
TCGGGGAA	TCGGGGGA
TGTCTANC	TGTCTAGC
TCGGGGAG	TCGGGGGA
TGTCTANG	TGTCTAGC
TCGGGGAT	TCGGGGGA
TCGGGGAN	TCGGGGGA
TGACCACC	TGCCACCG
TCGGGGCA	TCGGGGGA
TCGGGGCG	TCGGGGGA
TCGGGGGA	TCGGGGGA
TCGGGGGC	TCGGGGGA
TGCCAGCC	TGCCACCG
TCGGGGGG	TCGGGGGA
TGCCAGCG	TGCCACCG
TCGGGGGT	TCGGGGGA
TCGGGGGN	TCGGGGGA
TGTCTCAG	TGTCTAGC
TCGGGGTA	TCGGGGGA
TCGGGGTG	TCGGGGGA
TCGGGGNA	TCGGGGGA
TCGGGGNG	TCGGGGGA
TGTCTCGC	TGTCTAGC
TGTCTCGG	TGTTCGGC
TGACCCGC	TACCCGCA
TGTCTGAG	TGTCTAGC
TGAGGGTT	TGCGGGTT
TGTCTGCA	TGTCTAGC
TCGGGTGA	TCGGGGGA
TGTCTGCC	TGTCTAGC
TCGGGTGG	TCGGGGGA
TGTCTGCG	TGTCTAGC
TGTCTGCT	TGTCTAGC
TGTCTGCN	TGTCTAGC
TCGGGTTA	TGCGGGTT
TGTCTGGC	TGTCTAGC
TCGGGTTG	TGCGGGTT
TCGGGTTT	TGCGGGTT
TCGGGTTN	TGCGGGTT
TGAGGTTA	TAGAGGTT
TGAGGTTC	TAGAGGTT
TGTCTTAG	TGTCTAGC
TGAGGTTG	TAGAGGTT
TGAGGTTT	TAGAGGTT
TGAGGTTN	TAGAGGTT
TCGGGNGA	TCGGGGGA
TCGGGNGG	TCGGGGGA
TGTCTTGC	TGTCTAGC
TGCCATCC	TGCCACCG
TGCCATCG	TGCCACCG
TCCGGAAC	TCCGGGAC
TCCGGACA	TCCGGGAC
TCCGGACC	TCCGGGAC
TCCGGACG	TCCGGGAC
TCCGGACT	TCCGGGAC
TCCGGACN	TCCGGGAC
TCCGGAGA	TCCGGGAC
TCCGGCAC	TCCGGGAC
TCCGGCGA	TCCGGGAC
TGTCTNAG	TGTCTAGC
TGCCANCC	TGCCACCG
TGCCANCG	TGCCACCG
TGACGACT	TGGCGACT
TCCGGGAA	TCCGGGAC
TCCGGGAC	TCCGGGAC
TGTCTNGC	TGTCTAGC
TCCGGGAG	TCCGGGAC
TCCGGGAT	TCCGGGAC
TCCGGGAN	TCCGGGAC
TCCGGGCA	TCCGGGAC
TCCGGGCC	TCCGGGAC
TCCGGGCG	TCCGGGAC
TCCGGGCT	TCCGGGAC
TCCGGGCN	TCCGGGAC
TGCNACCG	TGCCACCG
TCCGGGGC	TCCGGGAC
TCCGGGGG	TCGGGGGA
TCCGGGTA	TCCGGGAC
TCCGGGTC	TCCGGGAC
TCCGGGTT	TGCGGGTT
TGCCCACC	TGCCACCG
TCCGGGNA	TCCGGGAC
TCCGGGNC	TCCGGGAC
TGCCCAGT	GCCCAGTC
TCCGGTAC	TCCGGGAC
TGTCNAGC	TGTCTAGC
TCCGGTGA	TCCGGGAC
TCCGGTTG	ACCGGTTG
TCGGTGGA	TCGGGGGA
TGCCCCCG	TGCCACCG
TGACGCTG	CGACGCTG
TCGGTGGG	TCGGGGGA
TGCCCCGA	TGCCACCG
TCCGGNAC	TCCGGGAC
TGCCCCGC	TGCCACCG
TGCCCCGG	TGCCACCG
TGCCCCGT	TGCCACCG
TGCCCCGN	TGCCACCG
TCCGGNGA	TCCGGGAC
TCGACGCT	CGACGCTG
TGTCNTAG	TGTCTAGC
TGCCCGCA	TACCCGCA
TGACGGGT	TGCGGGTT
TGCNCACC	TGCCACCG
TCGACTTC	TCAACTTC
TGTGAGAA	TTGAGAAC
TCCGTGAC	TCCGGGAC
TCCGTGGA	TCCGGGAC
TCGAGAAC	TTGAGAAC
TGATAAAA	CTGATAAA
TGATAAAC	CTGATAAA
TGATAAAG	CTGATAAA
TGATAAAT	CTGATAAA
TGATAAAN	CTGATAAA
TCGAGACG	TCAAGACG
TGACTAGC	TGTCTAGC
TGCCGACC	TGCCACCG
TGCCGACT	TGGCGACT
TGCNGGGT	TGCGGGTT
TGACTCAG	TAACTCAG
TGCNGGTT	TGCGGGTT
TGATATCA	GATATCAT
TGCCGCCG	TGCCACCG
TGTGCGAC	TGGCGACT
TGTGCGGC	TGTTCGGC
TGTGCGTC	TTTGCGTC
TGTGCTAG	TGTCTAGC
TGCCGGGA	TCCGGGAC
TGCCGGGT	TGCGGGTT
TCCGNGAC	TCCGGGAC
TGTGCTGA	TTTGCTGA
TGCCGGTT	TGCGGGTT
TCGAGGGA	TCGGGGGA
TCGAGGGG	TCGGGGGA
TCCGNGGA	TCCGGGAC
TCGAGGTT	TAGAGGTT
TGATCGAT	TAATCGAT
TGATCGGC	TGTTCGGC
TGATCTAG	TGTCTAGC
TGTGGCGT	TTGGCGTA
TGTGGGTT	TGCGGGTT
TGATGAAC	GGATGAAC
TGCCTACC	TGCCACCG
TGCCTAGC	TGTCTAGC
TGCCTCCG	TGCCACCG
TGTGTAGC	TGTCTAGC
TGAGAACA	TTGAGAAC
TCGATGGA	TTCGATGG
TGAGAACC	TTGAGAAC
TCGATGGC	TTCGATGG
TCGATGGG	TTCGATGG
TGAGAACG	TTGAGAAC
TCGATGGT	TTCGATGG
TGAGAACT	TTGAGAAC
TCGATGGN	TTCGATGG
TGAGAACN	TTGAGAAC
TGAGAAGA	TAGAAGAG
TGTGTCCA	CGTGTCCA
TGTGTCGG	TGTTCGGC
TCGATTAA	CCGATTAA
TGCCTTTA	CTGCCTTT
TGCCTTTC	CTGCCTTT
TGCCTTTG	CTGCCTTT
TGCCTTTT	CTGCCTTT
TGCCTTTN	CTGCCTTT
TGCCNACC	TGCCACCG
TGCCNCCG	TGCCACCG
TGTGTTTA	TTGTTTAA
TGTGTTTC	GGTGTTTC
TGAGAGGT	TAGAGGTT
TGTTCAGC	TGTTCGGC
TGTTCAGG	TGTTCGGC
TGGTGACT	TGGCGACT
TGTTCCAA	CGTTCCAA
TGATTCGG	TGTTCGGC
TGTTCCGC	TGTTCGGC
TGTTCCGG	TGTTCGGC
TGTTCGAC	TGTTCGGC
TGTTCGAG	TGTTCGGC
TGTTCGCA	TGTTCGGC
TGTTCGCC	TGTTCGGC
TGTTCGCG	TGTTCGGC
TGTTCGCT	TGTTCGGC
TGTTCGCN	TGTTCGGC
TGTTCGGA	TGTTCGGC
TGTTCGGC	TGTTCGGC
TGTTCGGG	TGTTCGGC
TGTTCGGT	TGTTCGGC
TGTTCGGN	TGTTCGGC
TGTTCGTC	TGTTCGGC
TGTTCGTG	TGTTCGGC
TGTTCGNC	TGTTCGGC
TGTTCGNG	TGTTCGGC
TGTTCTAG	TGTCTAGC
TGTTCTGC	TGTTCGGC
TGTTCTGG	TGTTCGGC
TCTNTGTA	TCTTTGTA
TGGAAAAG	GGAAAAGA
TGTTCNGC	TGTTCGGC
TGTTCNGG	TGTTCGGC
TGGTGTTT	GGTGTTTC
TCTNTTGT	TCTTTGTA
TGGAAGAG	TAGAAGAG
TGGTTCGG	TGTTCGGC
TGTTGCGG	TGTTCGGC
TGTTGCGT	TTTGCGTC
TGTTGCTG	TTTGCTGA
TGGTTTAA	TTGTTTAA
TGTTGGCA	TGTTCGGC
TGTTGGCC	TGTTCGGC
TGTTGGCG	TGTTCGGC
TGTTGGCT	TGTTCGGC
TGTTGGCN	TGTTCGGC
TGTTGGGC	TGTTCGGC
TGTTGTAT	GTTGTATT
TGNCGACT	TGGCGACT
TGAAAAAG	GAAAAAGC
TGAAAAGA	GGAAAAGA
TGTTACGG	TGTTCGGC
TGTTAGAC	TTTAGACA
TGTTTAAA	TTGTTTAA
TGNCGGGT	TGCGGGTT
TGTTAGCG	TGTCTAGC
TGTTAGCT	TGTCTAGC
TGTTAGCN	TGTCTAGC
TGTTAGGC	TGTTCGGC
TGAAAGTA	GAAAGTAC
TGTTTAAC	TTGTTTAA
TGTTTAAG	TTGTTTAA
TGTTTAAT	TTGTTTAA
TGTTTAAN	TTGTTTAA
TGAAATAG	GAAATAGG
TCGCAGCC	ACGCAGCC
TGTACCCG	GTACCCGG
TGTTTCGG	TGTTCGGC
TGTACGGC	TGTTCGGC
TGTACTAG	TGTCTAGC
TGNCTAGC	TGTCTAGC
TGTTTGGC	TGTTCGGC
TGAACTCA	TAACTCAG
TGTTTGTA	TCTTTGTA
TGAACTTC	TCAACTTC
TGTAGAAC	GTAGAACC
TGTAGACA	TTTAGACA
TCNAACTT	TCAACTTC
TCNAAGAC	TCAAGACG
TGAAGACG	TCAAGACG
TGAAGAGA	TAGAAGAG
TGAAGAGC	TAGAAGAG
TGAAGAGG	TAGAAGAG
TGAAGAGT	TAGAAGAG
TGAAGAGN	TAGAAGAG
TGTTNCGG	TGTTCGGC
TGTTNGGC	TGTTCGGC
TCNGGGAC	TCCGGGAC
TCNGGGGA	TCGGGGGA
TCNGGGGG	TCGGGGGA
TGGNCGAC	TGGCGACT
TGTATACG	GTATACGA
TGTATAGC	TGTCTAGC
TGTATCGG	TGTTCGGC
TGGCNACT	TGGCGACT
TGGNGACT	TGGCGACT
TGGCNGAC	TGGCGACT
TCNACTTC	TCAACTTC
TGTNCGGC	TGTTCGGC
TGTNCTAG	TGTCTAGC
TCNAGACG	TCAAGACG
TGGGACCC	GGGACCCG
TGGGACTA	TGGCGACT
TGGGACTC	TGGCGACT
TGGGACTG	TGGCGACT
TGGGACTT	TGGCGACT
TGGGACTN	TGGCGACT
TGTCAAGC	TGTCTAGC
TGTNTAGC	TGTCTAGC
TGTCACCG	TGCCACCG
TGNGCGAC	TGGCGACT
TGTCAGAT	TTCAGATA
TGTNTCGG	TGTTCGGC
TGTCAGCA	TGTCTAGC
TGTCAGCC	TGTCTAGC
TGTCAGCG	TGTCTAGC
TGTCAGCT	TGTCTAGC
TGTCAGCN	TGTCTAGC
TGTCATAG	TGTCTAGC
TGCGACCG	TGCCACCG
TGGGCGAC	TGGCGACT
TGCGACTA	TGGCGACT
TGCGACTC	TGGCGACT
TGCGACTG	TGGCGACT
TGCGACTT	TGGCGACT
TTACCCGC	TACCCGCA
TGCGACTN	TGGCGACT
TTACCCGG	GTACCCGG
TGGGCGTA	TTGGCGTA
TGCGAGGT	TGCGGGTT
TGCGAGTT	TGCGGGTT
TGCGATGG	TTCGATGG
TGTCCACC	TGCCACCG
TGTCCAGC	TGTCTAGC
TGCGCACC	TGCCACCG
TGGGGACT	TGGCGACT
TGNGGGTT	TGCGGGTT
TTACGATG	TTCGATGG
TGCGCGAC	TGGCGACT
TGCGCGGT	TGCGGGTT
TGCGCGTT	TGCGGGTT
TGGGGGAA	TCGGGGGA
TGGGGGAC	TCGGGGGA
TGGGGGAG	TCGGGGGA
TGGGGGAT	TCGGGGGA
TGGGGGAN	TCGGGGGA
TGGGGGGA	TCGGGGGA
TGGGGGTT	TGCGGGTT
TGTCCGGC	TGTTCGGC
TGTCCTAG	TGTCTAGC
TGGGGTTA	TGCGGGTT
TGGGGTTC	TGCGGGTT
TGGGGTTG	TGCGGGTT
TGGGGTTT	TGCGGGTT
TGGGGTTN	TGCGGGTT
TGCGGAGT	TGCGGGTT
TTCAAATA	TTCAGATA
TTACTATA	TTCTATAC
TGCGGATT	TGCGGGTT
TTCCACCG	TGCCACCG
TTACTCAG	TAACTCAG
TGCGGCGT	TGCGGGTT
TGTCGACT	TGGCGACT
TGTCGAGC	TGTCTAGC
TGCGGCTT	TGCGGGTT
TTCAACTT	TCAACTTC
TGTCGATG	TTCGATGG
TGCGGGAC	TCCGGGAC
TGCGGGAT	TGCGGGTT
TTCCAGAT	TTCAGATA
TGCGGGCT	TGCGGGTT
TGCGGGGG	TCGGGGGA
TGCGGGGT	TGCGGGTT
TGCGGGTA	TGCGGGTT
TGCGGGTC	TGCGGGTT
TGCGGGTG	TGCGGGTT
TGCGGGTT	TGCGGGTT
TGCGGGTN	TGCGGGTT
TGCGGGNT	TGCGGGTT
TTCCATAC	TTCTATAC
TTCAAGAC	TCAAGACG
TTCAAGAT	TTCAGATA
TGCGGTGT	TGCGGGTT
TGCGGTTA	TGCGGGTT
TGCGGTTC	TGCGGGTT
TGCGGTTG	TGCGGGTT
TGCGGTTT	TGCGGGTT
TGCGGTTN	TGCGGGTT
TTCCATGG	TTCGATGG
TTCAATAA	TTCAGATA
TTCAATAG	TTCAGATA
TGCGGNGT	TGCGGGTT
TTCAATAT	TTCAGATA
TGGGTTCG	CGGGTTCG
TTCAATAN	TTCAGATA
TGCGGNTT	TGCGGGTT
TGTCGGCA	TGTTCGGC
TGTCGGCC	TGTTCGGC
TGTCGGCG	TGTTCGGC
TGTCGGCT	TGTTCGGC
TGTCGGCN	TGTTCGGC
TGTCGGGT	TGCGGGTT
TTCAATGG	TTCGATGG
TGCGTAAA	GCGTAAAT
TGTCGTAG	TGTCTAGC
TCNTTGTA	TCTTTGTA
TTCACATA	TTCAGATA
TGCGTGGT	TGCGGGTT
TTCCCAGA	CTTCCCAG
TTCCCAGC	CTTCCCAG
TGCGTGTT	TGCGGGTT
TTCCCAGG	CTTCCCAG
TTCCCAGT	CTTCCCAG
TTCCCAGN	CTTCCCAG
TGCGTTAA	GCGTTAAC
TTCACGAT	TTCAGATA
TTCACTAC	CTCACTAC
TCNTTTGT	TCTTTGTA
TTCCCGCA	TACCCGCA
TTCAGAAA	TTCAGATA
TTCAGAAG	TTCAGATA
TTCAGAAT	TTCAGATA
TTCAGAAN	TTCAGATA
TTAGAACA	TTGAGAAC
TTAGAACG	TTGAGAAC
TTAGAACT	TTGAGAAC
TTAGAACN	TTGAGAAC
TTAGAAGA	TAGAAGAG
TTCCCTCT	ATCCCTCT
TTATACGA	GTATACGA
TTAGACAA	TTTAGACA
TTCAGACT	TTCAGATA
TTAGACAC	TTTAGACA
TTCAGAGA	TTCAGATA
TTAGACAG	TTTAGACA
TTAGACAT	TTTAGACA
TTAGACAN	TTTAGACA
TTCAGAGT	TTCAGATA
TTCAGATA	TTCAGATA
TTCAGATC	TTCAGATA
TTCAGATT	TTCAGATA
TTCAGATN	TTCAGATA
TTCAGANA	TTCAGATA
TTCAGANT	TTCAGATA
TTCAGCAT	TTCAGATA
TTAGAGAA	TTGAGAAC
TGCGNGGT	TGCGGGTT
TGCGNGTT	TGCGGGTT
TTATAGAC	TTTAGACA
TTAGAGGT	TAGAGGTT
TTATAGCC	TTTTAGCC
TTCAGCTA	TTCAGATA
TTCAGGAT	TTCAGATA
TTCCGATA	TTCAGATA
TTCCGATG	TTCGATGG
TTCAGGTA	TTCAGATA
TTCAGTAA	TTCAGATA
TTCAGTAC	TTCAGATA
TTCAGTAG	TTCAGATA
TTCAGTAT	TTCAGATA
TTCAGTAN	TTCAGATA
TTAGATAA	TTCAGATA
TTAGATAC	TTCAGATA
TTAGATAG	TTCAGATA
TTAGATAT	TTCAGATA
TTAGATAN	TTCAGATA
TTATATAC	TTCTATAC
TGGACATT	AGGACATT
TTCAGTTA	TTCAGATA
TGGACCCG	GGGACCCG
TTCAGNAT	TTCAGATA
TTAGATGG	TTCGATGG
TTCCGGGA	TCCGGGAC
TTCAGNTA	TTCAGATA
TGGACGAC	TGGCGACT
TTCATACA	TTCTATAC
TTCATACC	TTCTATAC
TTCATACG	TTCTATAC
TGCTACCG	TGCCACCG
TTCATACT	TTCTATAC
TTCATACN	TTCTATAC
TTCNGATA	TTCAGATA
TTCNGATG	TTCGATGG
TGCTAGCA	TGTCTAGC
TGCTAGCC	TGTCTAGC
TGCTAGCG	TGTCTAGC
TGCTAGCT	TGTCTAGC
TGGTCCGA	ATGGTCCG
TGGTCCGC	ATGGTCCG
TGCTAGCN	TGTCTAGC
TGGTCCGG	ATGGTCCG
TGGTCCGT	ATGGTCCG
TGGTCCGN	ATGGTCCG
TGGTCGAC	TGGCGACT
TGCTATAC	TTCTATAC
TGGTCGGC	TGTTCGGC
TTCATGAT	TTCAGATA
TTCATGGA	TTCGATGG
TTCATGGC	TTCGATGG
TTCATGGG	TTCGATGG
TTCATGGT	TTCGATGG
TTCATGGN	TTCGATGG
TGGTCTAG	TGTCTAGC
TGGAGAAC	TTGAGAAC
TTCCTATA	TTCTATAC
TTAGCAAA	GTTAGCAA
TTAGCAAC	GTTAGCAA
TTAGCAAG	GTTAGCAA
TTAGCAAT	GTTAGCAA
TTAGCAAN	GTTAGCAA
TGGAGACT	TGGCGACT
TTCCTGGC	ATCCTGGC
TGCTCACC	TGCCACCG
TTCANATA	TTCAGATA
TGGAGGTT	TAGAGGTT
TTCNTATA	TTCTATAC
TTAGCGTA	TTGGCGTA
TTAGCGTC	TTTGCGTC
TTCANGAT	TTCAGATA
TGCTCGGC	TGTTCGGC
TTAGCTGA	TTTGCTGA
TGCTCGTT	GCTCGTTC
TGCTCTAG	TGTCTAGC
TGGATGAA	GGATGAAC
TTATCGAT	TAATCGAT
TTAGGCGT	TTGGCGTA
TTCGAAGG	TTCGATGG
TTCGAATG	TTCGATGG
TTATCTCT	ATATCTCT
TTTGCAGA	TTTGCTGA
TTCGACGG	TTCGATGG
TTTGCAGT	TTTGCGTC
TTTGCATC	TTTGCGTC
TTCGACTG	TTCGATGG
TTTGCATG	TTTGCTGA
TTGAAAAC	TTGAGAAC
TTCGAGAA	TTGAGAAC
TTGAAACA	TTGAGAAC
TTGAAACC	TTGAGAAC
TTCGAGAT	TTCAGATA
TTGAAACG	TTGAGAAC
TTGAAACT	TTGAGAAC
TTGAAACN	TTGAGAAC
TTCGAGGA	TTCGATGG
TTCGAGGC	TTCGATGG
TTCGAGGG	TTCGATGG
TTCGAGGT	TTCGATGG
TTCGAGGN	TTCGATGG
TTCGAGTG	TTCGATGG
TTCGATAA	TTCAGATA
TTCGATAT	TTCAGATA
TTCGATAN	TTCAGATA
TTCGATCG	TTCGATGG
TTCGATGA	TTCGATGG
TTCGATGC	TTCGATGG
TTCGATGG	TTCGATGG
TTCGATGT	TTCGATGG
TTGAAGAA	TTGAGAAC
TTGAAGAG	TAGAAGAG
TTTGCCGA	TTTGCTGA
TTTGCCGT	TTTGCGTC
TTTGCCTC	TTTGCGTC
TTTGCCTG	TTTGCTGA
TTCGATGN	TTCGATGG
TTCGATTG	TTCGATGG
TTTGCGAA	TTTGCTGA
TTCGATNG	TTCGATGG
TTTGCGAG	TTTGCTGA
TTTGCGAN	TTTGCTGA
TTTGCGCA	TTTGCGTC
TTTGCGCC	TTTGCGTC
TTTGCGCG	TTTGCGTC
TTTGCGCT	TTTGCGTC
TTTGCGCN	TTTGCGTC
TTTGCGGA	TTTGCTGA
TTTGCGGC	TTTGCGTC
TTTGCGGT	TTTGCGTC
TTTGCGTC	TTTGCGTC
TTCGANGG	TTCGATGG
TTTGCGTT	TTTGCGTC
TTTGCGTN	TTTGCGTC
TTTGCGNC	TTTGCGTC
TTCGANTG	TTCGATGG
TTTGCGNT	TTTGCGTC
TTTGCTAA	TTTGCTGA
TTTGCTAC	TTTGCTGA
TTTGCTAG	TTTGCTGA
TTTGCTAT	TTTGCTGA
TTTGCTAN	TTTGCTGA
TTTGCTCC	TTTGCGTC
TTTGCTCT	TTTGCGTC
TTTGCTCN	TTTGCGTC
TTTGCTGA	TTTGCTGA
TGGCAAAA	GGCAAAAT
TTTGCTGC	TTTGCTGA
TTTGCTGG	TTTGCTGA
TTATGCGT	TTTGCGTC
TTTGCTGN	TTTGCTGA
TTTGCTTA	TTTGCTGA
TTTGCTTC	TTTGCGTC
TTATGCTG	TTTGCTGA
TTTGCTTG	TTTGCTGA
TGGCAACT	TGGCGACT
TTTGCTNA	TTTGCTGA
TTGACAAC	TTGAGAAC
TTTGCTNG	TTTGCTGA
TTTGCNGA	TTTGCTGA
TTTGCNGT	TTTGCGTC
TTTGCNTC	TTTGCGTC
TGGCACCG	TGCCACCG
TTTGCNTG	TTTGCTGA
TGCTGGGT	TGCGGGTT
TTCGCATG	TTCGATGG
TGCTGGTT	TGCGGGTT
TGGCACTA	TGGCGACT
TTAGTTTA	TTGTTTAA
TGGCACTC	TGGCGACT
TGGCACTG	TGGCGACT
TGGCACTT	TGGCGACT
TGGCACTN	TGGCGACT
TTTGGACA	TTTAGACA
TGGCAGAC	TGGCGACT
TTGACGAA	TTGAGAAC
TTAAAGTC	ATAAAGTC
TTGACGTA	TTGGCGTA
TTCGCGTA	TTGGCGTA
TTCGCGTC	TTTGCGTC
TTTGGCTG	TTTGCTGA
TTCGCTGA	TTTGCTGA
TTCGCTGG	TTCGATGG
TTTGGGTC	TTTGCGTC
TTGAGAAA	TTGAGAAC
TTGAGAAC	TTGAGAAC
TTGAGAAG	TTGAGAAC
TTGAGAAT	TTGAGAAC
TTGAGAAN	TTGAGAAC
TTTGGTCA	TTTGCGTC
TTGAGACC	TTGAGAAC
TTGAGACG	TTGAGAAC
TTGAGACT	TTGAGAAC
TGGCCACC	TGCCACCG
TTGAGACN	TTGAGAAC
TTGAGAGA	TTGAGAAC
TTGAGAGC	TTGAGAAC
TGGCCACT	TGGCGACT
TTGNAGAA	TTGAGAAC
TTGAGATC	TTGAGAAC
TTTGGTCC	TTTGCGTC
TTTGGTCG	TTTGCGTC
TTTGGTCT	TTTGCGTC
TTTGGTCN	TTTGCGTC
TTTGGTGA	TTTGCTGA
TTGAGANA	TTGAGAAC
TTGAGANC	TTGAGAAC
TTGAGCAA	TTGAGAAC
TTGAGCAC	TTGAGAAC
TTCGGATA	TTCAGATA
TTCGGATG	TTCGATGG
TTGAGCGT	TTGGCGTA
TTGAGGAA	TTGAGAAC
TTGAGGAC	TTGAGAAC
TGGCCGAC	TGGCGACT
TGGCCGCC	AGGCCGCC
TTCGGCGT	TTGGCGTA
TTGAGGTT	TAGAGGTT
TTCGGGAC	TCCGGGAC
TTGAGTAA	TTGAGAAC
TTATTAGC	TTTTAGCC
TTGAGTAC	TTGAGAAC
TTCGGGGG	TCGGGGGA
TTCGGGTT	TGCGGGTT
TTGAGNAA	TTGAGAAC
TTGAGNAC	TTGAGAAC
TTCGGTGG	TTCGATGG
TTTGTAGC	TTTTAGCC
TTTGTATT	GTTGTATT
TTGATAAA	CTGATAAA
TTGATAAC	TTGAGAAC
TGGCGAAC	TGGCGACT
TGGCGAAT	TGGCGACT
TGGCGACA	TGGCGACT
TGGCGACC	TGGCGACT
TGGCGACG	TGGCGACT
TGGCGACT	TGGCGACT
TGGCGACN	TGGCGACT
TTTGTCGT	TTTGCGTC
TGGCGAGC	TGGCGACT
TGGCGAGT	TGGCGACT
TTTGTCTG	TTTGCTGA
TGGCGATA	TGGCGACT
TGGCGATC	TGGCGACT
TGGCGATG	TGGCGACT
TGGCGATT	TGGCGACT
TGGCGATN	TGGCGACT
TGGCGANC	TGGCGACT
TTTGTGAA	TTTGCTGA
TGGCGANT	TGGCGACT
TTTGTGAC	TTTGCTGA
TTTGTGAG	TTTGCTGA
TTTGTGAT	TTTGCTGA
TTTGTGAN	TTTGCTGA
TGGCGCAC	TGGCGACT
TTTTNAGC	TTTTAGCC
TGGCGCCT	TGGCGACT
TTTGTGTC	TTTGCGTC
TTGNCGTA	TTGGCGTA
TGGCGCTA	TGGCGACT
TGGCGCTC	TGGCGACT
TGGCGCTG	TGGCGACT
TGGCGCTT	TGGCGACT
TGGCGCTN	TGGCGACT
TGGCGGAC	TGGCGACT
TTTGTTGA	TTTGCTGA
TGGCGGCT	TGGCGACT
TTTGTTTA	TTGTTTAA
TGGCGGGT	TGCGGGTT
TTGATGAA	TTGAGAAC
TTATTTAA	TTGTTTAA
TGGCGTAA	TTGGCGTA
TGGCGTAG	TTGGCGTA
TGGCGTAT	TTGGCGTA
TTTTNGCC	TTTTAGCC
TGGCGTAN	TTGGCGTA
TGGCGTCT	TGGCGACT
TTGATGGA	TTCGATGG
TTGATGGC	TTCGATGG
TTGATGGG	TTCGATGG
TTGATGGT	TTCGATGG
TTGATGGN	TTCGATGG
TTGATTAA	TTGTTTAA
TGGCGNAC	TGGCGACT
TTAACTCA	TAACTCAG
TGGCGNCT	TGGCGACT
TTGATTTA	TTGTTTAA
TTAACTTC	TCAACTTC
TTGNGAAC	TTGAGAAC
TGGCTACT	TGGCGACT
TGGCTAGC	TGTCTAGC
TTTGNCGT	TTTGCGTC
TTTGNCTG	TTTGCTGA
TTAAGAAC	TTGAGAAC
TTAAGACA	TTTAGACA
TTAAGACG	TCAAGACG
TTAAGATA	TTCAGATA
TTTGNGTC	TTTGCGTC
TGGCTGAC	TGGCGACT
TTGNGCGT	TTGGCGTA
TTTGNTGA	TTTGCTGA
TTTNAGAC	TTTAGACA
TTNGAGAA	TTGAGAAC
TTTNAGCC	TTTTAGCC
TTTTAACC	TTTTAGCC
TTTTAAGC	TTTTAGCC
TTNGATGG	TTCGATGG
TTTTACCA	TTTTAGCC
TTTTACCC	TTTTAGCC
TTTTACCG	TTTTAGCC
TTTTACCT	TTTTAGCC
TTTTACCN	TTTTAGCC
TTTTACGC	TTTTAGCC
TTAATCGA	TAATCGAT
TTTTAGCA	TTTTAGCC
TTTTAGCC	TTTTAGCC
TTTTAGCG	TTTTAGCC
TTTTAGCT	TTTTAGCC
TTTTAGCN	TTTTAGCC
TTTTAGGC	TTTTAGCC
TTTTAGTC	TTTTAGCC
TTTTAGNC	TTTTAGCC
TTTNCGTC	TTTGCGTC
TTTTATAC	TTCTATAC
TTGNTTAA	TTGTTTAA
TTTNCTGA	TTTGCTGA
TTGNTTTA	TTGTTTAA
TTTTATCC	TTTTAGCC
TTTTATGC	TTTTAGCC
TTTNGACA	TTTAGACA
TTNGCGTA	TTGGCGTA
TTNGCGTC	TTTGCGTC
TTTTANCC	TTTTAGCC
TTTTANGC	TTTTAGCC
TTNGCTGA	TTTGCTGA
TTTNGCGT	TTTGCGTC
TTTNGCTG	TTTGCTGA
TTTTCAGC	TTTTAGCC
TGNTCGGC	TGTTCGGC
TTTTCGCC	TTTTAGCC
TTTTCGGC	TGTTCGGC
TTTTCGTC	TTTGCGTC
TGNTCTAG	TGTCTAGC
TTTNTAGC	TTTTAGCC
TTTAAACA	TTTAGACA
TTTTCTGA	TTTGCTGA
TTNGGCGT	TTGGCGTA
TTTAACAA	TTTAGACA
TTTAACAC	TTTAGACA
TTTAACAG	TTTAGACA
TTTAACAT	TTTAGACA
TTTAACAN	TTTAGACA
TTTTGACA	TTTAGACA
TTTAAGAC	TTTAGACA
TTTTGAGC	TTTTAGCC
TTTAAGCC	TTTTAGCC
TTTTGCCA	TTTTAGCC
TTTTGCCC	TTTTAGCC
TTTTGCCG	TTTTAGCC
TTTTGCCT	TTTTAGCC
TTTTGCCN	TTTTAGCC
TTTTGCGT	TTTGCGTC
TTTTGCTG	TTTGCTGA
TTTTGGCC	TTTTAGCC
TTACAGAT	TTCAGATA
TTTTGTAA	TCTTTGTA
TTTTGTAC	TCTTTGTA
TTTTGTAG	TCTTTGTA
TTTTGTAT	TCTTTGTA
TTTTGTAN	TCTTTGTA
TTTACACA	TTTAGACA
TTTTTAAA	TTGTTTAA
TTTTTAAC	TTGTTTAA
TTTTTAAG	TTGTTTAA
TTTTTAAT	TTGTTTAA
TTTTTAAN	TTGTTTAA
TTTTTAGC	TTTTAGCC
TTGGGAAC	TTGAGAAC
TTTTTGCC	TTTTAGCC
TTTTTGTA	TCTTTGTA
TGNTTCGG	TGTTCGGC
TTNGTTTA	TTGTTTAA
TTTTTTAA	TTGTTTAA
TTTATACC	TTCTATAC
TTTATACG	TTCTATAC
TTTATACT	TTCTATAC
TTTATACN	TTCTATAC
TTTATAGC	TTTTAGCC
TTTACGAC	TTTAGACA
TTGGGCGT	TTGGCGTA
TTTATGAC	TTTAGACA
TTTACGTC	TTTGCGTC
TTGGGGGA	TCGGGGGA
TTGGGGTA	TTGGCGTA
TTGGGTAA	TTGGCGTA
TTGGGTAC	TTGGCGTA
TTGGGTAG	TTGGCGTA
TTGGGTAT	TTGGCGTA
TTTACTGA	TTTGCTGA
TTGGGTAN	TTGGCGTA
TTTAGAAA	TTTAGACA
TTTAGAAG	TTTAGACA
TTTAGAAT	TTTAGACA
TTTAGAAN	TTTAGACA
TTTAGACA	TTTAGACA
TTTAGACC	TTTAGACA
TTTAGACG	TTTAGACA
TTTAGACT	TTTAGACA
TTTAGACN	TTTAGACA
TTTAGAGA	TTTAGACA
TTTAGAGC	TTTAGACA
TTTAGATC	TTTAGACA
TTTAGANA	TTTAGACA
TTTAGANC	TTTAGACA
TTTAGCAC	TTTAGACA
TTTAGCAG	TTTAGACA
TTTAGCAT	TTTAGACA
TTTAGCAN	TTTAGACA
TNCAACTT	TCAACTTC
TTTAGCCC	TTTTAGCC
TTTAGCCG	TTTTAGCC
TTTAGCCT	TTTTAGCC
TTTAGCCN	TTTTAGCC
TTTAGCGT	TTTGCGTC
TTTAGCTG	TTTGCTGA
TNCAAGAC	TCAAGACG
TTTAGGAC	TTTAGACA
TTTAGGCA	TTTAGACA
TTTANACA	TTTAGACA
TTTAGTAC	TTTAGACA
TTTAGTCA	TTTAGACA
TTGGTCCG	ATGGTCCG
TTTAGNAC	TTTAGACA
TTTAGNCA	TTTAGACA
TTGGTCGT	TTGGCGTA
TTGGTGTA	TTGGCGTA
TTTANGAC	TTTAGACA
TTGGTTAA	TTGTTTAA
TTGGTTTA	TTGTTTAA
TTNTAGAC	TTTAGACA
TTNTAGCC	TTTTAGCC
TTNTATAC	TTCTATAC
TTGGNCGT	TTGGCGTA
TTTCAGAC	TTTAGACA
TTTCAGAT	TTCAGATA
TTTCAGCC	TTTTAGCC
TTGGNGTA	TTGGCGTA
TGNCACCG	TGCCACCG
TNAGAAGA	TAGAAGAG
TTTCCCAG	CTTCCCAG
TNAGAGGT	TAGAGGTT
TGNCCACC	TGCCACCG
TNCAGATA	TTCAGATA
TTTCCGTC	TTTGCGTC
TTGTAGAA	TTGAGAAC
TTGTAGAC	TTTAGACA
TTGANAAC	TTGAGAAC
TTNTGCGT	TTTGCGTC
TTTCCTGA	TTTGCTGA
TTGTAGCC	TTTTAGCC
TTNTGCTG	TTTGCTGA
TTGTATAA	TTGTTTAA
TTGTATAC	TTCTATAC
TTGANGAA	TTGAGAAC
TTTCGACA	TTTAGACA
TTTCGATG	TTCGATGG
TTGTATTC	GTTGTATT
TTGTATTG	GTTGTATT
TTGTATTT	GTTGTATT
TTGTATTN	GTTGTATT
TTTCGCGT	TTTGCGTC
TTTCGCTG	TTTGCTGA
TNCGATGG	TTCGATGG
TTTCGGCA	TGTTCGGC
TTTCGGCC	TGTTCGGC
TTTCGGCG	TGTTCGGC
TTTCGGCT	TGTTCGGC
TTTCGGCN	TGTTCGGC
TTCGTATA	TTCTATAC
TTCGTATG	TTCGATGG
TTTCGTCA	TTTGCGTC
TTTCGTCC	TTTGCGTC
TTTCGTCG	TTTGCGTC
TTTCGTCT	TTTGCGTC
TTTCGTCN	TTTGCGTC
TTGCAGAA	TTGAGAAC
TTGCAGAT	TTCAGATA
TNGAAGAG	TAGAAGAG
TTGTCGTA	TTGGCGTA
TTCGTGGA	TTCGATGG
TTCGTGGC	TTCGATGG
TTCGTGGG	TTCGATGG
TTCGTGGT	TTCGATGG
TTCGTGGN	TTCGATGG
TTGTCTAA	TTGTTTAA
TTGTCTAG	TGTCTAGC
TTGTCTTA	TTGTTTAA
TTCGTTGG	TTCGATGG
TTCGTTTA	TTGTTTAA
TTTCTATA	TTCTATAC
TTGCATGG	ATGCATGG
TTTCTGAA	TTTGCTGA
TTTCTGAC	TTTGCTGA
TTTCTGAG	TTTGCTGA
TTTCTGAT	TTTGCTGA
TTTCTGAN	TTTGCTGA
TTCGNATG	TTCGATGG
TTGTGAAC	TTGAGAAC
TNCGGGAC	TCCGGGAC
TNCGGGGG	TCGGGGGA
TNCGGGTT	TGCGGGTT
TNCCACCG	TGCCACCG
TTGCCACC	TGCCACCG
TTCGNTGG	TTCGATGG
TNGAGAAC	TTGAGAAC
TTCTAAAC	TTCTATAC
TTCTAACA	TTCTATAC
TTCTAACC	TTCTATAC
TTCTAACG	TTCTATAC
TTCTAACT	TTCTATAC
TTCTAACN	TTCTATAC
TTGCCGTA	TTGGCGTA
TTCTAATA	TTCTATAC
TTGTGCTG	TTTGCTGA
TTCTACAC	TTCTATAC
TNGAGGTT	TAGAGGTT
TTGCCTTT	CTGCCTTT
TTCTACTA	TTCTATAC
TTCTAGAT	TTCAGATA
TTCTAGCA	TGTCTAGC
TTCTAGCG	TGTCTAGC
TTCTAGCT	TGTCTAGC
TTCTAGCN	TGTCTAGC
TTCTAGTA	TTCTATAC
TTCTATAA	TTCTATAC
TTCTATAC	TTCTATAC
TTCTATAG	TTCTATAC
TTCTATAT	TTCTATAC
TTCTATAN	TTCTATAC
TTCTATCA	TTCTATAC
TTCTATCC	TTCTATAC
TTCTATCG	TTCTATAC
TTCTATCT	TTCTATAC
TTCTATCN	TTCTATAC
TTCTATGA	TTCTATAC
TTGCGAAC	TTGAGAAC
TTCTATGC	TTCTATAC
TTCTATGG	TTCGATGG
TTCTATTA	TTCTATAC
TTCTATTC	TTCTATAC
TNCCCGCA	TACCCGCA
TTCTATNA	TTCTATAC
TTCTATNC	TTCTATAC
TTCTANAC	TTCTATAC
TTGTGTAA	TTGTTTAA
TTGCGACT	TGGCGACT
TTCTANTA	TTCTATAC
TTGCGATG	TTCGATGG
TTCTCATA	TTCTATAC
TTGTGTTA	TTGTTTAA
TTGCGCGT	TTGGCGTA
TTGCGGGT	TGCGGGTT
TTGCGTAA	TTGGCGTA
TTGCGTAC	TTGGCGTA
TTGCGTAG	TTGGCGTA
TTGCGTAT	TTGGCGTA
TTGCGTAN	TTGGCGTA
TTGCGTCA	TTTGCGTC
TTGCGTCC	TTTGCGTC
TTGCGTCG	TTTGCGTC
TTTGACAA	TTTAGACA
TTTGACAC	TTTAGACA
TTTGACAG	TTTAGACA
TTTGACAT	TTTAGACA
TTTGACAN	TTTAGACA
TTGTTAAA	TTGTTTAA
TTTGACGT	TTTGCGTC
TTTGACTG	TTTGCTGA
TTTGAGAA	TTGAGAAC
TTTGAGAC	TTTAGACA
TTGCGTCT	TTTGCGTC
TTGCGTCN	TTTGCGTC
TTGTTAAC	TTGTTTAA
TTTGAGCC	TTTTAGCC
TTCTCTAC	TTCTATAC
TTGTTAAG	TTGTTTAA
TTGTTAAT	TTGTTTAA
TTGTTAAN	TTGTTTAA
TTTGAGTC	TTTGCGTC
TTGTTAGC	TTTTAGCC
TTGTTATA	TTGTTTAA
TTGTTCAA	TTGTTTAA
TTTGATGA	TTTGCTGA
TTTGATGG	TTCGATGG
TTGTTCGG	TGTTCGGC
TTGTTCTA	TTGTTTAA
TTGTTGAA	TTGTTTAA
TTGTTGTA	TTGTTTAA
TTCTGAGC	ATCTGAGC
TTGTTTAA	TTGTTTAA
TTGTTTAC	TTGTTTAA
TTGTTTAG	TTGTTTAA
TTGTTTAT	TTGTTTAA
TTGTTTAN	TTGTTTAA
TTGTTTCA	TTGTTTAA
TTCTGATG	TTCGATGG
TTGTTTGA	TTGTTTAA
TTGTTTTA	TTGTTTAA
TNCCGGGA	TCCGGGAC
TTCTGCGT	TTTGCGTC
TTCTGCTG	TTTGCTGA
TTGTTTNA	TTGTTTAA
TTGTTNAA	TTGTTTAA
TNATCGAT	TAATCGAT
TTGCTATA	TTCTATAC
TTCTGTAC	TTCTATAC
TTGCTGAA	TTTGCTGA
TTGCTGAC	TTTGCTGA
TTGCTGAG	TTTGCTGA
TTGCTGAT	TTTGCTGA
TTGTTNTA	TTGTTTAA
TTGCTGAN	TTTGCTGA
TTGCTTAA	TTGTTTAA
TTGCTTTA	TTGTTTAA
TTCTTACA	TTCTATAC
TTCTTACC	TTCTATAC
TTCTTACG	TTCTATAC
TTCTTACT	TTCTATAC
TTCTTACN	TTCTATAC
TTCTTAGC	TTTTAGCC
TTCTTATA	TTCTATAC
TTCTTTAA	TTGTTTAA
TTCTTTAC	TTCTATAC
TTCTTTGT	TCTTTGTA
TTGTNTAA	TTGTTTAA
TNGCCACC	TGCCACCG
TTCTNATA	TTCTATAC
TTGTNTTA	TTGTTTAA
TTGGAACA	TTGAGAAC
TTGGAACC	TTGAGAAC
TTGGAACG	TTGAGAAC
TTGGAACT	TTGAGAAC
TTGGAACN	TTGAGAAC
TNCTATAC	TTCTATAC
TTGGACGT	TTGGCGTA
TTCTNTAC	TTCTATAC
TTGGAGAA	TTGAGAAC
TTGGAGTA	TTGGCGTA
TNTTAGAC	TTTAGACA
TNAACTCA	TAACTCAG
TNTTAGCC	TTTTAGCC
TTGGATGG	TTCGATGG
TNAACTTC	TCAACTTC
TTCNAGAT	TTCAGATA
TTGGCAGT	TTGGCGTA
TTGGCATA	TTGGCGTA
TTCNATAC	TTCTATAC
TTCNATGG	TTCGATGG
TNAAGACG	TCAAGACG
TTGGCCGT	TTGGCGTA
TTGGCCTA	TTGGCGTA
TNTTCGGC	TGTTCGGC
TTGGCGAA	TTGGCGTA
TTGGCGAG	TTGGCGTA
TTGGCGAT	TTGGCGTA
TTGGCGAN	TTGGCGTA
TTGGCGCA	TTGGCGTA
TTGGCGCT	TTGGCGTA
TTNAGAAC	TTGAGAAC
TTNAGACA	TTTAGACA
TTGGCGGA	TTGGCGTA
TTGGCGGT	TTGGCGTA
TTGGCGTA	TTGGCGTA
TTGGCGTG	TTGGCGTA
TTGGCGTT	TTGGCGTA
TTNAGATA	TTCAGATA
TTGGCGTN	TTGGCGTA
TTGGCGNA	TTGGCGTA
TTGGCGNT	TTGGCGTA
TTGGCTAA	TTGGCGTA
TTGGCTAC	TTGGCGTA
TTGGCTAG	TTGGCGTA
TTGGCTAT	TTGGCGTA
TTGGCTAN	TTGGCGTA
TTGGCTGA	TTTGCTGA
TTGGCTGT	TTGGCGTA
TTGGCTTA	TTGGCGTA
TTGGCNGT	TTGGCGTA
TTGGCNTA	TTGGCGTA
TNTTGCGT	TTTGCGTC
TNTTGCTG	TTTGCTGA
TTNTTAGC	TTTTAGCC
TNTTTAGC	TTTTAGCC
TTNTTTAA	TTGTTTAA
TNTTTGTA	TCTTTGTA
TNAATCGA	TAATCGAT
TNTAGACA	TTTAGACA
TTNCAGAT	TTCAGATA
TNTCGATG	TTCGATGG
NACATCCT	ACATCCTT
TNACCCGC	TACCCGCA
TTNCGATG	TTCGATGG
TNTCTAGC	TGTCTAGC
TNTCTATA	TTCTATAC
TTNCTATA	TTCTATAC
NAGAGGTT	TAGAGGTT
TNTCAGAT	TTCAGATA
NAAGGAGT	AAGGAGTG
NACCCGCA	TACCCGCA
TNGCGACT	TGGCGACT
NAAGGGGA	AAGGGGAC
TNACTCAG	TAACTCAG
NACGCAGC	ACGCAGCC
NACGCATG	AACGCATG
TNTGAGAA	TTGAGAAC
TNGCGGGT	TGCGGGTT
NACGCCCT	ACGCCCTA
NACGCGCT	CACGCGCT
NAAGTGCT	AAGTGCTG
NAAGTGGT	AAGTGGTG
NACCGGTT	ACCGGTTG
TNTGCGTC	TTTGCGTC
TNTGCTGA	TTTGCTGA
NACGGCCA	ACGGCCAG
TNTGGCGT	TTGGCGTA
TNGTCTAG	TGTCTAGC
NACGTATT	ACGTATTA
NAATCACC	AATCACCC
NACGTGGG	CACGTGGG
NAATCGAT	TAATCGAT
NAATCGCT	AAATCGCT
NACGAAAC	ACGAAACT
TNTGTTTA	TTGTTTAA
TNCTTTGT	TCTTTGTA
NACTAATT	ACTAATTT
TNGTTCGG	TGTTCGGC
TNGGCGAC	TGGCGACT
TNGGCGTA	TTGGCGTA
TNGTTTAA	TTGTTTAA
TNGGGGGA	TCGGGGGA
NAATTTTC	GAATTTTC
NAGCTTGC	CAGCTTGC
NATTTTTT	CATTTTTT
NACTGGGA	AACTGGGA
NATATCAT	GATATCAT
NACACAAG	ACACAAGT
NATATCGG	CATATCGG
NATATCTC	ATATCTCT
NAAAAAGC	GAAAAAGC
NATCACCC	AATCACCC
NACAGTTA	GACAGTTA
NCCCCTTC	CCCCTTCA
NATCCCTC	ATCCCTCT
NATCCTGG	ATCCTGGC
NAACCGAA	CAACCGAA
NCCCTTCA	CCCCTTCA
NATGACGC	CATGACGC
NAACGCAT	AACGCATG
NAAAGTAC	GAAAGTAC
NAAATAGG	GAAATAGG
NCCGAACA	CCGAACAT
NAAATCGC	AAATCGCT
NATGCATG	ATGCATGG
NAACTCAG	TAACTCAG
NATCTGAG	ATCTGAGC
NCCGATTA	CCGATTAA
NAACTGGG	AACTGGGA
NAGGACAT	AGGACATT
NAGGAGTG	AAGGAGTG
NATGGTCC	ATGGTCCG
NCATATCG	CATATCGG
NAGGCCGC	AGGCCGCC
NCCGGGAC	TCCGGGAC
NCATCCTT	ACATCCTT
NAAGAATA	AAGAATAA
NCCGGTTG	ACCGGTTG
NAGGGGAC	AAGGGGAC
NCATGACG	CATGACGC
NCGCAGCC	ACGCAGCC
NATTCCCT	CATTCCCT
NCGCCCTA	ACGCCCTA
NCATTCCC	CATTCCCT
NCATTTTT	CATTTTTT
NCCTACGG	CCTACGGT
NCCAAATG	CCAAATGC
NAGTGCTG	AAGTGCTG
NAGTGGTG	AAGTGGTG
NCGGCCAG	ACGGCCAG
NCCAGAGT	CCAGAGTC
NCGGGGGA	TCGGGGGA
NCGGGTTC	CGGGTTCG
NCCCAGTC	GCCCAGTC
NCAAATGC	CCAAATGC
NAGAAGAG	TAGAAGAG
NCAACCGA	CAACCGAA
NAGAATAA	AAGAATAA
NCAACTTC	TCAACTTC
NCTCACTA	CTCACTAC
NGAAAAAG	GAAAAAGC
NCAAGACG	TCAAGACG
NGAAAAGA	GGAAAAGA
NATAAAGT	ATAAAGTC
NGAAAGTA	GAAAGTAC
NGAAATAG	GAAATAGG
NCACGCGC	CACGCGCT
NCTTACGG	GCTTACGG
NGCGGGTT	TGCGGGTT
NCACGTGG	CACGTGGG
NGCGTAAA	GCGTAAAT
NCTCGTTC	GCTCGTTC
NGCGTTAA	GCGTTAAC
NCTTCCCA	CTTCCCAG
NCTTTACC	GCTTTACC
NCACAAGT	ACACAAGT
NCTTTGTA	TCTTTGTA
NCAGAGTC	CCAGAGTC
NGCTCGTT	GCTCGTTC
NCTGATAA	CTGATAAA
NCAGCTTG	CAGCTTGC
NCTGCCTT	CTGCCTTT
NGGGACCC	GGGACCCG
NCGTAAAT	GCGTAAAT
NCGTATTA	ACGTATTA
NGCTTACG	GCTTACGG
NGCCACCG	TGCCACCG
NGGGTTCG	CGGGTTCG
NGCTTTAC	GCTTTACC
NCGAAACT	ACGAAACT
NCGAACAT	CCGAACAT
NGCCCAGT	GCCCAGTC
NCGTGTCC	CGTGTCCA
NCGACGCT	CGACGCTG
NCGTTAAC	GCGTTAAC
NCGTTCCA	CGTTCCAA
NCTAATTT	ACTAATTT
NGTTAGCA	GTTAGCAA
NCGATTAA	CCGATTAA
NCTACGGT	CCTACGGT
NTCGGGGG	TCGGGGGA
NGCAAAAT	GGCAAAAT
NGTTCCAA	CGTTCCAA
NGTTCGGC	TGTTCGGC
NTAAAGTC	ATAAAGTC
NGTTGTAT	GTTGTATT
NGTCTAGC	TGTCTAGC
NTAACTCA	TAACTCAG
NGAATTTT	GAATTTTC
NTCTATAC	TTCTATAC
NTAATCGA	TAATCGAT
NTCTGAGC	ATCTGAGC
NGACAGTT	GACAGTTA
NTGGCGAC	TGGCGACT
NTGGCGTA	TTGGCGTA
NTCTTTGT	TCTTTGTA
NTGGTCCG	ATGGTCCG
NGACGCTG	CGACGCTG
NGATATCA	GATATCAT
NGATGAAC	GGATGAAC
NTGTCTAG	TGTCTAGC
NTCCCTCT	ATCCCTCT
NGTGTCCA	CGTGTCCA
NTCCGGGA	TCCGGGAC
NGTGTTTC	GGTGTTTC
NTGTTCGG	TGTTCGGC
NGGAAAAG	GGAAAAGA
NTCCTGGC	ATCCTGGC
NTGTTTAA	TTGTTTAA
NGGACATT	AGGACATT
NTCGATGG	TTCGATGG
NGGACCCG	GGGACCCG
NGGTGTTT	GGTGTTTC
NTTTTAGC	TTTTAGCC
NGTACCCG	GTACCCGG
NGGATGAA	GGATGAAC
NGTAGAAC	GTAGAACC
NGTATACG	GTATACGA
NGGCAAAA	GGCAAAAT
NTCAACTT	TCAACTTC
NTCAAGAC	TCAAGACG
NGGCCGCC	AGGCCGCC
NTGAGAAC	TTGAGAAC
NTCACTAC	CTCACTAC
NGGCGACT	TGGCGACT
NTCAGATA	TTCAGATA
NTTGAGAA	TTGAGAAC
NTACCCGC	TACCCGCA
NTACCCGG	GTACCCGG
NTTGCGTC	TTTGCGTC
NTTGCTGA	TTTGCTGA
NTTGGCGT	TTGGCGTA
NTATACGA	GTATACGA
NTTGTATT	GTTGTATT
NTTGTTTA	TTGTTTAA
NTATCTCT	ATATCTCT
NTGATAAA	CTGATAAA
NTTTAGAC	TTTAGACA
NTTTAGCC	TTTTAGCC
NTAGAACC	GTAGAACC
NTAGAAGA	TAGAAGAG
NTAGAGGT	TAGAGGTT
NTTTGCGT	TTTGCGTC
NTTTGCTG	TTTGCTGA
NTGCATGG	ATGCATGG
NTGCCACC	TGCCACCG
NTGCCTTT	CTGCCTTT
NTTAGACA	TTTAGACA
NTTAGCAA	GTTAGCAA
NTGCGGGT	TGCGGGTT
NTTCAGAT	TTCAGATA
NTTCCCAG	CTTCCCAG
NTTCGATG	TTCGATGG
NTTCTATA	TTCTATAC
