AACTAAAC	ACTAAACG
AAGCCACC	AAGCACCC
AACTAAGA	AATAAGAA
AAAAAATC	TAAAAATC
AAATCAGT	AACTCAGT
AACTAAGT	AACTCAGT
AAACTCAG	AACTCAGT
AACTACAG	AACTCAGT
AAACTCGA	AAAGCTCG
AAACTCGC	AAAGCTCG
AAGCCCCA	AAGCACCC
AAACTCGG	AAAGCTCG
AAGCCCCC	AAGCACCC
AAGCCCCG	AAGCACCC
AAACTCGT	AAAGCTCG
AAACTCGN	AAAGCTCG
AAGCCCCT	AAGCACCC
AAGCCCCN	AAGCACCC
AAACTCTC	AGACTCTC
AAGCCCGC	AGCCCGCG
AACNTCAG	AACTCAGT
AAGCCGGA	ACAGCCGG
AAGCCGGC	ACAGCCGG
AAGCCGGG	ACAGCCGG
AAGCCGGT	ACAGCCGG
AAGCCGGN	ACAGCCGG
AACTAGTA	AACTCAGT
AACTAGTC	AACTCAGT
AACTAGTG	AACTCAGT
AAGCCGTT	AGCCGTTC
AACTAGTT	AACTCAGT
AACTAGTN	AACTCAGT
AACTATGT	AATTATGT
AAAAATCA	TAAAAATC
AAAAATCC	TAAAAATC
AAAAATCG	TAAAAATC
AAAAATCT	TAAAAATC
AAAAATCN	TAAAAATC
AAAAATGC	AGAAATGC
AACCGTTC	AGCCGTTC
AAATCTCG	AAAGCTCG
AAGCGACC	AAGCACCC
AACCGTTT	AACGTTTA
AACTCAAG	AACTCAGT
AACTCAAT	AACTCAGT
AACTCACG	AACTCAGT
AACTCACT	AACTCAGT
AACTCAGA	AACTCAGT
AACTCAGC	AACTCAGT
AACTCAGG	AACTCAGT
AACTCAGT	AACTCAGT
AACTCAGN	AACTCAGT
AAGCGCCC	AAGCACCC
AACTCATA	AACTCAGT
AACTCATG	AACTCAGT
AACTCATT	AACTCAGT
AAGCGCGA	AGAGCGCG
AACTCATN	AACTCAGT
AAGCGCGC	AGAGCGCG
AAGCGCGG	AGAGCGCG
AAGCGCGT	AGAGCGCG
AACTCANG	AACTCAGT
AAGCGCGN	AGAGCGCG
AACTCANT	AACTCAGT
AACTCCAG	AACTCAGT
AACCTAAA	CAACCTAA
AACCTAAC	CAACCTAA
AAATGACA	TAAATGAC
AACCTAAG	CAACCTAA
AACTCCCG	ACTCCCGA
AAATGACC	TAAATGAC
AACCTAAT	CAACCTAA
AAATGACG	TAAATGAC
AAATGACT	TAAATGAC
AACCTAAN	CAACCTAA
AAATGACN	TAAATGAC
AACTCCGT	AACTCAGT
AACNTTTA	AACGTTTA
AACTCGAG	AACTCAGT
AACCTCAG	AACTCAGT
AACTCGGT	AACTCAGT
AACTCGTA	AACTCAGT
AACTCGTC	AACTCAGT
AACTCGTG	AACTCAGT
AACTCGTT	AACTCAGT
AACTCGTN	AACTCAGT
AAGCGTAT	AGCGTATC
AACTCTAG	AACTCAGT
AAATGCTC	AAAGCTCG
AACTCTCA	AGACTCTC
AACTCTCC	AGACTCTC
AACTCTCT	AGACTCTC
AACTCTCN	AGACTCTC
AAGCGTTT	AACGTTTA
AACTCTGT	AACTCAGT
AAAACTCG	AAAGCTCG
AACTCNAG	AACTCAGT
AACTCNGT	AACTCAGT
AAGCTACC	AAGCACCC
AAGCTAGA	GAAGCTAG
AAGCTAGC	GAAGCTAG
AAGCTAGG	GAAGCTAG
AAGCTAGT	GAAGCTAG
AAGCTAGN	GAAGCTAG
AAATGTCG	AATGTCGT
AACTGAGG	ACTGAGGA
AACTGAGT	AACTCAGT
AACAAGAA	AATAAGAA
AACCTTGG	ACCTTGGT
AAATGTTG	AATGTTGT
AAAGACTC	AAAGCTCG
AACCTTTA	AACGTTTA
AAGCTCAG	AACTCAGT
AAGCTCCC	AAGCACCC
AAAAGAAC	AATAAGAA
AAAAGAAG	AATAAGAA
AAGCTCGA	AAAGCTCG
AAAAGAAT	AATAAGAA
AAAAGAAN	AATAAGAA
AAGCTCGC	AAAGCTCG
AACTGCAG	AACTCAGT
AAGCTCGG	AAAGCTCG
AAGCTCGT	AAAGCTCG
AAGCTCGN	AAAGCTCG
AAAAGATT	TAAAGATT
AACAATGA	ACACAATG
AACAATGC	ACACAATG
AACAATGG	ACACAATG
AACAATGT	ACACAATG
AACAATGN	ACACAATG
AAAAGCTC	AAAGCTCG
AAATTATG	AATTATGT
AACTGTCG	AATGTCGT
AAAGATCG	AAAGCTCG
AACACAAT	ACACAATG
AACTGTTG	AATGTTGT
AACACAGT	AACTCAGT
AAAGATTA	TAAAGATT
AAATTTAC	AATTTTAC
AAAGATTC	TAAAGATT
AAAGATTG	TAAAGATT
AAAGATTT	TAAAGATT
AAAGATTN	TAAAGATT
AAATTTTA	AATTTTAC
AAGCNACC	AAGCACCC
AACACCCA	AAGCACCC
AACACCCC	AAGCACCC
AACACCCG	AAGCACCC
AACACCCT	AAGCACCC
AACACCCN	AAGCACCC
AAGCNCCC	AAGCACCC
AAAGCACC	AAGCACCC
AAAGCACG	AAAGCTCG
AACTTAGT	AACTCAGT
AAAGCATC	AAAGCTCG
AAGAAATG	AGAAATGC
AAAATGAC	TAAATGAC
AACTTATG	AATTATGT
AAAATGCA	AGAAATGC
AAAATGCC	AGAAATGC
AAAATGCG	AGAAATGC
AAAATGCT	AGAAATGC
AAAATGCN	AGAAATGC
AAGAACCC	AAGCACCC
AACTTCAG	AACTCAGT
AACTTCCA	ACTTCCAT
AAAGCCCG	AAAGCTCG
AAGAAGAA	AATAAGAA
AAAGCCGA	AAAGCTCG
AAAGCCGC	AAAGCTCG
AAAGCCGT	AAAGCTCG
AAAGCCGN	AAAGCTCG
AAAGCCTC	AAAGCTCG
AACAGCCG	ACAGCCGG
AACAGCTC	AAAGCTCG
AAGAAGGG	ACGAAGGG
AACTTGGT	ACCTTGGT
AACTTTAA	AACGTTTA
AAGGACCC	AAGCACCC
AACTTTAG	AACGTTTA
AACTTTAT	AACGTTTA
AACTTTAN	AACGTTTA
AAAGCGTC	AAAGCTCG
AAAGCTAC	AAAGCTCG
AAAGCTCA	AAAGCTCG
AAAGCTCC	AAAGCTCG
AAAGCTCG	AAAGCTCG
AAAGCTCT	AAAGCTCG
AAAGCTCN	AAAGCTCG
AAAGCTGA	AAAGCTCG
AAAGCTGC	AAAGCTCG
AAAGCTGG	AAAGCTCG
AAAGCTGT	AAAGCTCG
AAAGCTGN	AAAGCTCG
AAAGCTTC	AAAGCTCG
AAAGCTTG	AAAGCTCG
AAAGCTNC	AAAGCTCG
AAAGCTNG	AAAGCTCG
AACAGTTT	AACGTTTA
AACGAAGG	ACGAAGGG
AAAGCNCG	AAAGCTCG
AAGGCACC	AAGCACCC
AAAGCNTC	AAAGCTCG
AAGGCCCG	CAGGCCCG
AACTNAGT	AACTCAGT
AAACAATG	ACACAATG
AACTNCAG	AACTCAGT
AAACACCC	AAGCACCC
AAAGGCTC	AAAGCTCG
AAGACACC	AAGCACCC
AACATCAG	AACTCAGT
AACGAGCT	TACGAGCT
AAGGCTCG	AAAGCTCG
AAAGGGGC	TAAGGGGC
AAGACCCA	AAGCACCC
AAGACCCC	AAGCACCC
AAGACCCG	AAGCACCC
AAGACCCT	AAGCACCC
AAGACCCN	AAGCACCC
AACGATTA	AACGTTTA
AACATGGA	TACATGGA
AAAGGTCG	AAAGCTCG
AACGATTT	AACGTTTA
AAGACTCT	AGACTCTC
AACATTTA	AACGTTTA
AAANCTCG	AAAGCTCG
AAGGGGCA	TAAGGGGC
AAGGGGCC	TAAGGGGC
AAGGGGCG	TAAGGGGC
AAGGGGCT	TAAGGGGC
AAGGGGCN	TAAGGGGC
AAAGTCGA	AAAGCTCG
AAAGTCGC	AAAGCTCG
AAAGTCGG	AAAGCTCG
AACGCACC	AAGCACCC
AAAGTCGN	AAAGCTCG
AAAGTCTC	AAAGCTCG
AAGGGGGG	CAGGGGGG
AACGCAGT	AACTCAGT
AAGAGCAG	TAGAGCAG
AACGCATA	GAACGCAT
AACGCATC	GAACGCAT
AACGCATG	GAACGCAT
AACGCATT	GAACGCAT
AACGCATN	GAACGCAT
AAAGTTCG	AAAGCTCG
AAGAGCGC	AGAGCGCG
AAAGTTGT	AATGTTGT
AAAGTTTA	AACGTTTA
AAGAGCTC	AAAGCTCG
AAGAGCTT	CAGAGCTT
AACGCTCG	AAAGCTCG
AACGCTTA	AACGTTTA
AACGCTTT	AACGTTTA
AACNCAGT	AACTCAGT
AAAGNCTC	AAAGCTCG
AAACCTAA	CAACCTAA
AAACCTCG	AAAGCTCG
AAANGCTC	AAAGCTCG
AAGGTCGT	AATGTCGT
AAAGNTCG	AAAGCTCG
AAGGTTGT	AATGTTGT
AAGGTTTA	AACGTTTA
AACCACCC	AAGCACCC
AAATAAGA	AATAAGAA
AAACGCAT	GAACGCAT
AAACGCTC	AAAGCTCG
AACGGTTA	AACGTTTA
AACGGTTT	AACGTTTA
AACCAGTA	AACTCAGT
AACCAGTC	AACTCAGT
AAATATGT	AATTATGT
AACCAGTG	AACTCAGT
AACCAGTT	AACTCAGT
AACCAGTN	AACTCAGT
AACNGTTT	AACGTTTA
AAACGTTT	AACGTTTA
AACGTATA	AACGTTTA
AACGTATC	AGCGTATC
AACCCAGT	AACTCAGT
AACGTATT	AACGTTTA
AACGTCAG	AACTCAGT
AACGTCGT	AATGTCGT
AACGTCTA	AACGTTTA
AACGTCTT	AACGTTTA
AAGCAACC	AAGCACCC
AATCAAGA	AATAAGAA
AACCCGCG	AGCCCGCG
AATCACCC	AAGCACCC
AAGCACAC	AAGCACCC
AAGCACCA	AAGCACCC
AAGCACCC	AAGCACCC
AAGCACCG	AAGCACCC
AAGCACCT	AAGCACCC
AAGCACCN	AAGCACCC
AACGTGTA	AACGTTTA
AACGTGTT	AACGTTTA
AACGTTAA	AACGTTTA
AATCAGAA	AATAAGAA
AACGTTAC	AACGTTTA
AACGTTAG	AACGTTTA
AACGTTAT	AACGTTTA
AACGTTAN	AACGTTTA
AACGTTCA	AACGTTTA
AAGTAAGA	AATAAGAA
AAGCACGC	AAGCACCC
AAGCACTC	AAGCACCC
AATCAGTA	AACTCAGT
AATCAGTC	AACTCAGT
AATCAGTG	AACTCAGT
AACGTTCT	AACGTTTA
AAGCACNC	AAGCACCC
AACGTTGA	AACGTTTA
AANCACCC	AAGCACCC
AACGTTTA	AACGTTTA
AACGTTTC	AACGTTTA
AACGTTTG	AACGTTTA
AACCCTCA	GACCCTCA
AACGTTTT	AACGTTTA
AAGTACCC	AAGCACCC
AACGTTTN	AACGTTTA
AACGTTNA	AACGTTTA
AAGCAGCC	AAGCACCC
AACGTTNT	AACGTTTA
AAGTACTC	CAGTACTC
AATCAGTN	AACTCAGT
AAGCATCC	AAGCACCC
AACGTNTA	AACGTTTA
AATCATCC	ACTCATCC
AACGTNTT	AACGTTTA
AATCATGT	AATTATGT
AAGTATGT	AATTATGT
AATGTACG	AATGTCGT
AAGCANCC	AAGCACCC
AATGTCAG	AATGTCGT
AATGTCAT	AATGTCGT
AATGTCCG	AATGTCGT
AATGTCCT	AATGTCGT
AATGTCGA	AATGTCGT
AATGTCGC	AATGTCGT
AATGTCGG	AATGTCGT
AATGTCGT	AATGTCGT
AATGTCGN	AATGTCGT
AATGTCTA	AATGTCGT
AATGTCTC	AATGTCGT
AAGTCACC	AAGCACCC
AATGTCTT	AATGTCGT
AATGTCTN	AATGTCGT
AATGTCNG	AATGTCGT
AATGTCNT	AATGTCGT
AATGTGCG	AATGTCGT
AATGTTAC	AATTTTAC
AATGTTAG	AATGTTGT
AATGTTAT	AATGTTGT
AATGTTCT	AATGTTGT
AATGTTGA	AATGTTGT
AATGTTGC	AATGTTGT
AATGTTGG	AATGTTGT
AATGTTGT	AATGTTGT
AATGTTGN	AATGTTGT
AATGTTTC	AATGTTGT
AATGTTTG	AATGTTGT
AAGTCGTA	AATGTCGT
AATGTTTT	AATGTTGT
AAGTCGTC	AATGTCGT
AATGTTTN	AATGTTGT
AAGTCGTG	AATGTCGT
AAGTCGTT	AATGTCGT
AAGTCGTN	AATGTCGT
AATGTTNG	AATGTTGT
AATCCCGA	ACTCCCGA
AATGTTNT	AATGTTGT
AATGTNCG	AATGTCGT
AACGNTTA	AACGTTTA
AATGTNTG	AATGTTGT
AACGNTTT	AACGTTTA
AATCCTCC	ATTCCTCC
AANGTCGT	AATGTCGT
AAGTGTCG	AATGTCGT
AANGTTGT	AATGTTGT
AANGTTTA	AACGTTTA
AAGTGTTG	AATGTTGT
AATGNCGT	AATGTCGT
ACAAAACG	ACTAAACG
ACAAAATG	ACACAATG
AATAAAAC	AATAAGAA
AATAAAAG	AATAAGAA
AATAAAAT	AATAAGAA
AATAAAAN	AATAAGAA
AATCGGTC	CATCGGTC
AATAAACG	ACTAAACG
AATAAAGA	AATAAGAA
AAGTTATG	AATTATGT
AATAACAA	AATAAGAA
AATAACGA	AATAAGAA
ACAAACGA	ACTAAACG
ACAAACGC	ACTAAACG
ACAAACGG	ACTAAACG
ACAAACGT	ACTAAACG
ACAAACGN	ACTAAACG
AATCGTCG	AATGTCGT
AANCGTTT	AACGTTTA
AATAAGAA	AATAAGAA
AATAAGAC	AATAAGAA
AATAAGAG	AATAAGAA
AAGTTGCC	AGTTGCCT
AATAAGAT	AATAAGAA
AATCGTTG	AATGTTGT
AATAAGAN	AATAAGAA
AATAAGCA	AATAAGAA
AATCGTTT	AACGTTTA
AATGNTCG	AATGTCGT
AATAAGGA	AATAAGAA
ACAAAGGG	ACGAAGGG
AATGNTGT	AATGTTGT
AAGTTGTA	AATGTTGT
AAGTTGTC	AATGTTGT
AAGTTGTG	AATGTTGT
AAGTTGTT	AATGTTGT
AATAAGTA	AATAAGAA
ACAAAGTC	CCAAAGTC
AAGTTGTN	AATGTTGT
AATGNTTG	AATGTTGT
AATAAGNA	AATAAGAA
AAGTTTAA	AACGTTTA
AAGTTTAG	AACGTTTA
AAGTTTAT	AACGTTTA
AAGTTTAN	AACGTTTA
AATAATAA	AATAAGAA
AATAATAT	GATAATAT
ACAAATGA	ACACAATG
ACAAATGG	ACACAATG
AATAATGA	AATAAGAA
ACAAATGT	ACACAATG
AAGTTTTA	AATTTTAC
ACAAATGN	ACACAATG
AATAATGT	AATTATGT
AATAANAA	AATAAGAA
AATAANGA	AATAAGAA
ACAACAAT	ACACAATG
AATNGTCG	AATGTCGT
AANTAAGA	AATAAGAA
AATTAAGA	AATAAGAA
AANCTCAG	AACTCAGT
AATTAAGT	AATTATGT
AATNGTTG	AATGTTGT
AATTAATG	AATTATGT
AATACAGA	AATAAGAA
AATACAGG	ATTACAGG
AATTACAG	ATTACAGG
AATTACGT	AATTATGT
AATTACTG	AATTATGT
AATCTATG	AATTATGT
AATTAGAA	AATAAGAA
AATCTCAG	AACTCAGT
ACAACCGG	ACAGCCGG
ACAACCTA	CAACCTAA
AATNTATG	AATTATGT
ACAACGGC	GCAACGGC
AATACGAA	AATAAGAA
AATCTCGT	AATGTCGT
AATTAGGT	AATTATGT
AANTATGT	AATTATGT
AATTAGTA	AATTATGT
AATNTCGT	AATGTCGT
AATTAGTC	AATTATGT
AATTAGTG	AATTATGT
AATTAGTT	AATTATGT
AATTAGTN	AATTATGT
AATCTTAC	AATTTTAC
AATTATAC	AATTTTAC
AATTATAG	AATTATGT
AAGNACCC	AAGCACCC
AATTATAT	AATTATGT
AATTATCG	AATTATGT
AATTATCT	AATTATGT
AATTATGA	AATTATGT
AATTATGC	AATTATGT
AATCTTGT	AATGTTGT
AATTATGG	AATTATGT
AATTATGT	AATTATGT
AATCTTTA	AATTTTAC
AATTATGN	AATTATGT
AATTATTC	AATTATGT
AATNTTAC	AATTTTAC
AATTATTG	AATTATGT
AATTATTT	AATTATGT
AATTATTN	AATTATGT
AATTATNG	AATTATGT
AANTCAGT	AACTCAGT
AATTATNT	AATTATGT
AATAGAAA	AATAAGAA
AATNTTGT	AATGTTGT
AATNTTTA	AATTTTAC
AATAGAAC	AATAAGAA
AATAGAAG	AATAAGAA
AATAGAAT	AATAAGAA
AATAGAAN	AATAAGAA
AATTANGT	AATTATGT
AATTANTG	AATTATGT
AATAGAGA	AATAAGAA
AATTCAGT	AACTCAGT
AATTCATG	AATTATGT
AATAGCTC	AAAGCTCG
ACAAGCCG	ACAGCCGG
AATTCCAT	ACTTCCAT
AATAGGAA	AATAAGAA
ACAAGCTC	AAAGCTCG
AATTCCTC	ATTCCTCC
AAGNCACC	AAGCACCC
AATTCGTA	AATGTCGT
AATAGTCG	AATGTCGT
AATTCGTC	AATGTCGT
AATTCGTG	AATGTCGT
AATTCGTT	AATGTCGT
AATTCGTN	AATGTCGT
ACAAGGGA	ACGAAGGG
ACAAGGGC	ACGAAGGG
AATTCTAC	AATTTTAC
ACAAGGGG	ACGAAGGG
ACAAGGGT	ACGAAGGG
ACAAGGGN	ACGAAGGG
AATAGTTG	AATGTTGT
AATTCTGT	AATTATGT
AATTCTTA	AATTTTAC
AATATAGA	AATAAGAA
AATATATG	AATTATGT
AANTGTCG	AATGTCGT
AATGAAGA	AATAAGAA
AANTGTTG	AATGTTGT
AATATCGT	AATGTCGT
AATATGAA	AATAAGAA
AATGACGT	AATGTCGT
AATATGTA	AATTATGT
AATTGATG	AATTATGT
AATATGTC	AATTATGT
AATATGTG	AATTATGT
AATATGTT	AATTATGT
AATATGTN	AATTATGT
AANAAGAA	AATAAGAA
AATGAGAA	AATAAGAA
AATTGCCT	AGTTGCCT
AATATTAC	AATTTTAC
AATATTGG	GATATTGG
AATATTGT	AATGTTGT
AATGAGGA	ACTGAGGA
AATATTTA	AATTTTAC
AATGATCG	AATGTCGT
AANGCACC	AAGCACCC
AANTTATG	AATTATGT
ACAATACT	GCAATACT
AATGATTG	AATGTTGT
AATTGTAC	AATTTTAC
AATTGTCG	AATGTCGT
AATTGTGT	AATTATGT
AATTGTTA	AATTTTAC
AATTGTTG	AATGTTGT
AATANAGA	AATAAGAA
AATGCACC	AAGCACCC
AATGCCGT	AATGTCGT
AANGCTCG	AAAGCTCG
AANTTTAC	AATTTTAC
AATTTAAC	AATTTTAC
AATGCGTA	AATGTCGT
AATTTACA	AATTTTAC
AATGCGTC	AATGTCGT
AATTTACC	AATTTTAC
AATGCGTG	AATGTCGT
AATTTACG	AATTTTAC
AATGCGTT	AATGTCGT
AATTTACT	AATTTTAC
AATGCGTN	AATGTCGT
AATTTACN	AATTTTAC
AATTTATA	AATTTTAC
AANTTTTA	AATTTTAC
AATTTATG	AATTATGT
AATGCTGT	AATGTTGT
AATGCTTG	AATGTTGT
ACGGAAGG	ACGAAGGG
AATTTCAC	AATTTTAC
AATANGAA	AATAAGAA
AATTTCGT	AATGTCGT
AATTTCTA	AATTTTAC
ACCTTAGG	ACCTTGGT
ACCTTAGT	ACCTTGGT
AATTTGAC	AATTTTAC
AATTTTAA	AATTTTAC
AATTTTAC	AATTTTAC
AATTTTAG	AATTTTAC
ACCTTCCA	ACTTCCAT
AATTTTAT	AATTTTAC
ACCTTCGG	ACCTTGGT
ACCTTCGT	ACCTTGGT
ACACAAAG	ACACAATG
ACACAAAT	ACACAATG
AATTTTAN	AATTTTAC
AATTTTCA	AATTTTAC
AATTTTCC	AATTTTAC
AATTTTCG	AATTTTAC
ACACAACG	ACACAATG
AATTTTCT	AATTTTAC
AATTTTCN	AATTTTAC
ACACAACT	ACACAATG
AATTTTGA	AATTTTAC
AATTTTGC	AATTTTAC
ACACAAGA	ACACAATG
ACACAAGC	ACACAATG
ACACAAGG	ACACAATG
AATTTTTA	AATTTTAC
ACACAAGT	ACACAATG
AATTTTTC	AATTTTAC
ACACAAGN	ACACAATG
ACACAATA	ACACAATG
ACACAATC	ACACAATG
AATTTTNA	AATTTTAC
ACACAATG	ACACAATG
AATTTTNC	AATTTTAC
ACACAATT	ACACAATG
ACCTTGAG	ACCTTGGT
ACACAATN	ACACAATG
ACCTTGAT	ACCTTGGT
AATTTNAC	AATTTTAC
ACACAANG	ACACAATG
ACACAANT	ACACAATG
ACACACAT	ACACAATG
ACGGACTT	TCGGACTT
AATTTNTA	AATTTTAC
ACACACTG	ACACAATG
AATGGCGT	AATGTCGT
ACCTTGCG	ACCTTGGT
ACCTTGCT	ACCTTGGT
ACCTTGGA	ACCTTGGT
ACCTTGGC	ACCTTGGT
ACCTTGGG	ACCTTGGT
ACGGAGGA	ACTGAGGA
ACCTTGGT	ACCTTGGT
ACCTTGGN	ACCTTGGT
ACGGAGGG	ACGAAGGG
ACACAGAT	ACACAATG
ACCTTGTA	ACCTTGGT
ACCTTGTC	ACCTTGGT
ACCTTGTG	ACCTTGGT
ACCTTGTT	ACCTTGGT
ACCTTGTN	ACCTTGGT
ACACAGTG	ACACAATG
ACCTTGNG	ACCTTGGT
ACCTTGNT	ACCTTGGT
AATTNATG	AATTATGT
ACCTTTAC	GCCTTTAC
ACACATAT	ACACAATG
ACACATCC	ACTCATCC
AATGGTCG	AATGTCGT
ACACATGA	ACACAATG
ACACATGC	ACACAATG
AATGGTGT	AATGTTGT
ACACATGG	ACACAATG
ACACATGT	ACACAATG
ACACATGN	ACACAATG
AATGGTTG	AATGTTGT
ACACATTG	ACACAATG
ACACANAT	ACACAATG
ACCTTTGG	ACCTTGGT
ACCTTTGT	ACCTTGGT
ACACANTG	ACACAATG
ACACCAAT	ACACAATG
ACACCATG	ACACAATG
ACAGCAAT	ACACAATG
ACCTTNGG	ACCTTGGT
ACCTTNGT	ACCTTGGT
AATTNTAC	AATTTTAC
ACAGCACC	AAGCACCC
ACAGCACG	ACAGCCGG
ACAGCAGG	ACAGCCGG
ACACCCGA	ACTCCCGA
ACACCCGG	ACAGCCGG
AATTNTGT	AATTATGT
AATTNTTA	AATTTTAC
ACGACAAT	ACACAATG
ACGACAGG	ACGAAGGG
AANAGCTC	AAAGCTCG
ACAGCCAG	ACAGCCGG
ACAGCCCG	ACAGCCGG
ACACCGGA	ACAGCCGG
ACACCGGC	ACAGCCGG
ACACCGGG	ACAGCCGG
ACACCGGT	ACAGCCGG
ACACCGGN	ACAGCCGG
AATNAAGA	AATAAGAA
ACAGCCGA	ACAGCCGG
ACAGCCGC	ACAGCCGG
ACAGCCGG	ACAGCCGG
ACAGCCGT	ACAGCCGG
ACAGCCGN	ACAGCCGG
ACAGCCTG	ACAGCCGG
ACGACGGG	ACGAAGGG
ACAGCCNG	ACAGCCGG
ACAGCGGA	ACAGCCGG
ACAGCGGC	ACAGCCGG
ACAGCGGG	ACAGCCGG
ACAGCGGT	ACAGCCGG
ACAGCGGN	ACAGCCGG
ACCTNGGT	ACCTTGGT
AATNAGAA	AATAAGAA
ACGACTCT	AGACTCTC
ACGACTTG	CCGACTTG
ACGGCCCA	CGGCCCAT
ACAGCTGG	ACAGCCGG
ACANAATG	ACACAATG
ACGGCCGG	ACAGCCGG
ACCTNTGG	ACCTTGGT
AATNATGT	AATTATGT
ACAGCNCG	ACAGCCGG
ACAGCNGG	ACAGCCGG
ACGAGAGG	ACGAAGGG
ACGAGCCG	ACAGCCGG
ACGAGCGC	AGAGCGCG
ACCAGCCG	ACAGCCGG
ACGAGCTA	TACGAGCT
ACGAGCTC	TACGAGCT
ACGGGACC	TCGGGACC
ACGAGCTG	TACGAGCT
ACGAGCTT	TACGAGCT
ACGAGCTN	TACGAGCT
ACGAGGAA	ACTGAGGA
ACGAGGAC	ACTGAGGA
ACGAGGAG	ACTGAGGA
ACGAGGAT	ACTGAGGA
ACGAGGAN	ACTGAGGA
ACACGAAT	ACACAATG
ACGAGGGA	ACGAAGGG
ACGAGGGC	ACGAAGGG
ACAGGCCC	CAGGCCCG
ACGAGGGG	ACGAAGGG
ACAGGCCG	ACAGCCGG
ACAGGCGG	ACAGCCGG
ACACGATG	ACACAATG
ACGAGGGT	ACGAAGGG
ACGAGGGN	ACGAAGGG
ACACGCCG	ACAGCCGG
ACAGGGGG	CAGGGGGG
ACGGGTGA	GCGGGTGA
ACANCAAT	ACACAATG
ACACGTTT	AACGTTTA
ACGATAGG	ACGAAGGG
ACAGTACT	CAGTACTC
ACACTAAT	ACACAATG
ACANCCGG	ACAGCCGG
ACCGAAGG	ACGAAGGG
ACGATGGG	ACGAAGGG
ACACTATG	ACACAATG
ACAGTCCG	ACAGCCGG
ACAGTCGG	ACAGCCGG
ACACTCAG	AACTCAGT
ACCGACTT	CCGACTTG
ACCGAGGA	ACTGAGGA
ACACTGTT	CACTGTTT
ACGANAGG	ACGAAGGG
ACCATATG	CCATATGC
ACACTTGG	ACCTTGGT
ACCATCCA	ACTCATCC
ACCATCCC	ACTCATCC
ACCATCCG	ACTCATCC
ACCATCCT	ACTCATCC
ACCATCCN	ACTCATCC
ACAGNCCG	ACAGCCGG
ACGANGGG	ACGAAGGG
ACAGNCGG	ACAGCCGG
ACACNAAT	ACACAATG
ACANGCCG	ACAGCCGG
ACACNATG	ACACAATG
ACCGCCGG	ACAGCCGG
ACCATGGT	ACCTTGGT
ACGTAAAC	ACTAAACG
ACGCAAGG	ACGAAGGG
ACGTAAGG	ACGAAGGG
ACGCAATG	ACACAATG
ACATAAAC	ACTAAACG
ACGCACCC	AAGCACCC
ACCATTGG	ACCTTGGT
ACATAAGA	AATAAGAA
ACGCACGA	CGCACGAC
ACGTAGAA	CGTAGAAA
ACGCAGGG	ACGAAGGG
ACATAATG	ACACAATG
ACGTAGGG	ACGAAGGG
ACGCATCC	ACTCATCC
ACGTATCA	AGCGTATC
ACGTATCC	AGCGTATC
ACGTATCG	AGCGTATC
ACGTATCT	AGCGTATC
ACGTATCN	AGCGTATC
ACAGAAGG	ACGAAGGG
ACAGAATG	ACACAATG
ACAGACCG	ACAGCCGG
ACATATGC	CCATATGC
ACGCCCGA	ACTCCCGA
ACGCCCGC	AGCCCGCG
ACGTCAGT	AGTCAGTT
ACGTCATC	ACTCATCC
ACCNTGGT	ACCTTGGT
ACAGACGG	ACAGCCGG
ACGCCGGA	ACAGCCGG
ACGCCGGC	ACAGCCGG
ACGCCGGG	ACAGCCGG
ACGCCGGT	ACAGCCGG
ACGCCGGN	ACAGCCGG
ACGCCGTT	AGCCGTTC
ACGTCCAT	ACTTCCAT
ACCNTTGG	ACCTTGGT
ACATCAAT	ACACAATG
ACAGAGCT	CAGAGCTT
ACAGAGGA	ACTGAGGA
ACATCATC	ACTCATCC
ACGTCCCG	ACTCCCGA
ACATCCAT	ACTTCCAT
ACGTCCGG	CGTCCGGG
ACATCCCG	ACTCCCGA
ACATCCGG	ACAGCCGG
ACATCGGT	CATCGGTC
ACCGTATC	AGCGTATC
ACCCAATG	ACACAATG
ACGTGAGG	ACTGAGGA
ACATGAGG	ACTGAGGA
ACGCGTAT	AGCGTATC
ACATGCCG	ACAGCCGG
ACCGTGGT	ACCTTGGT
ACCGTTCA	AGCCGTTC
ACCGTTCC	AGCCGTTC
ACCGTTCG	AGCCGTTC
ACCGTTCT	AGCCGTTC
ACCGTTCN	AGCCGTTC
ACCGTTGG	ACCTTGGT
ACCCATCC	ACTCATCC
ACCGTTTA	AACGTTTA
ACCCATGC	TCCCATGC
ACATGGAA	TACATGGA
ACATGGAC	TACATGGA
ACATGGAG	TACATGGA
ACATGGAT	TACATGGA
ACATGGAN	TACATGGA
ACCAAACG	ACTAAACG
ACCAAAGT	CCAAAGTC
ACATGTCG	AATGTCGT
ACATGTTG	AATGTTGT
ACGCTGGC	TCGCTGGC
ACCAAGGG	ACGAAGGG
ACGCTTGG	ACCTTGGT
ACCAATGA	ACACAATG
ACCAATGC	ACACAATG
ACCAATGG	ACACAATG
ACCAATGT	ACACAATG
ACATTATG	AATTATGT
ACCAATGN	ACACAATG
ACGAAACG	ACTAAACG
ACCCCCGA	ACTCCCGA
ACGAAAGG	ACGAAGGG
ACATTCCA	ACTTCCAT
ACGAAATG	AGAAATGC
ACCCCGAA	ACTCCCGA
ACNTAAAC	ACTAAACG
ACCCCGAC	ACTCCCGA
ACCCCGAG	ACTCCCGA
ACCCCGAT	ACTCCCGA
ACCCCGAN	ACTCCCGA
ACGAACGG	ACGAAGGG
ACATTGGT	ACCTTGGT
ACCACAAT	ACACAATG
ACCTAAAC	ACTAAACG
ACCTAACA	CCTAACAG
ACGAAGAG	ACGAAGGG
ACCCCGCG	AGCCCGCG
ACCCCGGC	CCCCGGCA
ACATTTTA	AATTTTAC
ACGAAGCG	ACGAAGGG
ACGAAGGA	ACGAAGGG
ACGAAGGC	ACGAAGGG
ACGAAGGG	ACGAAGGG
ACGAAGGT	ACGAAGGG
ACGAAGGN	ACGAAGGG
ACGTTCCA	ACTTCCAT
ACGAAGTG	ACGAAGGG
ACGAAGNG	ACGAAGGG
ACTAAAAC	ACTAAACG
ACTAAAAG	ACTAAACG
ACTAAACA	ACTAAACG
ACTAAACC	ACTAAACG
ACTAAACG	ACTAAACG
ACTAAACT	ACTAAACG
ACTAAACN	ACTAAACG
ACTAAAGA	ACTAAACG
ACTAAAGC	ACTAAACG
ACTAAAGG	ACTAAACG
ACTAAAGT	ACTAAACG
ACTAAAGN	ACTAAACG
ACTAAATC	ACTAAACG
ACCTAGGA	CCTAGGAA
ACTAAATG	ACTAAACG
ACCTAGGT	ACCTTGGT
ACGTTGCC	AGTTGCCT
ACTAAANC	ACTAAACG
ACTAAANG	ACTAAACG
ACTAACAC	ACTAAACG
ACGTTGGT	ACCTTGGT
ACTAACAG	CCTAACAG
ACGAATGG	ACGAAGGG
ACTAACCG	ACTAAACG
ACTAACGA	ACTAAACG
ACTAACGC	ACTAAACG
ACTAACGG	ACTAAACG
ACTAACGT	ACTAAACG
ACTAACGN	ACTAAACG
AGAAAAGC	AGAAATGC
ACTAAGAA	AATAAGAA
ACGAANGG	ACGAAGGG
ACTAAGAC	ACTAAACG
AGAAAATG	AGAAATGC
ACGTTTAA	AACGTTTA
ACGTTTAC	AACGTTTA
ACGTTTAG	AACGTTTA
ACGTTTAT	AACGTTTA
ACCTATGG	ACCTTGGT
ACNTCATC	ACTCATCC
ACGTTTAN	AACGTTTA
ACTAAGCG	ACTAAACG
ACTAAGGA	ACTGAGGA
ACTAAGGG	ACGAAGGG
ACNTCCAT	ACTTCCAT
AGAAACGC	AGAAATGC
ACNTCCCG	ACTCCCGA
AGAAACTG	AGAAATGC
ACTAATAC	ACTAAACG
ACTAATCC	ACTCATCC
ACTAATCG	ACTAAACG
AGAAAGCA	AGAAATGC
AGAAAGCC	AGAAATGC
AGAAAGCG	AGAAATGC
AGAAAGCT	AGAAATGC
AGAAAGCN	AGAAATGC
AGAAAGGC	AGAAATGC
ACCCGCGA	AGCCCGCG
ACCCGCGC	AGCCCGCG
ACCCGCGG	AGCCCGCG
AGAAAGTG	AGAAATGC
ACCCGCGT	AGCCCGCG
ACCCGCGN	AGCCCGCG
ACTAANAC	ACTAAACG
AGAAATAC	AGAAATGC
AGAAATAG	AGAAATGC
ACTAANCG	ACTAAACG
ACTCTATC	ACTCATCC
AGAAATCA	AGAAATGC
ACCCGGCA	CCCCGGCA
AGAAATCC	AGAAATGC
AGAAATCG	AGAAATGC
AGAAATCT	AGAAATGC
AGAAATCN	AGAAATGC
AGAAATGA	AGAAATGC
AGAAATGC	AGAAATGC
AGAAATGG	AGAAATGC
AGAAATGT	AGAAATGC
AGAAATGN	AGAAATGC
AGAAATTC	AGAAATGC
AGAAATTG	AGAAATGC
ACTCTCCC	ACTCATCC
AGAAATNC	AGAAATGC
AGAAATNG	AGAAATGC
ACTCTCCT	ACTCATCC
ACTACAAC	ACTAAACG
ACTCTCCN	ACTCATCC
ACTACAAT	ACACAATG
ACTCTCGC	CACTCTCG
ACTCTCGG	CACTCTCG
ACTCTCGT	CACTCTCG
ACTCTCGN	CACTCTCG
ACTACACG	ACTAAACG
ACTACAGG	ATTACAGG
AGAAANGC	AGAAATGC
ACTACATC	ACTCATCC
ACCCGTTC	AGCCGTTC
AGAAANTG	AGAAATGC
ACTACCAT	ACTTCCAT
ACTACCCG	ACTCCCGA
ACTACCGA	ACTCCCGA
ACNTGAGG	ACTGAGGA
AGAACATG	AGAAATGC
ACTCTTCC	ACTCATCC
ACTCTTGG	ACCTTGGT
ACTACTCG	CTACTCGT
ACCCTCAA	GACCCTCA
ACCCTCAC	GACCCTCA
AGAACGCA	GAACGCAT
ACCCTCAG	GACCCTCA
ACCCTCAT	GACCCTCA
AGAACGCG	AGAGCGCG
ACCCTCAN	GACCCTCA
ACNCTTGG	ACCTTGGT
ACCTCAGT	AACTCAGT
ACCCTGGT	ACCTTGGT
ACCTCATC	ACTCATCC
ACTCNATC	ACTCATCC
ACCTCCAT	ACTTCCAT
ACCCTTGG	ACCTTGGT
ACCTCCCG	ACTCCCGA
ACTAGAAC	ACTAAACG
AGAACTCT	AGACTCTC
ACTCNCCG	ACTCCCGA
AGAACTGC	AGAAATGC
ACTCNCGA	ACTCCCGA
ACTAGACG	ACTAAACG
ACTAGAGG	ACTGAGGA
ACNTTCCA	ACTTCCAT
ACCTCGGT	ACCTTGGT
ACTAGCCG	ACAGCCGG
ACNTTGGT	ACCTTGGT
ACTCNTCC	ACTCATCC
ACTAGGAC	ACTGAGGA
ACTAGGAG	ACTGAGGA
ACTAGGAT	ACTGAGGA
ACTAGGAN	ACTGAGGA
ACCTCTGG	ACCTTGGT
ACTAGTAG	GCTAGTAG
ACGNAAGG	ACGAAGGG
AGAAGATG	AGAAATGC
ACTGAAAC	ACTAAACG
ACTGAAAG	TCTGAAAG
ACTGAACG	ACTAAACG
ACTGAAGA	ACTGAGGA
ACTATAAC	ACTAAACG
ACNGAAGG	ACGAAGGG
ACTATACG	ACTAAACG
ACTGACGA	ACTGAGGA
ACTGACGG	ACTGAGGA
ACGNAGGG	ACGAAGGG
AGAAGCGC	AGAGCGCG
ACCTGAGG	ACTGAGGA
ACTGAGAA	ACTGAGGA
ACTGAGAC	ACTGAGGA
ACTATCCC	ACTCATCC
ACTGAGAG	ACTGAGGA
ACTATCCG	ACTCATCC
ACTGAGAT	ACTGAGGA
ACTATCCT	ACTCATCC
ACTGAGAN	ACTGAGGA
ACTATCCN	ACTCATCC
ACTGAGCA	ACTGAGGA
AGAAGCTA	GAAGCTAG
ACTGAGCG	ACTGAGGA
ACTGAGGA	ACTGAGGA
ACTGAGGC	ACTGAGGA
ACTGAGGG	ACTGAGGA
ACTGAGGT	ACTGAGGA
ACTGAGGN	ACTGAGGA
ACTGAGTA	ACTGAGGA
ACTGAGTG	ACTGAGGA
AGAAGCTC	AAAGCTCG
ACTGAGNA	ACTGAGGA
ACTGAGNG	ACTGAGGA
ACTTCAAT	ACTTCCAT
ACTTCACA	ACTTCCAT
ACNGAGGA	ACTGAGGA
ACTGATCC	ACTCATCC
ACTGATGA	ACTGAGGA
ACTTCATA	ACTTCCAT
ACTTCATG	ACTTCCAT
ACTGATGG	ACTGAGGA
ACTTCATT	ACTTCCAT
ACTTCATN	ACTTCCAT
AGAAGGGA	ACGAAGGG
AGAAGGGC	ACGAAGGG
AGAAGGGG	ACGAAGGG
AGAAGGGT	ACGAAGGG
AGAAGGGN	ACGAAGGG
ACTTCCAA	ACTTCCAT
ACTTCCAC	ACTTCCAT
ACTTCCAG	ACTTCCAT
ACTTCCAT	ACTTCCAT
ACTTCCAN	ACTTCCAT
ACTTCCCA	ACTTCCAT
ACTTCCCG	ACTCCCGA
ACTTCCCT	ACTTCCAT
ACTTCCGT	ACTTCCAT
ACTTCCTA	ACTTCCAT
ACTTCCTG	ACTTCCAT
ACTTCCTT	ACTTCCAT
ACTTCCTN	ACTTCCAT
ACTTCCNA	ACTTCCAT
ACCTGGGT	ACCTTGGT
ACCTGGTA	ACCTTGGT
ACCTGGTC	ACCTTGGT
ACCTGGTG	ACCTTGGT
ACCTGGTT	ACCTTGGT
ACTTCCNT	ACTTCCAT
ACCTGGTN	ACCTTGGT
ACTTCGAT	ACTTCCAT
ACTTCGCA	ACTTCCAT
ACTGANGA	ACTGAGGA
ACTANAAC	ACTAAACG
ACTGANGG	ACTGAGGA
ACTANACG	ACTAAACG
ACTTCTAT	ACTTCCAT
AGAAGTGC	AGAAATGC
ACTTCTCA	ACTTCCAT
ACNGCCGG	ACAGCCGG
ACCTGTGG	ACCTTGGT
ACTTCNAT	ACTTCCAT
ACTGCAGG	ACTGAGGA
ACTTCNCA	ACTTCCAT
ACTGCATC	ACTCATCC
ACTGCCAT	ACTTCCAT
ACTGCCCG	ACTCCCGA
ACTGCCGA	ACTCCCGA
ACTGCCGG	ACAGCCGG
ACTTGAGG	ACTGAGGA
ACTGCGGA	ACTGAGGA
AGAATATG	AGAAATGC
ACTTGCAT	ACTTCCAT
ACTTGCCA	ACTTCCAT
AGAATCTC	AGACTCTC
ACTTGCCT	AGTTGCCT
AGAATGCA	AGAAATGC
AGAATGCC	AGAAATGC
AGAATGCG	AGAAATGC
AGAATGCT	AGAAATGC
AGAATGCN	AGAAATGC
ACTTGGTA	ACCTTGGT
ACTTGGTC	ACCTTGGT
ACTTGGTG	ACCTTGGT
ACTTGGTT	ACCTTGGT
ACTTGGTN	ACCTTGGT
ACTGGAAC	TCTGGAAC
AGAATTGC	AGAAATGC
ACTGGAGG	ACTGAGGA
ACTGGCCA	CTGGCCAA
ACTCAAAC	ACTAAACG
ACTCAACC	ACTCATCC
ACTCAACG	ACTAAACG
ACTCAATC	ACTCATCC
ACTCAATG	ACACAATG
ACTGGGAA	ACTGAGGA
ACTGGGAC	ACTGAGGA
ACTGGGAG	ACTGAGGA
ACTGGGAT	ACTGAGGA
ACTGGGAN	ACTGAGGA
ACTGGGGA	ACTGAGGA
ACNAAACG	ACTAAACG
AGAANATG	AGAAATGC
ACTCACCA	ACTCATCC
ACTCACCC	ACTCATCC
ACTCACCT	ACTCATCC
ACTCACCN	ACTCATCC
ACTCACGA	ACTCCCGA
ACTGTAGG	ACTGAGGA
ACTCACTC	ACTCATCC
ACTCAGCC	ACTCATCC
ACTGTCAG	CTGTCAGA
ACTGTCCA	ACTTCCAT
ACTGTCGT	AATGTCGT
ACTTTCAT	ACTTCCAT
ACTGTGCC	CTGTGCCA
ACTGTGGA	ACTGAGGA
ACTCAGGA	ACTGAGGA
ACTCAGTA	AACTCAGT
ACTCAGTG	AACTCAGT
AGAANTGC	AGAAATGC
ACTGTTGT	AATGTTGT
ACTGTTTA	CACTGTTT
ACTGTTTC	CACTGTTT
ACTGTTTG	CACTGTTT
ACTGTTTT	CACTGTTT
ACTCAGTN	AACTCAGT
ACTGTTTN	CACTGTTT
ACTTTCCA	ACTTCCAT
ACNAAGGG	ACGAAGGG
ACTCATAC	ACTCATCC
ACTCATCA	ACTCATCC
ACTCATCC	ACTCATCC
ACTCATCG	ACTCATCC
ACTCATCT	ACTCATCC
ACTCATCN	ACTCATCC
ACTCATGC	ACTCATCC
ACTCATTC	ACTCATCC
ACTGNAGG	ACTGAGGA
ACTCATNC	ACTCATCC
ACTCANCC	ACTCATCC
ACTGNGGA	ACTGAGGA
ACTCANTC	ACTCATCC
ACNACAAT	ACACAATG
ACTTTGGC	CTTTGGCT
ACTTTGGT	ACCTTGGT
AGACACTC	AGACTCTC
ACTCCACG	ACTCCCGA
ACTCCAGA	ACTCCCGA
ACTCCATA	ACTTCCAT
ACTCCATG	ACTTCCAT
ACTCCATT	ACTTCCAT
ACTTTTAC	AATTTTAC
ACTCCATN	ACTTCCAT
AGACAGTT	AGTCAGTT
ACTCCCAA	ACTCCCGA
ACTCCCAC	ACTCCCGA
ACTCCCAG	ACTCCCGA
ACTCCCAN	ACTCCCGA
ACTCCCCA	ACTCCCGA
ACTCCCCG	ACTCCCGA
ACTCCCGA	ACTCCCGA
ACTTAAAC	ACTAAACG
ACTCCCGC	ACTCCCGA
ACTCCCGG	ACTCCCGA
ACTTAACG	ACTAAACG
ACTTTTTA	GCTTTTTA
ACTCCCGT	ACTCCCGA
ACTCCCGN	ACTCCCGA
ACTCCCTA	ACTCCCGA
ACTCCCTG	ACTCCCGA
ACTCCCNA	ACTCCCGA
ACTCCCNG	ACTCCCGA
ACTCCGAA	ACTCCCGA
ACTCCGAC	ACTCCCGA
ACTCCGAG	ACTCCCGA
ACTCCGAT	ACTCCCGA
AGACATCT	AGACTCTC
AGACATGC	AGAAATGC
ACTCCGAN	ACTCCCGA
ACTCCGCG	ACTCCCGA
ACTCCGGA	ACTCCCGA
ACTTACAG	ATTACAGG
ACTTACAT	ACTTCCAT
ACTTACCA	ACTTCCAT
ACTCCTCG	ACTCCCGA
ACTCCTGA	ACTCCCGA
AGCNCCGC	AGCCCGCG
ACTTNCAT	ACTTCCAT
ACTTNCCA	ACTTCCAT
ACTCCNCG	ACTCCCGA
ACTCCNGA	ACTCCCGA
AGCNCGCG	AGCCCGCG
AGGGGATC	GGGGATCC
ACTTAGGA	ACTGAGGA
AGCNCGTT	AGCCGTTC
ACTCGAGG	ACTGAGGA
ACTCGATC	ACTCATCC
ACTTATCC	ACTCATCC
ACTCGCCG	ACTCCCGA
ACTTATGT	AATTATGT
ACTCGCGA	ACTCCCGA
ACTNAAAC	ACTAAACG
ACTNAACG	ACTAAACG
ACTCGTCC	ACTCATCC
AGGGGGGA	CAGGGGGG
AGGGGGGC	CAGGGGGG
AGGGGGGT	CAGGGGGG
AGGGGGGN	CAGGGGGG
ACNAGCCG	ACAGCCGG
ACTNAGGA	ACTGAGGA
AGANGCGC	AGAGCGCG
AGGGTATC	AGCGTATC
ACTNATCC	ACTCATCC
AGGGTCGT	GGGTCGTA
AGGCACCC	AAGCACCC
AGGGTCTG	GGGTCTGC
AGAGNCGC	AGAGCGCG
AGAGNGCG	AGAGCGCG
AGCNGTAT	AGCGTATC
ACTNCATC	ACTCATCC
ACTNCCAT	ACTTCCAT
ACTNCCCG	ACTCCCGA
ACTNCCGA	ACTCCCGA
AGCNGTTC	AGCCGTTC
AGGCAGTT	AGTCAGTT
AGGCATAG	GGCATAGA
AGATAACC	TGATAACC
AGATAAGA	AATAAGAA
AGATAATA	GATAATAT
AGATAATG	AGAAATGC
AGACCCGC	AGCCCGCG
AGACCCTT	TGACCCTT
AGCNTATC	AGCGTATC
AGATATGC	AGAAATGC
ACTNGAGG	ACTGAGGA
AGATATTG	GATATTGG
AGACCGTT	AGCCGTTC
AGATCAGT	AGTCAGTT
AGGCCCAT	CGGCCCAT
AGANTCTC	AGACTCTC
AGACCTCA	AGACTCTC
AGACCTCC	AGACTCTC
AGACCTCG	AGACTCTC
AGACCTCT	AGACTCTC
AGACCTCN	AGACTCTC
AGGCCCGA	CAGGCCCG
AGGCCCGG	CAGGCCCG
AGGCCCGT	CAGGCCCG
AGGCCCGN	CAGGCCCG
AGGCCGCG	AGCCCGCG
AGATCGCG	AGAGCGCG
AGGCCGTT	AGCCGTTC
AGATCTCA	AGACTCTC
ACNCAATG	ACACAATG
AGATCTCC	AGACTCTC
AGATCTCG	AGACTCTC
AGATCTCT	AGACTCTC
AGATCTCN	AGACTCTC
ACNCATCC	ACTCATCC
AGACGCGA	AGAGCGCG
AGACGCGC	AGAGCGCG
AGACGCGG	AGAGCGCG
AGACGCGT	AGAGCGCG
ACTNTCCA	ACTTCCAT
AGACGCGN	AGAGCGCG
AGGCGAGA	GGCGAGAC
AGATGCCT	AGTTGCCT
AGACGCTC	AGACTCTC
AGATGCGC	AGAGCGCG
AGGTATAA	GGTATAAC
AGGTATCA	AGCGTATC
AGGTATCC	AGCGTATC
AGGTATCG	AGCGTATC
AGGTATCT	AGCGTATC
AGGTATCN	AGCGTATC
AGGCGCGA	AGAGCGCG
AGGCGCGC	AGAGCGCG
AGGCGCGG	AGAGCGCG
AGGCGCGT	AGAGCGCG
AGGCGCGN	AGAGCGCG
AGACGTAT	AGCGTATC
AGACGTCT	AGACTCTC
AGGAAATG	AGAAATGC
AGACGTTC	AGCCGTTC
ACNCCCGA	ACTCCCGA
AGACGTTT	AACGTTTA
AGGTCAGT	AGTCAGTT
AGGCGTAT	AGCGTATC
AGGAAGGG	ACGAAGGG
AGGCGTTC	AGCCGTTC
AGATGTCG	AATGTCGT
AGGAATGC	AGAAATGC
AGACTACT	AGACTCTC
AGATGTTG	AATGTTGT
AGACTATC	AGACTCTC
AGACTCAC	AGACTCTC
AGACTCAG	AACTCAGT
AGACTCAT	AGACTCTC
AGACTCCA	AGACTCTC
AGCAAATG	AGAAATGC
AGACTCCC	AGACTCTC
AGGCTAGT	GGCTAGTT
AGACTCCG	AGACTCTC
AGACTCCT	AGACTCTC
AGACTCCN	AGACTCTC
AGACTCGC	AGACTCTC
AGGTCGTA	GGGTCGTA
AGCCACGC	AGCCCGCG
AGACTCGT	AGACTCTC
AGACTCTA	AGACTCTC
AGACTCTC	AGACTCTC
AGACTCTG	AGACTCTC
AGACTCTT	AGACTCTC
AGACTCTN	AGACTCTC
AGACTCNC	AGACTCTC
AGACTCNT	AGACTCTC
AGCGTAAC	AGCGTATC
AGCGTAAT	AGCGTATC
AGCCAGCG	AGCCCGCG
AGCGTACA	AGCGTATC
AGCGTACC	AGCGTATC
AGCGTACG	AGCGTATC
AGCGTACT	AGCGTATC
AGCGTACN	AGCGTATC
AGACTGCT	AGACTCTC
AGGCTCTC	AGACTCTC
AGCGTAGC	AGCGTATC
AGCGTAGT	AGCGTATC
AGCGTATA	AGCGTATC
AGCGTATC	AGCGTATC
AGCGTATG	AGCGTATC
AGACTGTC	AGACTCTC
AGCGTATT	AGCGTATC
AGCGTATN	AGCGTATC
AGCGTANC	AGCGTATC
AGCGTANT	AGCGTATC
AGGTCTGC	GGGTCTGC
AGCGTCAT	AGCGTATC
AGCAACGG	GCAACGGC
AGACTTCA	AGACTCTC
AGACTTCC	AGACTCTC
AGCCATTC	AGCCGTTC
AGACTTCG	AGACTCTC
AGCGTCTC	AGCGTATC
AGACTTCT	AGACTCTC
AGACTTCN	AGACTCTC
AGACTTTC	AGACTCTC
AGATTATG	AATTATGT
AGACTNCT	AGACTCTC
AGACTNTC	AGACTCTC
AGCGTGAT	AGCGTATC
AGGTGAGG	TGGTGAGG
AGGACTCT	AGACTCTC
AGCGTGTC	AGCGTATC
AGCCCACG	AGCCCGCG
AGGTGCCT	AGTTGCCT
AGCCCAGC	AGCCCGCG
AGCGTTAT	AGCGTATC
AGATTCTC	AGACTCTC
AGCAATAC	GCAATACT
AGCCCCCG	AGCCCGCG
AGCAATGC	AGAAATGC
AGCGTTTA	AACGTTTA
AGCGTTTC	AGCGTATC
AGCCCCGA	AGCCCGCG
AGCCCCGC	AGCCCGCG
AGCCCCGG	AGCCCGCG
AGATTGCC	AGTTGCCT
AGCCCCGT	AGCCCGCG
AGCCCCGN	AGCCCGCG
AGCGTNAT	AGCGTATC
AGGTGGGA	GGTGGGAA
AGCCCGAC	AGCCCGCG
AGCCCGAG	AGCCCGCG
AGCCCGCA	AGCCCGCG
AGCGTNTC	AGCGTATC
AGCCCGCC	AGCCCGCG
AGCCCGCG	AGCCCGCG
AGCCCGCT	AGCCCGCG
AGCCCGCN	AGCCCGCG
AGCCCGGA	AGCCCGCG
AGCCCGGC	AGCCCGCG
AGCCCGGG	AGCCCGCG
AGCCCGGT	AGCCCGCG
AGCCCGGN	AGCCCGCG
AGCCCGTC	AGCCCGCG
AGCCCGTG	AGCCCGCG
AGATTTTA	AATTTTAC
AGCCCGTT	AGCCGTTC
AGCCCGNC	AGCCCGCG
AGCCCGNG	AGCCCGCG
AGCGNATC	AGCGTATC
AGCCCTCG	AGCCCGCG
AGCCCTGC	AGCCCGCG
AGCACAAT	ACACAATG
AGCCCTTC	AGCCGTTC
AGGAGCGC	AGAGCGCG
AGCCCNCG	AGCCCGCG
AGCCCNGC	AGCCCGCG
AGACNCTC	AGACTCTC
AGCACCCA	AAGCACCC
AGCACCCC	AAGCACCC
AGCACCCG	AAGCACCC
AGCACCCT	AAGCACCC
AGCACCCN	AAGCACCC
AGCCGATC	AGCCGTTC
AGCCGATT	AGCCGTTC
AGCGNTAT	AGCGTATC
AGCACCGC	AGCCCGCG
AGCCGCGA	AGCCCGCG
AGCCGCGC	AGCCCGCG
AGCCGCGG	AGCCCGCG
AGCCGCGT	AGCCCGCG
AGCCGCGN	AGCCCGCG
AGCACGAC	CGCACGAC
AGCCGCTC	AGCCGTTC
AGCCGCTT	AGCCGTTC
AGCACGCG	AGCCCGCG
AGGTTCTG	GGTTCTGA
AGCCGGCG	AGCCCGCG
AGCCGGTC	AGCCGTTC
AGCCGGTT	AGCCGTTC
AGCTAAAC	ACTAAACG
AGGTTGCC	AGTTGCCT
AGCCGTAC	AGCCGTTC
AGCACGTT	AGCCGTTC
AGCCGTCA	AGCCGTTC
AGCCGTCC	AGCCGTTC
AGCCGTCG	AGCCGTTC
AGCCGTCT	AGCCGTTC
AGCCGTCN	AGCCGTTC
AGCCGTGC	AGCCGTTC
AGGATACA	GGGATACA
AGCCGTGT	AGCCGTTC
AGCACTCT	AGACTCTC
AGCCGTTA	AGCCGTTC
AGCCGTTC	AGCCGTTC
AGCCGTTG	AGCCGTTC
AGCCGTTT	AGCCGTTC
AGCCGTTN	AGCCGTTC
AGCCGTNC	AGCCGTTC
AGCCGTNT	AGCCGTTC
AGGATCAA	TGGATCAA
AGACNTCT	AGACTCTC
AGCCGNTC	AGCCGTTC
AGCCGNTT	AGCCGTTC
AGANAATG	AGAAATGC
AGCTAGTA	GCTAGTAG
AGCTAGTT	GGCTAGTT
AGCCTATC	AGCGTATC
AGCTATCA	AGCGTATC
AGCTATCC	AGCGTATC
AGGGATAC	GGGATACA
AGCTATCG	AGCGTATC
AGCTATCT	AGCGTATC
AGCTATCN	AGCGTATC
AGCCTCGC	AGCCCGCG
AGGGATCC	GGGGATCC
AGCCTCTC	AGACTCTC
AGCCTGCG	AGCCCGCG
AGANATGC	AGAAATGC
AGCCTGTT	AGCCGTTC
AGCCTTCA	AGCCGTTC
AGCCTTCC	AGCCGTTC
AGCCTTCG	AGCCGTTC
AGCCTTCT	AGCCGTTC
AGCCTTCN	AGCCGTTC
AGCCTTGG	ACCTTGGT
AGCCTTTA	GCCTTTAC
AGCCTTTC	AGCCGTTC
AGCTCATC	ACTCATCC
AGCAGCCG	ACAGCCGG
AGCAGCGC	AGAGCGCG
AGCTCCCG	ACTCCCGA
AGCTCCGC	AGCCCGCG
AGCTCGCG	AGCCCGCG
AGCTCGTT	AGCCGTTC
AGANCGCG	AGAGCGCG
AGGGCGCG	AGAGCGCG
AGCAGTAT	AGCGTATC
AGCTCTCA	AGACTCTC
AGCTCTCC	AGACTCTC
AGCTCTCG	AGACTCTC
AGCTCTCT	AGACTCTC
AGCTCTCN	AGACTCTC
AGCAGTTA	AGTCAGTT
AGCAGTTG	AGTCAGTT
AGCAGTTT	AGTCAGTT
AGANCTCT	AGACTCTC
AGCCNCGC	AGCCCGCG
AGAGAATG	AGAAATGC
AGCAGTTN	AGTCAGTT
AGCCNGCG	AGCCCGCG
AGCCNGTT	AGCCGTTC
AGCTGAGG	ACTGAGGA
AGAGACGC	AGAGCGCG
AGTATAAC	GGTATAAC
AGAGACTA	TGAGACTA
AGCCNTTC	AGCCGTTC
AGCTGCCT	AGTTGCCT
AGCATAGA	GGCATAGA
AGAGAGCG	AGAGCGCG
AGCATATC	AGCGTATC
ATAACAGG	ATTACAGG
AGCGAAGG	ACGAAGGG
AGCGAATC	AGCGTATC
AGCTGTAT	AGCGTATC
AGNGCGCG	AGAGCGCG
AGTATGCC	AGTTGCCT
AGNTTGCC	AGTTGCCT
AGAGATGC	AGAAATGC
AGCTGTTC	AGCCGTTC
AGCGAGAC	GGCGAGAC
AGCGATAT	AGCGTATC
AGCGATCA	AGCGTATC
AGCGATCC	AGCGTATC
AGCGATCG	AGCGTATC
AGCGATCT	AGCGTATC
AGCGATCN	AGCGTATC
AGCTTATC	AGCGTATC
AGCTTCCA	ACTTCCAT
AGAGCACC	AAGCACCC
AGAGCACG	AGAGCGCG
AGAGCAGA	TAGAGCAG
AGAGCAGG	TAGAGCAG
AGAGCAGT	TAGAGCAG
AGAGCAGN	TAGAGCAG
AGCTTGCC	AGTTGCCT
ATAAGAAA	AATAAGAA
ATAAGAAC	AATAAGAA
ATAAGAAG	AATAAGAA
ATAAGAAT	AATAAGAA
ATAAGAAN	AATAAGAA
AGCTTGGT	ACCTTGGT
AGAGCCCG	AGAGCGCG
AGCTTTTT	GCTTTTTA
AGCGCATC	AGCGTATC
AGAGCCGA	AGAGCGCG
AGAGCCGC	AGAGCGCG
AGAGCCGT	AGAGCGCG
AGAGCCGN	AGAGCGCG
ATAAGCTC	AAAGCTCG
AGCGCCGC	AGCCCGCG
AGAGCGAC	AGAGCGCG
AGAGCGAG	AGAGCGCG
AGAGCGCA	AGAGCGCG
AGAGCGCC	AGAGCGCG
AGAGCGCG	AGAGCGCG
AGAGCGCT	AGAGCGCG
AGAGCGCN	AGAGCGCG
AGAGCGGA	AGAGCGCG
AGAGCGGC	AGAGCGCG
AGAGCGGG	AGAGCGCG
AGAGCGGT	AGAGCGCG
AGAGCGGN	AGAGCGCG
AGAGCGTC	AGAGCGCG
AGAGCGTG	AGAGCGCG
AGAGCGNC	AGAGCGCG
AGTGCAGT	AGTCAGTT
ATAAGGGG	TAAGGGGC
AGNGTATC	AGCGTATC
AGAGCGNG	AGAGCGCG
AGCGCGTT	AGCCGTTC
AGCGCTAT	AGCGTATC
AGTGCCTA	AGTTGCCT
AGTGCCTC	AGTTGCCT
AGTGCCTG	AGTTGCCT
AGTGCCTT	AGTTGCCT
AGAGCTCT	AGACTCTC
AGTGCCTN	AGTTGCCT
AGAGCTGC	AGAGCGCG
AGTGCGAT	GTGCGATC
AGAGCTTA	CAGAGCTT
AGTGCGCG	AGAGCGCG
AGAGCTTC	CAGAGCTT
AGAGCTTG	CAGAGCTT
AGAGCTTT	CAGAGCTT
AGAGCTTN	CAGAGCTT
AGCGGATC	AGCGTATC
AGAGCNCG	AGAGCGCG
AGAGCNGC	AGAGCGCG
ATAATATA	GATAATAT
ATAATATC	GATAATAT
AGTGGCCT	AGTTGCCT
AGTGGCTT	GTGGCTTC
ATAATATG	GATAATAT
ATAATATT	GATAATAT
ATAATATN	GATAATAT
AGTGGGAA	GGTGGGAA
AGCGGGTG	GCGGGTGA
AGTCAAGT	AGTCAGTT
AGTCAATT	AGTCAGTT
AGCGGTAT	AGCGTATC
AGTCACGT	AGTCAGTT
AGTCACTT	AGTCAGTT
AGCGGTTC	AGCCGTTC
AGAGGCGA	AGAGCGCG
AGAGGCGC	AGAGCGCG
AGAGGCGG	AGAGCGCG
AGAGGCGT	AGAGCGCG
AGTCAGAT	AGTCAGTT
AGAGGCGN	AGAGCGCG
AGTCAGCT	AGTCAGTT
AGTCAGGT	AGTCAGTT
AGTCAGTA	AGTCAGTT
AGTCAGTC	AGTCAGTT
AGTGTATC	AGCGTATC
AGTCAGTG	AGTCAGTT
AGTCAGTT	AGTCAGTT
AGTCAGTN	AGTCAGTT
AGTCAGNT	AGTCAGTT
AGAGGGCG	AGAGCGCG
AGTCATCC	ACTCATCC
AGTGTCGT	AATGTCGT
AGTCATGT	AGTCAGTT
AGTCATTA	AGTCAGTT
AGTCATTC	AGTCAGTT
AGTCATTG	AGTCAGTT
AGTCATTT	AGTCAGTT
AGTCATTN	AGTCAGTT
AGTGTGCC	AGTTGCCT
AGTCANGT	AGTCAGTT
AGTCANTT	AGTCAGTT
AGTTNCCT	AGTTGCCT
AGTGTTGT	AATGTTGT
AGTCCACC	GTCCACCT
AGTCCAGT	AGTCAGTT
AGTCCCGA	ACTCCCGA
AGTCCCGC	AGCCCGCG
AGNAGCGC	AGAGCGCG
AGTTNGCC	AGTTGCCT
AGTCCGCG	AGCCCGCG
AGTCCGGG	CGTCCGGG
AGTCCTCC	ATTCCTCC
AGAGTATC	AGCGTATC
AGNTCAGT	AGTCAGTT
AGAGTCGC	AGAGCGCG
AGAGTCTC	AGACTCTC
AGAGTGCG	AGAGCGCG
AGTCGAGT	AGTCAGTT
AGTTACAG	ATTACAGG
ATACAATG	ACACAATG
AGTTACCT	AGTTGCCT
AGTCGCCT	AGTTGCCT
AGTNAGTT	AGTCAGTT
AGTTAGCC	AGTTGCCT
AGTTAGTT	AGTCAGTT
ATACAGGA	ATTACAGG
ATACAGGC	ATTACAGG
ATACAGGG	ATTACAGG
ATACAGGT	ATTACAGG
ATACAGGN	ATTACAGG
AGTTATGT	AATTATGT
AGTCGGTT	AGTCAGTT
ATACATGG	TACATGGA
AGTNCAGT	AGTCAGTT
AGTCGTAT	AGCGTATC
AGTCGTTA	AGTCAGTT
AGTCGTTG	AGTCAGTT
AGTTCAGT	AGTCAGTT
AGTCGTTT	AGTCAGTT
AGTCGTTN	AGTCAGTT
AGNTGCCT	AGTTGCCT
AGTCTAGT	AGTCAGTT
AGTTCCAT	ACTTCCAT
AGTTCCCT	AGTTGCCT
AGTCTCTC	AGACTCTC
AGTTCCTA	AGTTGCCT
AGTTCCTG	AGTTGCCT
AGTTCCTT	AGTTGCCT
AGTTCCTN	AGTTGCCT
AGTCTGCC	AGTTGCCT
AGTNGCCT	AGTTGCCT
AGTTCGCC	AGTTGCCT
AGTCTGTT	AGTCAGTT
ATACCTCC	ATTCCTCC
AGTTCTAC	GTTCTACG
AGTTCTGA	GGTTCTGA
AGTCTTTG	GTCTTTGG
ATACGAGC	TACGAGCT
AGTCNAGT	AGTCAGTT
AGTTGACC	AGTTGCCT
AGTTGACT	AGTTGCCT
AGNCAGTT	AGTCAGTT
AGTNTGCC	AGTTGCCT
ATGAAATG	AGAAATGC
AGTCNGTT	AGTCAGTT
ATAAAAAT	TAAAAATC
AGTTGCAC	AGTTGCCT
ATAAAATA	TTAAAATA
ATGAAGGG	ACGAAGGG
AGTTGCAT	AGTTGCCT
AGTTGCCA	AGTTGCCT
AGTTGCCC	AGTTGCCT
AGTTGCCG	AGTTGCCT
AGNCCCGC	AGCCCGCG
ATACGTTT	AACGTTTA
ATAAACGA	ACTAAACG
ATAAACGC	ACTAAACG
ATAAACGG	ACTAAACG
ATAAACGT	ACTAAACG
ATAAACGN	ACTAAACG
AGNCCGCG	AGCCCGCG
AGTTGCCT	AGTTGCCT
AGTTGCCN	AGTTGCCT
AGNCCGTT	AGCCGTTC
AGTTGCGC	AGTTGCCT
AGTTGCGT	AGTTGCCT
AGTTGCTA	AGTTGCCT
AGTTGCTC	AGTTGCCT
AGTTGCTG	AGTTGCCT
AGTTGCTT	AGTTGCCT
AGTTGCTN	AGTTGCCT
AGTTGCNC	AGTTGCCT
ATAAAGAT	TAAAGATT
AGTTGCNT	AGTTGCCT
AGTTGGCC	AGTTGCCT
ATGACAGG	ATTACAGG
AGTTGGCT	AGTTGCCT
ATGACCCT	TGACCCTT
ATAAATGA	TAAATGAC
ATAAATGC	AGAAATGC
AGTTGTCC	AGTTGCCT
AGTTGTCT	AGTTGCCT
ATACTCAG	AACTCAGT
AGTGAGGA	ACTGAGGA
ATGACTCT	AGACTCTC
ATACTCGT	CTACTCGT
AGTGAGTT	AGTCAGTT
ATACTCTC	AGACTCTC
ATGCGATC	GTGCGATC
AGTTGNCC	AGTTGCCT
AGTTGNCT	AGTTGCCT
AGNCGTAT	AGCGTATC
ATGCGTAT	AGCGTATC
ATGAGACT	TGAGACTA
AGNCGTTC	AGCCGTTC
ATGAGCGC	AGAGCGCG
AGNAAATG	AGAAATGC
AGTTTCCT	AGTTGCCT
ATGAGGAA	ACTGAGGA
ATGAGGAC	ACTGAGGA
ATGAGGAG	ACTGAGGA
ATGAGGAT	ACTGAGGA
ATGAGGAN	ACTGAGGA
AGTTTGCC	AGTTGCCT
ATATGTCG	AATGTCGT
ATATGTTG	AATGTTGT
AGNCTCTC	AGACTCTC
AGTTTTAC	AATTTTAC
AGNAATGC	AGAAATGC
ATATTATG	AATTATGT
ATGTACAG	ATTACAGG
ATGATAAC	TGATAACC
ATCAAAAG	TTCAAAAG
ATATTGGA	GATATTGG
ATATTGGC	GATATTGG
ATATTGGG	GATATTGG
ATATTGGT	GATATTGG
ATATTGGN	GATATTGG
ATGTCAGA	CTGTCAGA
ATGTCAGT	AGTCAGTT
AGNACTCT	AGACTCTC
ATGTCCTC	ATTCCTCC
ATATTTTA	AATTTTAC
ATGTCGTA	AATGTCGT
ATGTCGTC	AATGTCGT
ATGTCGTG	AATGTCGT
ATGTCGTT	AATGTCGT
ATGTCGTN	AATGTCGT
ATCTCAGT	AACTCAGT
ATCTCATC	ACTCATCC
ATCTCCCG	ACTCCCGA
ATCTCCTC	ATTCCTCC
ATCCTCCA	ATTCCTCC
ATCCTCCC	ATTCCTCC
ATCCTCCG	ATTCCTCC
ATCCTCCT	ATTCCTCC
ATCCTCCN	ATTCCTCC
AGTAAACG	ACTAAACG
AGTAAATG	AGAAATGC
ATCCTTGG	ACCTTGGT
ATGGATCA	TGGATCAA
ATCACAAT	ACACAATG
AGTAAGAA	AATAAGAA
ATCTGAAA	TCTGAAAG
ATCACAGG	ATTACAGG
ATCTGAGG	ACTGAGGA
AGTAAGTT	AGTCAGTT
ATGTGCCA	CTGTGCCA
AGTAATGC	AGAAATGC
ATGTGGGC	TTGTGGGC
ATCTGGAA	TCTGGAAC
ATGGCCAA	CTGGCCAA
AGTACAGG	ATTACAGG
AGTACAGT	AGTCAGTT
AGTACTCA	CAGTACTC
ATCTTCCA	ACTTCCAT
AGTACTCC	CAGTACTC
AGTACTCG	CAGTACTC
AGTACTCN	CAGTACTC
ATCAGCCG	ACAGCCGG
ATGTTGCC	AGTTGCCT
ATCTTGGT	ACCTTGGT
ATGTTGTA	AATGTTGT
ATGTTGTC	AATGTTGT
ATGTTGTG	AATGTTGT
ATGTTGTT	AATGTTGT
ATGTTGTN	AATGTTGT
AGTAGAAA	CGTAGAAA
ATCTTTGG	GTCTTTGG
ATGGCTTC	GTGGCTTC
AGTAGCCT	AGTTGCCT
AGTAGCGC	AGAGCGCG
ATCAGTTA	AGTCAGTT
ATCAGTTC	AGTCAGTT
ATCAGTTG	AGTCAGTT
ATCAGTTT	AGTCAGTT
ATCAGTTN	AGTCAGTT
ATCGAAGG	ACGAAGGG
AGTAGTTA	AGTCAGTT
AGTAGTTC	AGTCAGTT
AGTAGTTG	AGTCAGTT
AGTAGTTT	AGTCAGTT
AGTAGTTN	AGTCAGTT
ATCATCCA	ACTCATCC
ATCATCCC	ACTCATCC
ATCATCCG	ACTCATCC
ATCATCCT	ACTCATCC
ATCATCCN	ACTCATCC
ATGCACCC	AAGCACCC
ATGGTGAG	TGGTGAGG
ATCGCTGG	TCGCTGGC
ATAGAGCA	TAGAGCAG
ATGCCCGC	AGCCCGCG
ATCGGACT	TCGGACTT
ATGCCGTT	AGCCGTTC
ATGCCTCC	ATTCCTCC
ATCGGGAC	TCGGGACC
ATAGCACC	AAGCACCC
ATAGCCGG	ACAGCCGG
ATAGCGCG	AGAGCGCG
ATCGGTCA	CATCGGTC
ATCGGTCC	CATCGGTC
ATCGGTCG	CATCGGTC
ATCGGTCT	CATCGGTC
ATCGGTCN	CATCGGTC
ATAGCTCG	AAAGCTCG
ATCCACCT	GTCCACCT
ATCGTATC	AGCGTATC
ATAGTAAC	TTAGTAAC
ATCCCATG	TCCCATGC
ATCCCGAA	ACTCCCGA
ATCCCGAC	ACTCCCGA
ATCCCGAG	ACTCCCGA
ATCCCGAT	ACTCCCGA
ATCCCGAN	ACTCCCGA
ATCCCGCG	AGCCCGCG
ATTCCACC	ATTCCTCC
ATTCCAGG	ATTACAGG
ATTCCATA	ACTTCCAT
ATTCCATG	ACTTCCAT
ATTCCATT	ACTTCCAT
ATTCCATN	ACTTCCAT
ATCCCTCC	ATTCCTCC
ATCGTTTA	AACGTTTA
ATTCCCCA	ATTCCTCC
ATTCCCCC	ATTCCTCC
ATTCCCCG	ATTCCTCC
ATTCCCCT	ATTCCTCC
ATTCCCCN	ATTCCTCC
ATTCCCGA	ACTCCCGA
ATTCCCTC	ATTCCTCC
ATTCCGCC	ATTCCTCC
ATTCCGTC	ATTCCTCC
ATNTACAG	ATTACAGG
ATTCCTAC	ATTCCTCC
ATTCCTCA	ATTCCTCC
ATTCCTCC	ATTCCTCC
ATTCCTCG	ATTCCTCC
ATTCCTCT	ATTCCTCC
ATTCCTCN	ATTCCTCC
ATTCCTGC	ATTCCTCC
ATTCCTTC	ATTCCTCC
ATTCCTNC	ATTCCTCC
ATTCCNCC	ATTCCTCC
ATTCCNTC	ATTCCTCC
ATCCGTTC	AGCCGTTC
ATTCGCTC	ATTCCTCC
ATCTAAAC	ACTAAACG
ATATAAGA	AATAAGAA
ATCTACAG	ATTACAGG
ATTCGTCC	ATTCCTCC
ATATACAG	ATTACAGG
ANACAATG	ACACAATG
ATTCTACG	GTTCTACG
ATNTCCTC	ATTCCTCC
ATATCCTC	ATTCCTCC
ATTTACAG	ATTACAGG
ATTCTCCA	ATTCCTCC
ATTTACCC	TTTACCCT
ATTCTCCC	ATTCCTCC
ATTCTCCG	ATTCCTCC
ATTCTCCT	ATTCCTCC
ATTCTCCN	ATTCCTCC
ATTCTCTC	ATTCCTCC
ATTTATGT	AATTATGT
ATTCTTCC	ATTCCTCC
ATTTCAGG	ATTACAGG
ANAAATGC	AGAAATGC
ATTTCCAT	ACTTCCAT
ATTTCCTC	ATTCCTCC
ATTTCTCC	ATTCCTCC
ATTTGCCT	AGTTGCCT
ATNCCTCC	ATTCCTCC
ATTCNCTC	ATTCCTCC
ATTTGGCT	CTTTGGCT
ANACGTTT	AACGTTTA
ATTCNTCC	ATTCCTCC
ATTTTACA	AATTTTAC
ATTTTACC	AATTTTAC
ATTTTACG	AATTTTAC
ATTTTACT	AATTTTAC
ATTTTACN	AATTTTAC
ANAAGCTC	AAAGCTCG
ANACTCAG	AACTCAGT
ANACTCTC	AGACTCTC
ATTTTTAC	AATTTTAC
ATNACAGG	ATTACAGG
ATTAAAAT	TTAAAATA
ATTAAACG	ACTAAACG
ATTAAAGG	ATTACAGG
ATTGACAG	ATTACAGG
ATTAACAG	ATTACAGG
ATTGAGGA	ACTGAGGA
ATTAAGAA	AATAAGAA
ATTAAGGA	ATTACAGG
ATTAAGGC	ATTACAGG
ATTAAGGG	ATTACAGG
ATTAAGGT	ATTACAGG
ATTAAGGN	ATTACAGG
ANGAGCGC	AGAGCGCG
ATTNACAG	ATTACAGG
ATTGCAGG	ATTACAGG
ATTGCCTA	AGTTGCCT
ATTGCCTG	AGTTGCCT
ATTGCCTT	AGTTGCCT
ATTGCCTN	AGTTGCCT
ATTNCAGG	ATTACAGG
ATTGCTCC	ATTCCTCC
ATTACAAG	ATTACAGG
ATTACACG	ATTACAGG
ATTACAGA	ATTACAGG
ATTACAGC	ATTACAGG
ATTACAGG	ATTACAGG
ATTACAGT	ATTACAGG
ATTACAGN	ATTACAGG
ATTACATG	ATTACAGG
ATTNCCTC	ATTCCTCC
ATTACANG	ATTACAGG
ATTACCAG	ATTACAGG
ATTACCCT	TTTACCCT
ATTNCTCC	ATTCCTCC
ATTACCGG	ATTACAGG
ATTACCTC	ATTCCTCC
ATTACGAG	ATTACAGG
ATTACGGA	ATTACAGG
ATTACGGC	ATTACAGG
ATTACGGG	ATTACAGG
ATTACGGT	ATTACAGG
ATTACGGN	ATTACAGG
ANAGCACC	AAGCACCC
ATTACTAG	ATTACAGG
ATTACTCC	ATTCCTCC
ATTACTGG	ATTACAGG
ATTACNAG	ATTACAGG
ATTACNGG	ATTACAGG
ANAGCCGG	ACAGCCGG
ATTAGAGG	ATTACAGG
ATTAGCAG	ATTACAGG
ANAGCGCG	AGAGCGCG
ANGCACCC	AAGCACCC
ANAGCTCG	AAAGCTCG
ATTAGTAA	TTAGTAAC
ATTGTCGT	AATGTCGT
ATTATAGG	ATTACAGG
ATTATCAG	ATTACAGG
ATTGTGGG	TTGTGGGC
ANGCCCGC	AGCCCGCG
ANGTTGCC	AGTTGCCT
ATTATGTA	AATTATGT
ATTATGTC	AATTATGT
ATTATGTG	AATTATGT
ATTATGTT	AATTATGT
ATTATGTN	AATTATGT
ATTGTTGT	AATGTTGT
ANGCCGTT	AGCCGTTC
ATTANAGG	ATTACAGG
ATTANCAG	ATTACAGG
ANGCGTAT	AGCGTATC
ATTCAAAA	TTCAAAAG
ANCGTATC	AGCGTATC
ATTCACAG	ATTACAGG
ATTCACTC	ATTCCTCC
ATTCAGGA	ATTACAGG
ATTCAGGC	ATTACAGG
ATTCAGGG	ATTACAGG
ANGTCAGT	AGTCAGTT
ATTCAGGT	ATTACAGG
ATTCAGGN	ATTACAGG
ANCCCGCG	AGCCCGCG
ATTCAGTT	AGTCAGTT
ANCGTTTA	AACGTTTA
ANCCGTTC	AGCCGTTC
ANCCTTGG	ACCTTGGT
ANCTAAAC	ACTAAACG
CAAAAATC	TAAAAATC
CAAAAGTC	CCAAAGTC
ANCGAAGG	ACGAAGGG
ANCTCAGT	AACTCAGT
ANCTCATC	ACTCATCC
ANCTCCCG	ACTCCCGA
ANATAAGA	AATAAGAA
CAAACCTA	CAACCTAA
CAAACTAA	CAACCTAA
ANCTGAGG	ACTGAGGA
ANTAAACG	ACTAAACG
ANTAAGAA	AATAAGAA
CAAAGATT	TAAAGATT
CAAAGCTC	AAAGCTCG
CAAAGCTT	CAGAGCTT
ANTTGCCT	AGTTGCCT
CAACGCAT	GAACGCAT
CAAAGTCA	CCAAAGTC
CAAAGTCC	CCAAAGTC
CAAAGTCG	CCAAAGTC
CAAAGTCT	CCAAAGTC
CAAAGTCN	CCAAAGTC
CAACGCTA	CAACCTAA
CAACGGCA	GCAACGGC
CAACGGCC	GCAACGGC
CAACGGCG	GCAACGGC
ANCTTCCA	ACTTCCAT
CAACGGCT	GCAACGGC
CAACGGCN	GCAACGGC
CAACGGTC	CATCGGTC
ANCTTGGT	ACCTTGGT
CAACGTAA	CAACCTAA
CAACGTTT	AACGTTTA
CAACTAAA	CAACCTAA
CAACTAAC	CAACCTAA
CAACTAAG	CAACCTAA
CAACTAAT	CAACCTAA
CAACTAAN	CAACCTAA
ANCACAAT	ACACAATG
CAAATGAC	TAAATGAC
ANTTTTAC	AATTTTAC
CAACTCAG	AACTCAGT
CAACTCGT	CTACTCGT
CAACTCTA	CAACCTAA
ANATGTCG	AATGTCGT
CAACTCTC	CACTCTCG
ANATGTTG	AATGTTGT
CAACTGTT	CACTGTTT
CAACTTAA	CAACCTAA
ANGAAATG	AGAAATGC
ANATTATG	AATTATGT
ANGAAGGG	ACGAAGGG
ANATTTTA	AATTTTAC
CAACNCTA	CAACCTAA
ANCAGCCG	ACAGCCGG
CAACNTAA	CAACCTAA
ANGACTCT	AGACTCTC
ANTACAGG	ATTACAGG
CAAGAGCT	CAGAGCTT
CAACACTA	CAACCTAA
CAAGCACC	AAGCACCC
CAACATAA	CAACCTAA
CAAGCCCG	CAGGCCCG
CAAGCCTA	CAACCTAA
CAAGCTAA	CAACCTAA
CAAGCTAG	GAAGCTAG
CAAGCTCG	AAAGCTCG
CAACCAAA	CAACCTAA
CAACCAAC	CAACCTAA
CAACCAAG	CAACCTAA
CAACCAAT	CAACCTAA
CAACCAAN	CAACCTAA
CAAGCTTA	CAGAGCTT
CAAGCTTC	CAGAGCTT
CAAGCTTG	CAGAGCTT
CAAGCTTT	CAGAGCTT
CAAGCTTN	CAGAGCTT
CAACCATA	CAACCTAA
CAACCCAA	CAACCTAA
CAACCCTA	CAACCTAA
CAACCGAA	CAACCTAA
CAACCGTA	CAACCTAA
CAAGGCCC	CAGGCCCG
CAAGGGGC	TAAGGGGC
CAAGGGGG	CAGGGGGG
CAACCTAA	CAACCTAA
CAACCTAC	CAACCTAA
CAACCTAG	CAACCTAA
CAACCTAT	CAACCTAA
CAACCTAN	CAACCTAA
CAACCTCA	CAACCTAA
CAACCTGA	CAACCTAA
ANTGAGGA	ACTGAGGA
CAACCTTA	CAACCTAA
CAACCTNA	CAACCTAA
CAAGTACT	CAGTACTC
CAACCNAA	CAACCTAA
CAACCNTA	CAACCTAA
CAGGTACT	CAGTACTC
CAGGTCCC	CAGGCCCG
CAGGTCCG	CAGGCCCG
CAGGTGGG	CAGGGGGG
CAGCACCC	AAGCACCC
CAGCACGA	CGCACGAC
CAGCACTC	CAGTACTC
CAGGNCCC	CAGGCCCG
CAGGNCCG	CAGGCCCG
CAGCAGCT	CAGAGCTT
CAGGNGGG	CAGGGGGG
CAGTAACT	CAGTACTC
CAGTAATC	CAGTACTC
CAGCCCAT	CGGCCCAT
CAGTACAC	CAGTACTC
CAGCCCCG	CAGGCCCG
CAGCCCGA	CAGGCCCG
CAGTACAT	CAGTACTC
CAGCCCGG	CAGGCCCG
CAGTACCA	CAGTACTC
CAGTACCC	CAGTACTC
CAGTACCG	CAGTACTC
CAGTACCT	CAGTACTC
CAGTACCN	CAGTACTC
CAGTACGC	CAGTACTC
CAGTACGT	CAGTACTC
CAGTACTA	CAGTACTC
CAGTACTC	CAGTACTC
CAGTACTG	CAGTACTC
CAGTACTT	CAGTACTC
CAGTACTN	CAGTACTC
ANTCAGTT	AGTCAGTT
CAGTACNC	CAGTACTC
CAGCCCGT	CAGGCCCG
CAGTACNT	CAGTACTC
CAGCCCGN	CAGGCCCG
CAGTAGAA	CGTAGAAA
ANTCATCC	ACTCATCC
CAGTAGTC	CAGTACTC
CAGTATCA	CAGTACTC
CAGTATCC	CAGTACTC
CAGTATCG	CAGTACTC
CAGTATCT	CAGTACTC
CAGTATCN	CAGTACTC
CAGTATTC	CAGTACTC
CAGCCGGA	ACAGCCGG
CAGCCGGC	ACAGCCGG
CAGCCGGG	ACAGCCGG
CAGTANCT	CAGTACTC
CAGTANTC	CAGTACTC
ANTGTCGT	AATGTCGT
CAGCCGGT	ACAGCCGG
CAGCCGGN	ACAGCCGG
CAGCCGTT	AGCCGTTC
CAGTCACT	CAGTACTC
CAGTCAGA	CTGTCAGA
CAGTCAGT	AGTCAGTT
CAGCCTAA	CAACCTAA
CAGNCCCG	CAGGCCCG
CACCCGGC	CCCCGGCA
CAGTCCCG	CAGGCCCG
CAGTCCGG	CGTCCGGG
CAGTCCTC	CAGTACTC
CACCCTAA	CAACCTAA
ANTCCCGA	ACTCCCGA
CACCCTCA	GACCCTCA
CACCCTCG	CACTCTCG
CAGTCGGT	CATCGGTC
CAGTCTCA	CAGTACTC
CAGTCTCC	CAGTACTC
CAGTCTCT	CAGTACTC
CAGTCTCN	CAGTACTC
ANTCCTCC	ATTCCTCC
ANTGTTGT	AATGTTGT
CAGTGACT	CAGTACTC
CAGTGCCA	CTGTGCCA
CAGTGCCC	CAGGCCCG
CAGTGCTC	CAGTACTC
CAGTGCTT	CAGAGCTT
CACCGGCA	CCCCGGCA
CACCGGTC	CATCGGTC
CAGTGGGG	CAGGGGGG
CAGCGCCC	CAGGCCCG
CACCGTTT	CACTGTTT
CAGTGTTT	CACTGTTT
CAGCGCTT	CAGAGCTT
CACCTAAA	CAACCTAA
CACCTAAC	CAACCTAA
CAGNGCCC	CAGGCCCG
CACCTAAG	CAACCTAA
CACCTAAT	CAACCTAA
CACCTAAN	CAACCTAA
CAGTTACT	CAGTACTC
CAGNGCTT	CAGAGCTT
CAGNGGGG	CAGGGGGG
CACCTCGA	CACTCTCG
CACCTCGC	CACTCTCG
CACCTCGG	CACTCTCG
CAGCGGGG	CAGGGGGG
CACCTCGT	CACTCTCG
CACCTCGN	CACTCTCG
CAGTTCTC	CAGTACTC
CACCTCTC	CACTCTCG
CAGCGGTC	CATCGGTC
CAGTTGCC	AGTTGCCT
CAGCGTAT	AGCGTATC
CACCTGTT	CACTGTTT
ANTTACAG	ATTACAGG
CACCTTGG	ACCTTGGT
CAGNTACT	CAGTACTC
CAGCTACT	CAGTACTC
CAGCTCTC	CACTCTCG
CAATAAGA	AATAAGAA
CAGTNACT	CAGTACTC
CAGCTGTT	CACTGTTT
ANTTATGT	AATTATGT
CAATACTA	GCAATACT
CAATACTG	GCAATACT
CAATACTT	GCAATACT
CAATACTN	GCAATACT
CAGTNCTC	CAGTACTC
ANTTCCAT	ACTTCCAT
CACTAAAC	ACTAAACG
CACTAACA	CCTAACAG
ANTTCCTC	ATTCCTCC
CAATATGC	CCATATGC
CACTAGGA	CCTAGGAA
CACGAAGG	ACGAAGGG
CACTAGTT	CACTGTTT
CACTATCG	CACTCTCG
CAGNACTC	CAGTACTC
CACTATTT	CACTGTTT
CATAACAG	CCTAACAG
CAATCCTA	CAACCTAA
CAGNAGCT	CAGAGCTT
CACGACTT	CCGACTTG
CACTCACG	CACTCTCG
CATAAGAA	AATAAGAA
CAATCGGT	CATCGGTC
CACTCAGT	AACTCAGT
CAATCTAA	CAACCTAA
CAATCTCG	CACTCTCG
CACTCCGA	CACTCTCG
CACTCCGC	CACTCTCG
CACTCCGG	CACTCTCG
CACTCCGT	CACTCTCG
CACTCCGN	CACTCTCG
CACTCCTC	CACTCTCG
CATAATAT	GATAATAT
CACTCGCG	CACTCTCG
CACTCGGT	CATCGGTC
CAGGACCC	CAGGCCCG
CAGGACCG	CAGGCCCG
CAGGACTC	CAGTACTC
CACTCGTA	CTACTCGT
CACTCGTG	CTACTCGT
CACTCGTN	CTACTCGT
CACTCTAC	CACTCTCG
CACTCTAG	CACTCTCG
CAGGAGCT	CAGAGCTT
CACTCTCA	CACTCTCG
CACTCTCC	CACTCTCG
CAGGAGGG	CAGGGGGG
CACTCTCG	CACTCTCG
CACTCTCT	CACTCTCG
CACTCTCN	CACTCTCG
CACTCTGA	CACTCTCG
CACTCTGC	CACTCTCG
CACTCTGG	CACTCTCG
CACTCTGT	CACTCTCG
CACTCTGN	CACTCTCG
CACTCTTC	CACTCTCG
CACTCTTG	CACTCTCG
CACTCTTT	CACTGTTT
CACTCTNC	CACTCTCG
CACTCTNG	CACTCTCG
CATACCTA	CAACCTAA
CCAAGAGT	CCAAAGTC
CACTCNCG	CACTCTCG
CACTCNTC	CACTCTCG
CATACGGT	CATCGGTC
CATACTCA	CAGTACTC
CATACTCC	CAGTACTC
CAATGTCG	AATGTCGT
CACTGAGG	ACTGAGGA
CATACTCT	CAGTACTC
CATACTCN	CAGTACTC
CACTGATT	CACTGTTT
CCAAGGAA	CCTAGGAA
CAATGTTG	AATGTTGT
CAATGTTT	CACTGTTT
CCAAGGTC	CCAAAGTC
CACTGCTC	CACTCTCG
CACTGCTT	CACTGTTT
CACNGTTT	CACTGTTT
CATAGAAA	CGTAGAAA
CAGGCACC	CAGGCCCG
CAGGCACG	CAGGCCCG
CCAAGTCA	CCAAAGTC
CCAAGTCC	CCAAAGTC
CCAAGTCG	CCAAAGTC
CCAAGTCT	CCAAAGTC
CCAAGTCN	CCAAAGTC
CACTGGTT	CACTGTTT
CACTGTAT	CACTGTTT
CACTGTCG	CACTCTCG
CACTGTCT	CACTGTTT
CAGGCCAA	CTGGCCAA
CAGGCCAC	CAGGCCCG
CAATTATG	AATTATGT
CACTGTGT	CACTGTTT
CAGGCCAG	CAGGCCCG
CACTGTTA	CACTGTTT
CACTGTTC	CACTGTTT
CACTGTTG	CACTGTTT
CAGGCCCC	CAGGCCCG
CACTGTTT	CACTGTTT
CACGCCCG	CAGGCCCG
CAGGCCCG	CAGGCCCG
CACTGTTN	CACTGTTT
CAGGCCCT	CAGGCCCG
CAGGCCCN	CAGGCCCG
CAGGCCGA	CAGGCCCG
CACTGTNT	CACTGTTT
CAGGCCGC	CAGGCCCG
CAGGCCGG	CAGGCCCG
CAGGCCGT	CAGGCCCG
CAGGCCGN	CAGGCCCG
CAGGCCTC	CAGGCCCG
CAGGCCTG	CAGGCCCG
CAGGCCNC	CAGGCCCG
CAGGCCNG	CAGGCCCG
CACTGNTT	CACTGTTT
CAGGCGCC	CAGGCCCG
CAGGCGCG	CAGGCCCG
CAGGCGGG	CAGGGGGG
CATAGCTT	CAGAGCTT
CATAGGAA	CCTAGGAA
CAGGCTCC	CAGGCCCG
CAGGCTCG	CAGGCCCG
CACTTCCA	ACTTCCAT
CACTTCGA	CACTCTCG
CACTTCGC	CACTCTCG
CACNTCTC	CACTCTCG
CACTTCGG	CACTCTCG
CACTTCGT	CACTCTCG
CACTTCGN	CACTCTCG
CATAGGTC	CATCGGTC
CACTTCTC	CACTCTCG
CAGGCTTA	CAGAGCTT
CAGGCTTC	CAGAGCTT
CAGGCTTG	CAGAGCTT
CAGGCTTT	CAGAGCTT
CAGGCTTN	CAGAGCTT
CCAATACT	GCAATACT
CCAATAGT	CCAAAGTC
CAGGCNCC	CAGGCCCG
CAGGCNCG	CAGGCCCG
CACTTGTT	CACTGTTT
CAATTTTA	AATTTTAC
CACTTTCG	CACTCTCG
CACTTTTA	CACTGTTT
CACTTTTC	CACTGTTT
CACTTTTG	CACTGTTT
CACTTTTT	CACTGTTT
CACTTTTN	CACTGTTT
CACAAAGT	CCAAAGTC
CACNTGTT	CACTGTTT
CCAATATG	CCATATGC
CACGCTCG	CACTCTCG
CAGGGAGG	CAGGGGGG
CAGGGCCC	CAGGCCCG
CAGGGCCG	CAGGCCCG
CAGGGCGG	CAGGGGGG
CAGGGCTT	CAGAGCTT
CAGGGGAG	CAGGGGGG
CAGGGGCG	CAGGGGGG
CACAATGA	ACACAATG
CACTNCTC	CACTCTCG
CACAATGC	ACACAATG
CAGGGGGA	CAGGGGGG
CACAATGG	ACACAATG
CAGGGGGC	CAGGGGGG
CACAATGT	ACACAATG
CAGGGGGG	CAGGGGGG
CACAATGN	ACACAATG
CAGGGGGT	CAGGGGGG
CAGGGGGN	CAGGGGGG
CAGGGGTG	CAGGGGGG
CAGGGGNG	CAGGGGGG
CATATGCA	CCATATGC
CACTNGTT	CACTGTTT
CATATGCC	CCATATGC
CATATGCG	CCATATGC
CATATGCT	CCATATGC
CAGGGTGG	CAGGGGGG
CATATGCN	CCATATGC
CACACAAT	ACACAATG
CACTNTCG	CACTCTCG
CCAATGCA	CCATATGC
CCAATGCC	CCATATGC
CCAATGCG	CCATATGC
CCAATGCT	CCATATGC
CCAATGCN	CCATATGC
CACTNTTT	CACTGTTT
CCAATGTC	CCAAAGTC
CATATTGG	GATATTGG
CACGGCCC	CAGGCCCG
CAGGGNGG	CAGGGGGG
CACACCTA	CAACCTAA
CACGGGGG	CAGGGGGG
CACACGAC	CGCACGAC
CCAGAAGT	CCAAAGTC
CACGGTCA	CATCGGTC
CACGGTCC	CATCGGTC
CACGGTCG	CATCGGTC
CACGGTCT	CATCGGTC
CACGGTCN	CATCGGTC
CCAANAGT	CCAAAGTC
CACACTCG	CACTCTCG
CACGGTTT	CACTGTTT
CCAGACTT	CCGACTTG
CAGAAATG	AGAAATGC
CCAGAGCT	CAGAGCTT
CCAGAGTC	CCAAAGTC
CACGTACT	CAGTACTC
CAGAACTC	CAGTACTC
CCAANGTC	CCAAAGTC
CAGAACTT	CAGAGCTT
CAGAAGCT	CAGAGCTT
CCAGATGC	CCATATGC
CACGTCTC	CACTCTCG
CACGTGTT	CACTGTTT
CACAGCCG	ACAGCCGG
CACGTTTC	CACTGTTT
CCACAAGT	CCAAAGTC
CCAGCCGG	ACAGCCGG
CACGTTTG	CACTGTTT
CCACAATG	ACACAATG
CACGTTTT	CACTGTTT
CACGTTTN	CACTGTTT
CACAGCTT	CAGAGCTT
CAANCCTA	CAACCTAA
CACNCTCG	CACTCTCG
CAGACCCG	CAGGCCCG
CCACAGTC	CCAAAGTC
CAANCTAA	CAACCTAA
CCACATGC	CCATATGC
CAGACCTA	CAACCTAA
CAGACCTT	CAGAGCTT
CACAGTTT	CACTGTTT
CAGACGCT	CAGAGCTT
CAGACTCA	CAGTACTC
CAGACTCC	CAGTACTC
CAGACTCG	CAGTACTC
CAGACTCN	CAGTACTC
CAGACTTA	CAGAGCTT
CAGACTTC	CAGAGCTT
CAGACTTT	CAGAGCTT
CAGACTTN	CAGAGCTT
CCAGGAAA	CCTAGGAA
CCAGGAAC	CCTAGGAA
CCAGGAAG	CCTAGGAA
CCAGGAAT	CCTAGGAA
CCAGGAAN	CCTAGGAA
CCACCGGC	CCCCGGCA
CACATATG	CCATATGC
CAGAGACT	CAGAGCTT
CCACCTAA	CAACCTAA
CACATCTC	CACTCTCG
CAGAGATT	CAGAGCTT
CAGAGCAG	TAGAGCAG
CAGAGCAT	CAGAGCTT
CCAGGCCC	CAGGCCCG
CAGAGCCC	CAGGCCCG
CAGAGCCT	CAGAGCTT
CACATGGA	TACATGGA
CAGAGCGC	AGAGCGCG
CAGAGCGT	CAGAGCTT
CAGAGCTA	CAGAGCTT
CAGAGCTC	CAGAGCTT
CAGAGCTG	CAGAGCTT
CAGAGCTT	CAGAGCTT
CAGAGCTN	CAGAGCTT
CAGAGCNT	CAGAGCTT
CCACGACA	CGCACGAC
CCACGACC	CGCACGAC
CCACGACG	CGCACGAC
CCACGACT	CGCACGAC
CCACGACN	CGCACGAC
CACATGTT	CACTGTTT
CAGAGGCT	CAGAGCTT
CATNCGGT	CATCGGTC
CAGAGGGG	CAGGGGGG
CAGAGGTT	CAGAGCTT
CAGAGTCT	CAGAGCTT
CAGAGTTA	CAGAGCTT
CCACGGCA	CCCCGGCA
CAGAGTTC	CAGAGCTT
CAGAGTTG	CAGAGCTT
CAGAGTTT	CAGAGCTT
CAGAGTTN	CAGAGCTT
CCAGGGGG	CAGGGGGG
CAGAGNCT	CAGAGCTT
CAGAGNTT	CAGAGCTT
CAGATACT	CAGTACTC
CAGATCTT	CAGAGCTT
CAGATGCT	CAGAGCTT
CATNGGTC	CATCGGTC
CCACTATG	CCATATGC
CCAGTACT	CAGTACTC
CCAGTATG	CCATATGC
CATCAGGT	CATCGGTC
CAGANCTT	CAGAGCTT
CATCAGTC	CATCGGTC
CCACTCGT	CTACTCGT
CAGANGCT	CAGAGCTT
CCACTCTC	CACTCTCG
CCACTGTT	CACTGTTT
CCACTTGA	CCGACTTG
CCACTTGC	CCGACTTG
CCACTTGG	CCGACTTG
CCACTTGT	CCGACTTG
CCACTTGN	CCGACTTG
CANCCTAA	CAACCTAA
CATGGCCA	CTGGCCAA
CATGGCCC	CAGGCCCG
CATCCGGG	CGTCCGGG
CATCCGGT	CATCGGTC
CATCCGTC	CATCGGTC
CATCCTAA	CAACCTAA
CATGGGGG	CAGGGGGG
CATGGGTC	CATCGGTC
CANCGGTC	CATCGGTC
CANGCCCG	CAGGCCCG
CATGGTCA	CATCGGTC
CATGGTCC	CATCGGTC
CATGGTCG	CATCGGTC
CATGGTCT	CATCGGTC
CATGGTCN	CATCGGTC
CATCGAGT	CATCGGTC
CATCGATC	CATCGGTC
CATGTACT	CAGTACTC
CATCGCGT	CATCGGTC
CATCGCTC	CATCGGTC
CATCGGAC	CATCGGTC
CATCGGAT	CATCGGTC
CCGTCAGA	CTGTCAGA
CATCGGCA	CATCGGTC
CATCGGCC	CATCGGTC
CATCGGCG	CATCGGTC
CATCGGCT	CATCGGTC
CANCTCTC	CACTCTCG
CATCGGCN	CATCGGTC
CATCGGGC	CATCGGTC
CATGTCAG	CTGTCAGA
CATCGGGT	CATCGGTC
CATCGGTA	CATCGGTC
CATCGGTC	CATCGGTC
CATCGGTG	CATCGGTC
CATCGGTT	CATCGGTC
CATCGGTN	CATCGGTC
CATCGGNC	CATCGGTC
CATGTCGT	AATGTCGT
CCGTCCGG	CGTCCGGG
CANCTGTT	CACTGTTT
CATCGGNT	CATCGGTC
CATGTGCC	CTGTGCCA
CATCGTCA	CATCGGTC
CATCGTCC	CATCGGTC
CATCGTCG	CATCGGTC
CATCGTCT	CATCGGTC
CATCGTCN	CATCGGTC
CATCGTGT	CATCGGTC
CATCGTTC	CATCGGTC
CATGTTGT	AATGTTGT
CATGTTTA	CACTGTTT
CATGTTTC	CACTGTTT
CATGTTTG	CACTGTTT
CATGTTTT	CACTGTTT
CATGTTTN	CACTGTTT
CCGTCTTG	CCGACTTG
CATCGNGT	CATCGGTC
CATCGNTC	CATCGGTC
CCAAAAGT	CCAAAGTC
CCAAAATC	CCAAAGTC
CCATAACA	CCTAACAG
CCAAACAG	CCTAACAG
CCATAAGC	CCATATGC
CCATAAGT	CCAAAGTC
CCATAATG	CCATATGC
CCGTGCCA	CTGTGCCA
CANACCTA	CAACCTAA
CCAAACGT	CCAAAGTC
CANGGCCC	CAGGCCCG
CCAAACTC	CCAAAGTC
CCATACGC	CCATATGC
CCAAAGAC	CCAAAGTC
CCATACTG	CCATATGC
CCAAAGAT	CCAAAGTC
CCAAAGCA	CCAAAGTC
CCAAAGCC	CCAAAGTC
CCAAAGCG	CCAAAGTC
CCATAGCA	CCATATGC
CCATAGCC	CCATATGC
CCATAGCG	CCATATGC
CCATAGCT	CCATATGC
CCATAGCN	CCATATGC
CCATAGGA	CCTAGGAA
CCAAAGCT	CCAAAGTC
CCATAGGC	CCATATGC
CCAAAGCN	CCAAAGTC
CCAAAGGC	CCAAAGTC
CCAAAGGT	CCAAAGTC
CCAAAGTA	CCAAAGTC
CCAAAGTC	CCAAAGTC
CCAAAGTG	CCAAAGTC
CCAAAGTT	CCAAAGTC
CCAAAGTN	CCAAAGTC
CCAAAGNC	CCAAAGTC
CCATAGTC	CCAAAGTC
CCAAAGNT	CCAAAGTC
CCATAGTG	CCATATGC
CANGGGGG	CAGGGGGG
CCAAATCA	CCAAAGTC
CCAAATCC	CCAAAGTC
CCATATAC	CCATATGC
CCATATAG	CCATATGC
CATCTCGA	CACTCTCG
CATCTCGC	CACTCTCG
CATCTCGG	CACTCTCG
CCATATCA	CCATATGC
CATCTCGT	CACTCTCG
CCATATCC	CCATATGC
CATCTCGN	CACTCTCG
CCATATCG	CCATATGC
CATCTCTC	CACTCTCG
CCATATCT	CCATATGC
CCATATCN	CCATATGC
CCATATGA	CCATATGC
CCATATGC	CCATATGC
CCATATGG	CCATATGC
CCATATGT	CCATATGC
CCATATGN	CCATATGC
CCATATTC	CCATATGC
CCATATTG	CCATATGC
CCAAATCG	CCAAAGTC
CCAAATCT	CCAAAGTC
CCATATNC	CCATATGC
CCAAATCN	CCAAAGTC
CCATATNG	CCATATGC
CCAAATGC	CCATATGC
CCAAATGT	CCAAAGTC
CCAAATTC	CCAAAGTC
CCATANGC	CCATATGC
CANGAGCT	CAGAGCTT
CCATANTG	CCATATGC
CATCTGGT	CATCGGTC
CATCTGTC	CATCGGTC
CATCTGTT	CACTGTTT
CCAAANGT	CCAAAGTC
CCAAANTC	CCAAAGTC
CANAGCTT	CAGAGCTT
CCATCATG	CCATATGC
CANGTACT	CAGTACTC
CCAACAGA	CCTAACAG
CCAACAGC	CCTAACAG
CCAACAGG	CCTAACAG
CCAACAGN	CCTAACAG
CCCTGGCA	CCCCGGCA
CCATCGGT	CATCGGTC
CCAACCTA	CAACCTAA
CCCTGTTT	CACTGTTT
CCATCTGC	CCATATGC
CATTACAG	ATTACAGG
CCAACGGC	GCAACGGC
CCAACGTC	CCAAAGTC
CATTACTC	CAGTACTC
CCCCNGCA	CCCCGGCA
CCCCNGGC	CCCCGGCA
CCATGATG	CCATATGC
CCCTTGGT	ACCTTGGT
CCAACTTG	CCGACTTG
CCCTTTAC	GCCTTTAC
CATCNGGT	CATCGGTC
CATCNGTC	CATCGGTC
CATTATGT	AATTATGT
CCATGTGC	CCATATGC
CCCGACTT	CCGACTTG
CATTCCTC	ATTCCTCC
CATTCGGT	CATCGGTC
CCGCTGGC	TCGCTGGC
CANTACTC	CAGTACTC
CCGCTTGA	CCGACTTG
CCGCTTGC	CCGACTTG
CCGCTTGG	CCGACTTG
CCGCTTGT	CCGACTTG
CCGCTTGN	CCGACTTG
CCGNACTT	CCGACTTG
CATTCTCG	CACTCTCG
CATGAGCT	CAGAGCTT
CCCGCGGC	CCCCGGCA
CCTAAAAG	CCTAACAG
CCTAAACA	CCTAACAG
CANTCGGT	CATCGGTC
CANTCTCG	CACTCTCG
CCTAAACG	ACTAAACG
CCTAAAGA	CCTAACAG
CCTAAAGC	CCTAACAG
CCTAAAGG	CCTAACAG
CCTAAAGN	CCTAACAG
CCCNCGGC	CCCCGGCA
CCTAACAA	CCTAACAG
CCTAACAC	CCTAACAG
CCTAACAG	CCTAACAG
CATTGGCT	CTTTGGCT
CATTGGTC	CATCGGTC
CATGCCCG	CAGGCCCG
CCCGGCAA	CCCCGGCA
CCCGGCAC	CCCCGGCA
CCCGGCAG	CCCCGGCA
CCCGGCAT	CCCCGGCA
CCCGGCAN	CCCCGGCA
CCTAACAT	CCTAACAG
CCTAACAN	CCTAACAG
CCTAACCA	CCTAACAG
CCTAACCG	CCTAACAG
CCTAACGA	CCTAACAG
CCTAACGC	CCTAACAG
CCTAACGG	CCTAACAG
CCTAACGT	CCTAACAG
CCTAACGN	CCTAACAG
CCTAACTA	CCTAACAG
CATTGTTT	CACTGTTT
CCTAACTG	CCTAACAG
CCTAACNA	CCTAACAG
CCTAACNG	CCTAACAG
CCTAAGAA	CCTAGGAA
CCTAAGAG	CCTAACAG
CATGCGGT	CATCGGTC
CCCGGGCA	CCCCGGCA
CCTAAGCA	CCTAACAG
CCTAAGGA	CCTAGGAA
CCTAAGTC	CCAAAGTC
CCTAATAG	CCTAACAG
CCTAATCA	CCTAACAG
CANTGTTT	CACTGTTT
CCTAANAG	CCTAACAG
CCTAANCA	CCTAACAG
CCTACACA	CCTAACAG
CCATTATG	CCATATGC
CCTACAGA	CCTAACAG
CCTACAGC	CCTAACAG
CCTACAGG	CCTAACAG
CCTACAGT	CCTAACAG
CCTACAGN	CCTAACAG
CATTTGGC	CTTTGGCT
CCCNGGCA	CCCCGGCA
CCTACCAG	CCTAACAG
CCGNCTTG	CCGACTTG
CATTTTAC	AATTTTAC
CCATTGCA	CCATATGC
CCATTGCC	CCATATGC
CCATTGCG	CCATATGC
CCATTGCT	CCATATGC
CCTACGAA	CCTAGGAA
CCATTGCN	CCATATGC
CCTACGGA	CCTAGGAA
CCATTTGC	CCATATGC
CCTACTCG	CTACTCGT
CCTACTTG	CCGACTTG
CCGGCCAA	CTGGCCAA
CCTAGAAC	CCTAGGAA
CCTAGAAG	CCTAGGAA
CCTAGAAT	CCTAGGAA
CCTAGAAN	CCTAGGAA
CCTAGACA	CCTAACAG
CCGGCCCA	CGGCCCAT
CCATNATG	CCATATGC
CCGGCCCG	CAGGCCCG
CCTAGAGA	CCTAGGAA
CCGAAAGT	CCAAAGTC
CCTAGCAA	CCTAGGAA
CCTAGCAG	CCTAACAG
CCGAACAG	CCTAACAG
CCTAGCGA	CCTAGGAA
CCGAACTT	CCGACTTG
CCTAGGAA	CCTAGGAA
CCTAGGAC	CCTAGGAA
CCTAGGAG	CCTAGGAA
CCTAGGAT	CCTAGGAA
CCTAGGAN	CCTAGGAA
CCTAGGCA	CCTAGGAA
CCATNTGC	CCATATGC
CCTAGGGA	CCTAGGAA
CCGAAGGG	ACGAAGGG
CCTAGGTA	CCTAGGAA
CCGAAGTC	CCAAAGTC
CCTAGGNA	CCTAGGAA
CCTAGTAA	CCTAGGAA
CCTAGTAG	GCTAGTAG
CCGGCTTG	CCGACTTG
CCTAGTGA	CCTAGGAA
CCTAGNAA	CCTAGGAA
CCANAAGT	CCAAAGTC
CCGGGACC	TCGGGACC
CCGAATTG	CCGACTTG
CCTAGNGA	CCTAGGAA
CCCTAACA	CCTAACAG
CCTATACA	CCTAACAG
CCTATATG	CCATATGC
CCANAGTC	CCAAAGTC
CCTATCAG	CCTAACAG
CCGGGGGG	CAGGGGGG
CCANATGC	CCATATGC
CCCTAGGA	CCTAGGAA
CCTATGAA	CCTAGGAA
CCTATGCA	CCATATGC
CCTATGCC	CCATATGC
CCCACGAC	CGCACGAC
CCTATGCG	CCATATGC
CCTATGCT	CCATATGC
CCTATGCN	CCATATGC
CCTATGGA	CCTAGGAA
CCGGGTGA	GCGGGTGA
CCCTATGC	CCATATGC
CCGACATG	CCGACTTG
CCGACATT	CCGACTTG
CCCACGGC	CCCCGGCA
CCGACCTG	CCGACTTG
CCGACCTT	CCGACTTG
CCCACTTG	CCGACTTG
CCGACGTG	CCGACTTG
CCGACGTT	CCGACTTG
CCGACTAG	CCGACTTG
CCGACTAT	CCGACTTG
CCGACTCG	CCGACTTG
CCGACTCT	CCGACTTG
CCGACTGA	CCGACTTG
CCGACTGC	CCGACTTG
CCTANACA	CCTAACAG
CCGACTGG	CCGACTTG
CCGACTGT	CCGACTTG
CCGACTGN	CCGACTTG
CCGACTTA	CCGACTTG
CCGACTTC	CCGACTTG
CCTANCAG	CCTAACAG
CCGACTTG	CCGACTTG
CCGACTTT	CCGACTTG
CCGACTTN	CCGACTTG
CCGACTNG	CCGACTTG
CCGACTNT	CCGACTTG
CCCAGGAA	CCTAGGAA
CCCAGGCA	CCCCGGCA
CCTANGAA	CCTAGGAA
CCGACNTG	CCGACTTG
CCGACNTT	CCGACTTG
CCNCCGGC	CCCCGGCA
CCTANGGA	CCTAGGAA
CCCTCGGC	CCCCGGCA
CCCTCTCG	CACTCTCG
CGACACGA	CGCACGAC
CCGAGGAA	CCTAGGAA
CCCATATG	CCATATGC
CCTCAACA	CCTAACAG
CCNCGGCA	CCCCGGCA
CCTCACAG	CCTAACAG
CCGAGTTG	CCGACTTG
CCANTATG	CCATATGC
CCTCAGGA	CCTAGGAA
CCCATGCA	TCCCATGC
CCCATGCC	TCCCATGC
CCCATGCG	TCCCATGC
CCCATGCT	TCCCATGC
CCCATGCN	TCCCATGC
CCGATATG	CCATATGC
CCTCATCC	ACTCATCC
CCGATCTT	CCGACTTG
CCTCCCGA	ACTCCCGA
CCGTAACA	CCTAACAG
CGACCCAT	CGGCCCAT
CCTCCGGC	CCCCGGCA
CCTCCGGG	CGTCCGGG
CGACCCTC	GACCCTCA
CGACCCTT	TGACCCTT
CCGATTGA	CCGACTTG
CCGTACTC	CAGTACTC
CCGATTGC	CCGACTTG
CGACCGGG	CGTCCGGG
CCGATTGG	CCGACTTG
CCGTACTT	CCGACTTG
CCGATTGT	CCGACTTG
CCGATTGN	CCGACTTG
CCGATTTG	CCGACTTG
CGACCTAA	CAACCTAA
CCGTAGAA	CGTAGAAA
CCGTAGGA	CCTAGGAA
CGAGTACT	CAGTACTC
CCGTATGC	CCATATGC
CGACGACA	CGCACGAC
CGACGACC	CGCACGAC
CGACGACG	CGCACGAC
CGACGACT	CGCACGAC
CGACGACN	CGCACGAC
CCGANCTT	CCGACTTG
CCGANTTG	CCGACTTG
CCCCAGCA	CCCCGGCA
CCNGACTT	CCGACTTG
CCGCACGA	CGCACGAC
CCCCAGGC	CCCCGGCA
CCGCACTT	CCGACTTG
CGATAACC	TGATAACC
CGATAATA	GATAATAT
CCCCATGC	TCCCATGC
CCCAAAGT	CCAAAGTC
CGATAGAA	CGTAGAAA
CCCAACAG	CCTAACAG
CGACTCGT	CTACTCGT
CGATATGC	CCATATGC
CGATATTG	GATATTGG
CCNAAAGT	CCAAAGTC
CGACTGTT	CACTGTTT
CCNAACAG	CCTAACAG
CCGCCCAT	CGGCCCAT
CGACTTGA	CCGACTTG
CGACTTGC	CCGACTTG
CGACTTGG	CCGACTTG
CGACTTGT	CCGACTTG
CGACTTGN	CCGACTTG
CCCAAGTC	CCAAAGTC
CGATCCGG	CGTCCGGG
CCNAAGTC	CCAAAGTC
CCGCCGGC	CCCCGGCA
CCCCCGCA	CCCCGGCA
CGATCGGT	CATCGGTC
CCCCCGGC	CCCCGGCA
CCGCCTTG	CCGACTTG
CGAGAAAA	CGTAGAAA
CGAGAAAC	CGTAGAAA
CGAGAAAG	CGTAGAAA
CGAGAAAT	CGTAGAAA
CGAGAAAN	CGTAGAAA
CCTCGGAA	CCTAGGAA
CCTCGGCA	CCCCGGCA
CCNACTTG	CCGACTTG
CCTCGGTC	CATCGGTC
CCGCGGCA	CCCCGGCA
CGAGACTA	TGAGACTA
CCCCGACA	CCCCGGCA
CCCCGAGC	CCCCGGCA
CGAGAGCT	CAGAGCTT
CCNAGGAA	CCTAGGAA
CCCCGCAA	CCCCGGCA
CCCCGCAC	CCCCGGCA
CCCCGCAG	CCCCGGCA
CCCCGCAT	CCCCGGCA
CCCCGCAN	CCCCGGCA
CCCCGCCA	CCCCGGCA
CCTCTCGA	CACTCTCG
CCTCTCGC	CACTCTCG
CCTCTCGG	CACTCTCG
CCTCTCGT	CACTCTCG
CCTCTCGN	CACTCTCG
CCCCGCGC	CCCCGGCA
CGAAAGTC	CCAAAGTC
CCCCGGAA	CCCCGGCA
CCCCGGAC	CCCCGGCA
CCCCGGAG	CCCCGGCA
CCCCGGAT	CCCCGGCA
CCCCGGAN	CCCCGGCA
CCCCGGCA	CCCCGGCA
CCCCGGCC	CCCCGGCA
CCCCGGCG	CCCCGGCA
CCCCGGCT	CCCCGGCA
CCCCGGCN	CCCCGGCA
CCCCGGGA	CCCCGGCA
CCCCGGGC	CCCCGGCA
CCCCGGTA	CCCCGGCA
CGAGCCCA	CGGCCCAT
CCCCGGTC	CCCCGGCA
CCCCGGNA	CCCCGGCA
CCCCGGNC	CCCCGGCA
CCNATATG	CCATATGC
CCCCGTCA	CCCCGGCA
CGAAATGC	AGAAATGC
CCCCGTGC	CCCCGGCA
CGAGCGCG	AGAGCGCG
CCCCGNCA	CCCCGGCA
CCCCGNGC	CCCCGGCA
CGAGCTTA	CAGAGCTT
CGAGCTTC	CAGAGCTT
CGAGCTTG	CAGAGCTT
CGAGCTTT	CAGAGCTT
CGAGCTTN	CAGAGCTT
CCNTAACA	CCTAACAG
CCCCTGCA	CCCCGGCA
CCCCTGGC	CCCCGGCA
CGAACCTA	CAACCTAA
CGAGGCCC	CAGGCCCG
CCNTAGGA	CCTAGGAA
CGAACGAC	CGCACGAC
CCTTAACA	CCTAACAG
CGAGGGGG	CAGGGGGG
CGAACGCA	GAACGCAT
CCTGAAAG	TCTGAAAG
CCTTACAG	CCTAACAG
CCTGAACA	CCTAACAG
CCNTATGC	CCATATGC
CGCNACGA	CGCACGAC
CCTTAGGA	CCTAGGAA
CCTGACAG	CCTAACAG
CCTGACTT	CCGACTTG
CCTTATGC	CCATATGC
CGAAGAAA	CGTAGAAA
CGAAGCTA	GAAGCTAG
CCTTCCAT	ACTTCCAT
CGAAGGGA	ACGAAGGG
CGAAGGGC	ACGAAGGG
CGAAGGGG	ACGAAGGG
CGAAGGGT	ACGAAGGG
CGAAGGGN	ACGAAGGG
CGTAGAAA	CGTAGAAA
CGTAGAAC	CGTAGAAA
CGTAGAAG	CGTAGAAA
CGTAGAAT	CGTAGAAA
CGTAGAAN	CGTAGAAA
CGTAGACA	CGTAGAAA
CGTAGAGA	CGTAGAAA
CGTAGATA	CGTAGAAA
CGCNCGAC	CGCACGAC
CGTAGANA	CGTAGAAA
CGTAGCAA	CGTAGAAA
CGTAGTAA	CGTAGAAA
CCTTGGAA	CCTAGGAA
CGTAGNAA	CGTAGAAA
CCTTGGCT	CTTTGGCT
CCTTGGTA	ACCTTGGT
CCTTGGTC	ACCTTGGT
CCTTGGTG	ACCTTGGT
CCTTGGTT	ACCTTGGT
CCTTGGTN	ACCTTGGT
CGTATAAA	CGTAGAAA
CGTATAAC	GGTATAAC
CCTTTACA	GCCTTTAC
CGGNCCAT	CGGCCCAT
CGGNCCCA	CGGCCCAT
CCTTTACC	GCCTTTAC
CCTTTACG	GCCTTTAC
CCTTTACT	GCCTTTAC
CCTTTACN	GCCTTTAC
CGCGGGTG	GCGGGTGA
CCTGGAAA	CCTAGGAA
CCTGGAAG	CCTAGGAA
CCTGGAAT	CCTAGGAA
CCTGGAAN	CCTAGGAA
CGTATGAA	CGTAGAAA
CCTGGCCA	CTGGCCAA
CCTGGGAA	CCTAGGAA
CCTTTGGC	CTTTGGCT
CGCGTATC	AGCGTATC
CCTTTTTA	GCTTTTTA
CGTANAAA	CGTAGAAA
CGTANGAA	CGTAGAAA
CCTGTCAG	CTGTCAGA
CCTGTGCC	CTGTGCCA
CCTNAACA	CCTAACAG
CCTGTTTA	CACTGTTT
CCTGTTTC	CACTGTTT
CCTGTTTG	CACTGTTT
CCTGTTTT	CACTGTTT
CCTGTTTN	CACTGTTT
CCTNACAG	CCTAACAG
CGTCACGA	CGCACGAC
CGTCACGG	CGTCCGGG
CGGGCCAA	CTGGCCAA
CGGGCCAT	CGGCCCAT
CGTCAGAC	CTGTCAGA
CGGGCCCA	CGGCCCAT
CGTCAGAG	CTGTCAGA
CGGGCCCG	CAGGCCCG
CGTCAGAT	CTGTCAGA
CGTCAGAN	CTGTCAGA
CGTCAGGG	CGTCCGGG
CCTNAGGA	CCTAGGAA
CGTCAGTT	AGTCAGTT
CGTCCACC	GTCCACCT
CGTCCAGG	CGTCCGGG
CGTCCCAT	CGGCCCAT
CGTCCCGG	CGTCCGGG
CGTCCGAG	CGTCCGGG
CGTCCGCG	CGTCCGGG
CGTCCGGA	CGTCCGGG
CGTCCGGC	CGTCCGGG
CGTCCGGG	CGTCCGGG
CGTCCGGT	CGTCCGGG
CGTCCGGN	CGTCCGGG
CGTCCGTG	CGTCCGGG
CGTCCGNG	CGTCCGGG
CGTCCTGG	CGTCCGGG
CGCTAACA	CCTAACAG
CGTCCNGG	CGTCCGGG
CGTCGAAA	CGTAGAAA
CGCTACGA	CGCACGAC
CGCTAGAA	CGTAGAAA
CGTCGCGG	CGTCCGGG
CGGGGATC	GGGGATCC
CGCTAGGA	CCTAGGAA
CGCTAGTA	GCTAGTAG
CGCTAGTT	GGCTAGTT
CCTNGGAA	CCTAGGAA
CGTCGGGA	CGTCCGGG
CGTCGGGC	CGTCCGGG
CGTCGGGG	CGTCCGGG
CGTCGGGT	CGTCCGGG
CGTCGGGN	CGTCCGGG
CGTCGGTC	CATCGGTC
CGTAAAAA	CGTAGAAA
CGTAAAAC	CGTAGAAA
CGTAAAAG	CGTAGAAA
CGTAAAAT	CGTAGAAA
CGTAAAAN	CGTAGAAA
CGGGGGGA	CAGGGGGG
CGGGGGGC	CAGGGGGG
CGGGGGGT	CAGGGGGG
CGGGGGGN	CAGGGGGG
CGTAACAG	CCTAACAG
CGCTCCGG	CGTCCGGG
CGCANCGA	CGCACGAC
CGGATACA	GGGATACA
CGCTCGAC	CGCACGAC
CGCANGAC	CGCACGAC
CGGATCAA	TGGATCAA
CGTCTCGG	CGTCCGGG
CGTAAGAA	CGTAGAAA
CGCTCTCG	CACTCTCG
CGGGTCGT	GGGTCGTA
CGGGTCTG	GGGTCTGC
CGTCTGGG	CGTCCGGG
CGGGTGAA	GCGGGTGA
CGGGTGAC	GCGGGTGA
CGGGTGAG	GCGGGTGA
CGGGTGAT	GCGGGTGA
CGGGTGAN	GCGGGTGA
CGTCTTTG	GTCTTTGG
CGCCACGA	CGCACGAC
CGTACAAA	CGTAGAAA
CGCTGGCA	TCGCTGGC
CGCTGGCC	TCGCTGGC
CGCTGGCG	TCGCTGGC
CGCTGGCT	TCGCTGGC
CGCTGGCN	TCGCTGGC
CGTCNCGG	CGTCCGGG
CGCTGTTT	CACTGTTT
CGTCNGGG	CGTCCGGG
CGGACCAT	CGGCCCAT
CGGACCCA	CGGCCCAT
CGTACCGG	CGTCCGGG
CGTACGAA	CGTAGAAA
CGTACGAC	CGCACGAC
CGCTTTTT	GCTTTTTA
CTATCAGA	CTGTCAGA
CGTACGGG	CGTCCGGG
CGGACGAC	CGCACGAC
CGTACTCA	CAGTACTC
CGCCCATA	CGGCCCAT
CGTACTCC	CAGTACTC
CGCCCATC	CGGCCCAT
CGCCCATG	CGGCCCAT
CGTACTCT	CAGTACTC
CGTACTCN	CAGTACTC
CGCCCATT	CGGCCCAT
CGCCCATN	CGGCCCAT
CGCCCCAT	CGGCCCAT
CTATCGGT	CATCGGTC
CTATCGTA	CTACTCGT
CTATCGTC	CTACTCGT
CTATCGTG	CTACTCGT
CTATCGTT	CTACTCGT
CTATCGTN	CTACTCGT
CGGACTTA	TCGGACTT
CGGACTTC	TCGGACTT
CGGACTTT	TCGGACTT
CGGACTTN	TCGGACTT
CGCCCGAC	CGCACGAC
CGCCCGCG	AGCCCGCG
CTATCTCG	CTACTCGT
CGCCCGGC	CCCCGGCA
CGCCCGGG	CGTCCGGG
CGGCACAT	CGGCCCAT
CGGCACCA	CGGCCCAT
CGGCACGA	CGCACGAC
CGGAGAAA	CGTAGAAA
CTATGCCA	CTGTGCCA
CGGAGCTT	CAGAGCTT
CTATGGCT	CTTTGGCT
CGGCATAG	GGCATAGA
CTACTACG	CTACTCGT
CGGTACTC	CAGTACTC
CTACTAGT	CTACTCGT
CGGTAGAA	CGTAGAAA
CTACTCAG	CTACTCGT
CTACTCAT	CTACTCGT
CGCCGACA	CGCACGAC
CGCCGACC	CGCACGAC
CGCCGACG	CGCACGAC
CGCCGACT	CGCACGAC
CGCCGACN	CGCACGAC
CGGCCAAA	CTGGCCAA
CGGCCAAC	CTGGCCAA
CGGCCAAG	CTGGCCAA
CGGTATAA	GGTATAAC
CGGCCAAN	CTGGCCAA
CGGCCACA	CGGCCCAT
CTATTCGT	CTACTCGT
CGGCCATA	CGGCCCAT
CGNACGAC	CGCACGAC
CGGCCATC	CGGCCCAT
CGGCCATG	CGGCCCAT
CGGCCATT	CGGCCCAT
CGGCCATN	CGGCCCAT
CTATTGGC	CTTTGGCT
CTACTCCG	CTACTCGT
CGCCGGCA	CCCCGGCA
CGGCCCAA	CGGCCCAT
CTACTCCT	CTACTCGT
CGGCCCAC	CGGCCCAT
CGGCCCAG	CGGCCCAT
CGGCCCAT	CGGCCCAT
CGGCCCAN	CGGCCCAT
CGCCGGGA	CGTCCGGG
CGGCCCCA	CGGCCCAT
CGCCGGGC	CGTCCGGG
CGCCGGGG	CGTCCGGG
CGCCGGGT	CGTCCGGG
CGCCGGGN	CGTCCGGG
CTACTCGA	CTACTCGT
CGGCCCCT	CGGCCCAT
CTACTCGC	CTACTCGT
CTACTCGG	CTACTCGT
CTACTCGT	CTACTCGT
CGGCCCGC	CAGGCCCG
CTACTCGN	CTACTCGT
CGGCCCGG	CAGGCCCG
CTACTCTA	CTACTCGT
CTACTCTG	CTACTCGT
CGGCCCGN	CAGGCCCG
CTACTCTT	CTACTCGT
CGGCCCTA	CGGCCCAT
CTACTCTN	CTACTCGT
CGGCCCTC	CGGCCCAT
CGGCCCTG	CGGCCCAT
CGGCCCTT	CGGCCCAT
CGGCCCTN	CGGCCCAT
CGGCCCNA	CGGCCCAT
CTACTCNG	CTACTCGT
CTACTCNT	CTACTCGT
CGGCCCNT	CGGCCCAT
CGGCCGAT	CGGCCCAT
CGGCCGCA	CGGCCCAT
CGCCGTTC	AGCCGTTC
CGGTCAGA	CTGTCAGA
CGGCCGGG	CGTCCGGG
CGNAGAAA	CGTAGAAA
CGGCCTAT	CGGCCCAT
CGGCCTCA	CGGCCCAT
CGGTCCAT	CGGCCCAT
CGGTCCCA	CGGCCCAT
CGGTCCGG	CGTCCGGG
CGGCCNAT	CGGCCCAT
CGGCCNCA	CGGCCCAT
CGCAAAGT	CCAAAGTC
CTACTGCG	CTACTCGT
CGGTCGTA	GGGTCGTA
CTACTGGT	CTACTCGT
CTACTGTA	CTACTCGT
CGGTCTGC	GGGTCTGC
CTACTGTC	CTACTCGT
CTACTGTG	CTACTCGT
CTACTGTN	CTACTCGT
CTACTTCG	CTACTCGT
CTACTTGT	CTACTCGT
CGCAACGA	CGCACGAC
CGGCGAGA	GGCGAGAC
CGCAACGG	GCAACGGC
CGCCTTTA	GCCTTTAC
CGCAAGAC	CGCACGAC
CTACTNCG	CTACTCGT
CGGCGCAT	CGGCCCAT
CTACTNGT	CTACTCGT
CGGCGCCA	CGGCCCAT
CGGTGAGG	TGGTGAGG
CGCAATAC	GCAATACT
CGGTGCCA	CTGTGCCA
CTACNCGT	CTACTCGT
CGCACAAC	CGCACGAC
CGCACACA	CGCACGAC
CGCACACC	CGCACGAC
CGCACACG	CGCACGAC
CGGTGGGA	GGTGGGAA
CGCACACT	CGCACGAC
CGCACACN	CGCACGAC
CGCACAGA	CGCACGAC
CTACNTCG	CTACTCGT
CGCACCAC	CGCACGAC
CGCACCGA	CGCACGAC
CGNGCCCA	CGGCCCAT
CGCACGAA	CGCACGAC
CGCACGAC	CGCACGAC
CGCACGAG	CGCACGAC
CGCACGAT	CGCACGAC
CGCACGAN	CGCACGAC
CGCACGCA	CGCACGAC
CGCACGCC	CGCACGAC
CGCACGCG	CGCACGAC
CGCACGCT	CGCACGAC
CGCACGCN	CGCACGAC
CGCACGGA	CGCACGAC
CGCACGGC	CGCACGAC
CGGCTAGT	GGCTAGTT
CGCACGTA	CGCACGAC
CGCACGTC	CGCACGAC
CGCACGNA	CGCACGAC
CGCACGNC	CGCACGAC
CGCACTAC	CGCACGAC
CGGCTCAT	CGGCCCAT
CGGCTCCA	CGGCCCAT
CGCACTGA	CGCACGAC
CGCACNAC	CGCACGAC
CGGTTCTG	GGTTCTGA
CGCACNGA	CGCACGAC
CTAGAAAA	CGTAGAAA
CTAGAAAC	CGTAGAAA
CTAGAAAG	CGTAGAAA
CTAGAAAT	CGTAGAAA
CTAGAAAN	CGTAGAAA
CGCAGAAA	CGTAGAAA
CGCAGACA	CGCACGAC
CGCAGACC	CGCACGAC
CGCAGACG	CGCACGAC
CGCAGACT	CGCACGAC
CGCAGACN	CGCACGAC
CGCGACGA	CGCACGAC
CGCGACTT	CCGACTTG
CGCAGCGA	CGCACGAC
CGCGAGAC	GGCGAGAC
CTAGAGCA	TAGAGCAG
CTAGAGCT	CAGAGCTT
CGCAGGAC	CGCACGAC
CTAAAAAT	TAAAAATC
CTAAAATA	TTAAAATA
CGGCNCAT	CGGCCCAT
CGGCNCCA	CGGCCCAT
CTAAACGA	ACTAAACG
CTAAACGC	ACTAAACG
CTAAACGG	ACTAAACG
CTAAACGT	ACTAAACG
CTAAACGN	ACTAAACG
CTAAAGAT	TAAAGATT
CGCGCCCA	CGGCCCAT
CTAAAGTC	CCAAAGTC
CGNCACGA	CGCACGAC
CGCGCGAC	CGCACGAC
CTAAATGA	TAAATGAC
CTANCTCG	CTACTCGT
CTAGCCAA	CTGGCCAA
CTAACAGA	CCTAACAG
CTAACAGC	CCTAACAG
CTAACAGG	CCTAACAG
CTAACAGT	CCTAACAG
CTAACAGN	CCTAACAG
CGCATAGA	GGCATAGA
CTAGCTCG	CTACTCGT
CGCATATG	CCATATGC
CTAACCTA	CAACCTAA
CGNCCCAT	CGGCCCAT
CGCATCGA	CGCACGAC
CTAGGAAA	CCTAGGAA
CTAGGAAC	CCTAGGAA
CTAGGAAG	CCTAGGAA
CTAGGAAT	CCTAGGAA
CTAGGAAN	CCTAGGAA
CGGGACCA	TCGGGACC
CGGGACCC	TCGGGACC
CGCATGAC	CGCACGAC
CGGGACCG	TCGGGACC
CGGGACCT	TCGGGACC
CGGGACCN	TCGGGACC
CTAACTCG	CTACTCGT
CGTTTGGC	CTTTGGCT
CGNCCGGG	CGTCCGGG
CTAGGCCA	CTGGCCAA
CTAGGCCC	CAGGCCCG
CGGGATAC	GGGATACA
CGGGATCC	GGGGATCC
CTAGGGGG	CAGGGGGG
CGTGAAAA	CGTAGAAA
CGTGAAAC	CGTAGAAA
CGTGAAAG	CGTAGAAA
CGTGAAAT	CGTAGAAA
CGTGAAAN	CGTAGAAA
CTAGTAAC	TTAGTAAC
CTAAGGGG	TAAGGGGC
CTAGTACT	CAGTACTC
CTAGTAGA	GCTAGTAG
CTAGTAGC	GCTAGTAG
CTAGTAGG	GCTAGTAG
CTAGTAGT	GCTAGTAG
CTAGTAGN	GCTAGTAG
CGTGAGAA	CGTAGAAA
CTAGTCAG	CTGTCAGA
CTANTCGT	CTACTCGT
CTAGTCGT	CTACTCGT
CTAGTGCC	CTGTGCCA
CTAATCGT	CTACTCGT
CTTCAAAA	TTCAAAAG
CGTGCCAA	CTGTGCCA
CGTGCCAC	CTGTGCCA
CGTGCCAG	CTGTGCCA
CGTGCCAT	CTGTGCCA
CGTGCCAN	CTGTGCCA
CGTGCCCA	CGGCCCAT
CGTGCCGG	CGTCCGGG
CGTGCGAT	GTGCGATC
CGTGCGGG	CGTCCGGG
CTTCAGAA	CTGTCAGA
CTTCAGAC	CTGTCAGA
CTTCAGAG	CTGTCAGA
CTTCAGAT	CTGTCAGA
CTTCAGAN	CTGTCAGA
CTCTAACA	CCTAACAG
CGTNAGAA	CGTAGAAA
CGTGGAAA	CGTAGAAA
CTCTAGGA	CCTAGGAA
CTTCCATA	ACTTCCAT
CTTCCATC	ACTTCCAT
CTTCCATG	ACTTCCAT
CTTCCATT	ACTTCCAT
CTTCCATN	ACTTCCAT
CGTGGCCA	CTGGCCAA
CGTGGCTT	GTGGCTTC
CTTCCGGG	CGTCCGGG
CGTGGGAA	GGTGGGAA
CGNTAGAA	CGTAGAAA
CGTNCCGG	CGTCCGGG
CTTCCTCC	ATTCCTCC
CTACACGT	CTACTCGT
CTATATGC	CCATATGC
CGTNCGGG	CGTCCGGG
CTCTCAGA	CTGTCAGA
CTACATCG	CTACTCGT
CTACATGG	TACATGGA
CGNTCCGG	CGTCCGGG
CTCTCGTA	CTACTCGT
CTCTCGTC	CTACTCGT
CTCTCGTG	CTACTCGT
CTCTCGTT	CTACTCGT
CTCTCGTN	CTACTCGT
CTCTCTCG	CACTCTCG
CGTNGAAA	CGTAGAAA
CTACCCGT	CTACTCGT
CTTCGGCT	CTTTGGCT
CTTCGGTC	CATCGGTC
CTACCGTA	CTACTCGT
CTACCGTC	CTACTCGT
CTACCGTG	CTACTCGT
CTACCGTT	CTACTCGT
CTACCGTN	CTACTCGT
CTACCTAA	CAACCTAA
CGTGTCAG	CTGTCAGA
CTCTGAAA	TCTGAAAG
CTACCTCG	CTACTCGT
CTCTGCCA	CTGTGCCA
CTTCTACG	GTTCTACG
CGTGTGCC	CTGTGCCA
CTCTGGAA	TCTGGAAC
CTACGAGC	TACGAGCT
CTTCTCGT	CTACTCGT
CTCTGGCT	CTTTGGCT
CTTCTGGC	CTTTGGCT
CTACGCGT	CTACTCGT
CTGNTCAG	CTGTCAGA
CTCTGTTT	CACTGTTT
CTACGTCG	CTACTCGT
CTGNTGCC	CTGTGCCA
CTCTTGGC	CTTTGGCT
CTGGNCAA	CTGGCCAA
CTGGNCCA	CTGGCCAA
CTCTTTGG	GTCTTTGG
CTGAAAGA	TCTGAAAG
CTGAAAGC	TCTGAAAG
CTGAAAGG	TCTGAAAG
CTGAAAGT	TCTGAAAG
CTGAAAGN	TCTGAAAG
CTGTAAGA	CTGTCAGA
CTGTACAG	CTGTCAGA
CTGTACCA	CTGTGCCA
CTGTACTC	CAGTACTC
CTGTAGAC	CTGTCAGA
CTGTAGAG	CTGTCAGA
CTGTAGAT	CTGTCAGA
CTGTAGAN	CTGTCAGA
CTGTAGCC	CTGTGCCA
CTGTCAAA	CTGTCAGA
CTGTCAAC	CTGTCAGA
CTGTCAAG	CTGTCAGA
CTCCGGCA	CCCCGGCA
CTGTCAAT	CTGTCAGA
CTGTCAAN	CTGTCAGA
CTGTCACA	CTGTCAGA
CTGTCACG	CTGTCAGA
CTCCGGGA	CGTCCGGG
CTCCGGGC	CGTCCGGG
CTGTCAGA	CTGTCAGA
CTCCGGGG	CGTCCGGG
CTGTCAGC	CTGTCAGA
CTCCGGGT	CGTCCGGG
CTGTCAGG	CTGTCAGA
CTCCGGGN	CGTCCGGG
CTGTCAGT	CTGTCAGA
CTGTCAGN	CTGTCAGA
CTGTCATA	CTGTCAGA
CTGTCATG	CTGTCAGA
CTGTCANA	CTGTCAGA
CTGTCANG	CTGTCAGA
CTGTCCAC	CTGTGCCA
CTGTCCAT	CTGTGCCA
CTGTCCAN	CTGTGCCA
CTGTCCCA	CTGTGCCA
CTTAAAAT	TTAAAATA
CTGTCCGA	CTGTCAGA
CTGTCCGG	CGTCCGGG
CTGTCGAA	CTGTCAGA
CTGTCGAC	CTGTCAGA
CTTAACAG	CCTAACAG
CTGACAGA	CTGTCAGA
CTGTCGAG	CTGTCAGA
CTGTCGAT	CTGTCAGA
CTGTCGAN	CTGTCAGA
CTGTCGCC	CTGTGCCA
CTGTCGGA	CTGTCAGA
CTGTCTAG	CTGTCAGA
CGTTAGAA	CGTAGAAA
CTGTCTGA	CTGTCAGA
CTTGCCAC	CTGTGCCA
CTTGCCAG	CTGTGCCA
CTGACCAA	CTGGCCAA
CTTGCCAT	CTGTGCCA
CTTGCCAN	CTGTGCCA
CTGACCCT	TGACCCTT
CTCCTCGT	CTACTCGT
CTGTCNAG	CTGTCAGA
CTGTCNGA	CTGTCAGA
CTGTGACA	CTGTGCCA
CTGTGACC	CTGTGCCA
CTGACTCG	CTACTCGT
CTGACTTG	CCGACTTG
CTGTGAGA	CTGTCAGA
CTGCCAAA	CTGGCCAA
CTGCCAAC	CTGGCCAA
CTGCCAAG	CTGGCCAA
CTGCCAAT	CTGGCCAA
CTGCCAAN	CTGGCCAA
CTGCCAGA	CTGTCAGA
CTGCCCAA	CTGGCCAA
CTGCCCAT	CGGCCCAT
CTTACAGG	ATTACAGG
CTTACCCT	TTTACCCT
CTGTGCAA	CTGTGCCA
CTGTGCAC	CTGTGCCA
CTGTGCAT	CTGTGCCA
CTGTGCAN	CTGTGCCA
CTTACTCG	CTACTCGT
CTGAGACT	TGAGACTA
CTGTGCCA	CTGTGCCA
CTGTGCCC	CTGTGCCA
CTGTGCCG	CTGTGCCA
CTGTGCCT	CTGTGCCA
CGTTCCGG	CGTCCGGG
CTGTGCCN	CTGTGCCA
CTGTGCGA	CTGTGCCA
CTGTGCGC	CTGTGCCA
CTGTGCTA	CTGTGCCA
CTTGGCCA	CTGGCCAA
CTTGGCTA	CTTTGGCT
CTTGGCTC	CTTTGGCT
CTTGGCTG	CTTTGGCT
CTTGGCTT	CTTTGGCT
CTTGGCTN	CTTTGGCT
CTGTGCTC	CTGTGCCA
CTGTGCNA	CTGTGCCA
CTGTGCNC	CTGTGCCA
CTTGGGCT	CTTTGGCT
CGTTCGGG	CGTCCGGG
CTGTGGCA	CTGTGCCA
CTGTGGCC	CTGTGCCA
CTGTGGCT	CTTTGGCT
CTGTGGGC	TTGTGGGC
CGTTCTAC	GTTCTACG
CTGAGCTT	CAGAGCTT
CGTTCTGA	GGTTCTGA
CTGAGGAA	ACTGAGGA
CTGAGGAC	ACTGAGGA
CTGAGGAG	ACTGAGGA
CTGAGGAT	ACTGAGGA
CTGAGGAN	ACTGAGGA
CTGCGATC	GTGCGATC
CTTAGAAA	CGTAGAAA
CTGTGTCA	CTGTGCCA
CTGTGTCC	CTGTGCCA
CGTTGAAA	CGTAGAAA
CTGTGNCA	CTGTGCCA
CTGTGNCC	CTGTGCCA
CTGTTAGA	CTGTCAGA
CTTAGGAA	CCTAGGAA
CGTTGCCT	AGTTGCCT
CTGTTCAG	CTGTCAGA
CTGTTCCA	CTGTGCCA
CTTAGGCT	CTTTGGCT
CTGATAAC	TGATAACC
CTGATCAG	CTGTCAGA
CGTTGGCT	CTTTGGCT
CTTAGTAA	TTAGTAAC
CTGTTGCC	CTGTGCCA
CTGTTGGC	CTTTGGCT
CTGATGCC	CTGTGCCA
CTCGACTT	CCGACTTG
CTGCTCAG	CTGTCAGA
CTGCTCGT	CTACTCGT
CTGCTGCC	CTGTGCCA
CTGTNAGA	CTGTCAGA
CTGTNCAG	CTGTCAGA
CTGTNCCA	CTGTGCCA
CTCGCCAA	CTGGCCAA
CTTATGGC	CTTTGGCT
CTGTNGCC	CTGTGCCA
CTCGCTGG	TCGCTGGC
CTCAAAAG	TTCAAAAG
CTCAAAGT	CCAAAGTC
CTCGGACT	TCGGACTT
CTCGGCCA	CTGGCCAA
CTCGGGAC	TCGGGACC
CTGCACGA	CGCACGAC
CTGCAGAA	CTGTCAGA
CTGCAGAC	CTGTCAGA
CTGCAGAG	CTGTCAGA
CTGCAGAT	CTGTCAGA
CTGCAGAN	CTGTCAGA
CTGGAACA	TCTGGAAC
CTGGAACC	TCTGGAAC
CTCGGTCA	CATCGGTC
CTGGAACG	TCTGGAAC
CTGGAACT	TCTGGAAC
CTCGGTCC	CATCGGTC
CTCGGTCG	CATCGGTC
CTGGAACN	TCTGGAAC
CTCGGTCT	CATCGGTC
CTCGGTCN	CATCGGTC
CTGNCAGA	CTGTCAGA
CTGNCCAA	CTGGCCAA
CTGGACAA	CTGGCCAA
CTGGACCA	CTGGCCAA
CTCACGAC	CGCACGAC
CTGGATCA	TGGATCAA
CNAGGCCC	CAGGCCCG
CNCAAAGT	CCAAAGTC
CTCGTCAG	CTGTCAGA
CTCACTCG	CTACTCGT
CTNGGCCA	CTGGCCAA
CTNCTCGT	CTACTCGT
CNAGGGGG	CAGGGGGG
CTGGCAAA	CTGGCCAA
CTGGCAAC	CTGGCCAA
CTGGCAAG	CTGGCCAA
CTGGCAAT	CTGGCCAA
CTGGCAAN	CTGGCCAA
CTGGCACA	CTGGCCAA
CTGGCAGA	CTGTCAGA
CTCGTGCC	CTGTGCCA
CNAGTACT	CAGTACTC
CTGGCCAA	CTGGCCAA
CTNGTCAG	CTGTCAGA
CTGGCCCG	CAGGCCCG
CTGGCCGA	CTGGCCAA
CTGGCCTA	CTGGCCAA
CNCACGAC	CGCACGAC
CTGGCCNA	CTGGCCAA
CTNGTGCC	CTGTGCCA
CTGGCGAA	CTGGCCAA
CTGGCGCA	CTGGCCAA
CTGGCTAA	CTGGCCAA
CTGGCTCA	CTGGCCAA
CTGGCTTC	GTGGCTTC
CTGGCNAA	CTGGCCAA
CTGGCNCA	CTGGCCAA
CTGGGCAA	CTGGCCAA
CTCATATG	CCATATGC
CTCATCCA	ACTCATCC
CTCATCCC	ACTCATCC
CTCATCCG	ACTCATCC
CTCATCCT	ACTCATCC
CTCATCCN	ACTCATCC
CTGGGGGG	CAGGGGGG
CTNGCCAA	CTGGCCAA
CNACCTAA	CAACCTAA
CTNTCAGA	CTGTCAGA
CTGGTCAA	CTGGCCAA
CTGGTCAG	CTGTCAGA
CTTNGGCT	CTTTGGCT
CTGGTCCA	CTGGCCAA
CNATATGC	CCATATGC
CTCCACCT	GTCCACCT
CTGGTGAG	TGGTGAGG
CTGGTGCC	CTGTGCCA
CNATCGGT	CATCGGTC
CTNTGCCA	CTGTGCCA
CTCCCATG	TCCCATGC
CTTNTGGC	CTTTGGCT
CTNTGGCT	CTTTGGCT
CNACTCGT	CTACTCGT
CTCCCGAA	ACTCCCGA
CTCCCGAC	ACTCCCGA
CNACTCTC	CACTCTCG
CTCCCGAG	ACTCCCGA
CTCCCGAT	ACTCCCGA
CTCCCGAN	ACTCCCGA
CTCCCGGC	CCCCGGCA
CNACTGTT	CACTGTTT
CTTGTCAG	CTGTCAGA
CTTGTGCC	CTGTGCCA
CTTGTGGC	CTTTGGCT
CTTGTGGG	TTGTGGGC
CNTGGCCA	CTGGCCAA
CTNTTGGC	CTTTGGCT
CNTGTCAG	CTGTCAGA
CNTGTGCC	CTGTGCCA
CTTTACCC	TTTACCCT
CNTAACAG	CCTAACAG
CTTTAGCT	CTTTGGCT
CTTTAGGC	CTTTGGCT
CTTTCAGA	CTGTCAGA
CNAGAGCT	CAGAGCTT
CNGACTTG	CCGACTTG
CTNACTCG	CTACTCGT
CTTTCGCT	CTTTGGCT
CTTTCGGC	CTTTGGCT
CNTACTCG	CTACTCGT
CNGTGCCA	CTGTGCCA
CTTTGACT	CTTTGGCT
CTTTGAGC	CTTTGGCT
CNTAGAAA	CGTAGAAA
CTTTGCCA	CTGTGCCA
CNGAGCTT	CAGAGCTT
CTTTGCCT	CTTTGGCT
CTTTGCGC	CTTTGGCT
CTTTGCTA	CTTTGGCT
CTTTGCTC	CTTTGGCT
CTTTGCTG	CTTTGGCT
CTTTGCTT	CTTTGGCT
CTTTGCTN	CTTTGGCT
CTTTGGAC	CTTTGGCT
CTTTGGAT	CTTTGGCT
CTTTGGCA	CTTTGGCT
CTTTGGCC	CTTTGGCT
CTTTGGCG	CTTTGGCT
CTTTGGCT	CTTTGGCT
CTTTGGCN	CTTTGGCT
CTTTGGGC	CTTTGGCT
CTTTGGGT	CTTTGGCT
CTTTGGTA	CTTTGGCT
CTTTGGTC	CTTTGGCT
CTTTGGTG	CTTTGGCT
CTTTGGTT	CTTTGGCT
CTTTGGTN	CTTTGGCT
CTTTGGNC	CTTTGGCT
CTTTGGNT	CTTTGGCT
CTTTGTCT	CTTTGGCT
CTTTGTGC	CTTTGGCT
CNTAGGAA	CCTAGGAA
CTTTGNCT	CTTTGGCT
CTTTGNGC	CTTTGGCT
GAANGCAT	GAACGCAT
GAANGCTA	GAAGCTAG
CTTTTGCT	CTTTGGCT
CTTTTGGC	CTTTGGCT
CTTTTTAA	GCTTTTTA
CTTTTTAC	GCTTTTTA
CTTTTTAG	GCTTTTTA
CTTTTTAT	GCTTTTTA
CTTTTTAN	GCTTTTTA
CTTTNGCT	CTTTGGCT
CTTTNGGC	CTTTGGCT
CNCGACTT	CCGACTTG
CNGCACGA	CGCACGAC
CNAAAGTC	CCAAAGTC
GACAACGG	GCAACGGC
CNGCCCAT	CGGCCCAT
GACAATAC	GCAATACT
GACAATAT	GATAATAT
GACACAAT	ACACAATG
CNAACCTA	CAACCTAA
GACACCTC	GACCCTCA
CNTCCGGG	CGTCCGGG
GACACGCA	GAACGCAT
GACACTCA	GACCCTCA
CNCATATG	CCATATGC
GACAGCCG	ACAGCCGG
GACAGCTA	GAAGCTAG
CNTCGGTC	CATCGGTC
GACATAGA	GGCATAGA
GACATGGA	TACATGGA
GACATTGG	GATATTGG
GAAGNCTA	GAAGCTAG
GAACCATA	GAACGCAT
GAACCATC	GAACGCAT
GAACCATG	GAACGCAT
GAACCATT	GAACGCAT
GAACCATN	GAACGCAT
GAACCCAT	GAACGCAT
GAACCCTC	GACCCTCA
GAACCGCA	GAACGCAT
GAAGNTAG	GAAGCTAG
GAACCTAA	CAACCTAA
GAACCTAG	GAAGCTAG
GAACCTCA	GACCCTCA
CNCTAACA	CCTAACAG
GAACGAAT	GAACGCAT
GAACGACA	GAACGCAT
GAACGATA	GAACGCAT
GAACGATC	GAACGCAT
GAACGATG	GAACGCAT
GAATAAGA	AATAAGAA
GAACGATT	GAACGCAT
GAACGATN	GAACGCAT
GAATAATA	GATAATAT
GAACGCAA	GAACGCAT
GAACGCAC	GAACGCAT
GAACGCAG	GAACGCAT
GAACGCAT	GAACGCAT
GAACGCAN	GAACGCAT
GAACGCCA	GAACGCAT
GAACGCCT	GAACGCAT
GAACGCGA	GAACGCAT
GAATACTA	GCAATACT
GAATACTC	GCAATACT
CNGGCCAA	CTGGCCAA
GAATACTG	GCAATACT
GAATACTT	GCAATACT
GAATACTN	GCAATACT
CNGGCCCA	CGGCCCAT
GAACGCGT	GAACGCAT
GAACGCTC	GAACGCAT
GAACGCTG	GAACGCAT
GAACGCTT	GAACGCAT
GAACGCTN	GAACGCAT
GAACGCNA	GAACGCAT
CNGGCCCG	CAGGCCCG
GAACGCNT	GAACGCAT
CNCTAGGA	CCTAGGAA
GAACGGAT	GAACGCAT
GATGCGAT	GTGCGATC
CNCCCGGC	CCCCGGCA
GAACGGCC	GCAACGGC
GAACGGCG	GCAACGGC
GAATATTG	GATATTGG
GATGCTAG	GAAGCTAG
GAACGGCT	GCAACGGC
GAACGGCN	GCAACGGC
GAACGTAT	GAACGCAT
GAACGTCA	GAACGCAT
GAACGTTT	AACGTTTA
GAACGNAT	GAACGCAT
GAATCGCA	GAACGCAT
GAACGNCA	GAACGCAT
GATGGCTT	GTGGCTTC
GAATCTAG	GAAGCTAG
GATGGGAA	GGTGGGAA
GAACTAGA	GAAGCTAG
GAACTAGC	GAAGCTAG
GAACTAGG	GAAGCTAG
GAACTAGT	GAAGCTAG
GAACTAGN	GAAGCTAG
CNCCGGCA	CCCCGGCA
GAACTCAG	AACTCAGT
GAACTCAT	GAACGCAT
GAATGCAT	GAACGCAT
CNGGGGGG	CAGGGGGG
GAACTGCA	GAACGCAT
GAATGCTA	GAAGCTAG
GAATGTCG	AATGTCGT
GAATGTTG	AATGTTGT
GAACNCAT	GAACGCAT
GAATTATG	AATTATGT
GATGTCGT	AATGTCGT
GAACNGCA	GAACGCAT
GAATTGGA	GATATTGG
GAATTGGC	GATATTGG
GAATTGGG	GATATTGG
GAATTGGT	GATATTGG
GAATTGGN	GATATTGG
GAATTTTA	AATTTTAC
GATGTTGG	GATATTGG
GATGTTGT	AATGTTGT
GAAGACTA	GAAGCTAG
GAAGATAG	GAAGCTAG
CNCTCTCG	CACTCTCG
GAAGCAAG	GAAGCTAG
GAAGCACC	AAGCACCC
GAAGCAGA	GAAGCTAG
GAAGCAGC	GAAGCTAG
GAAGCAGG	GAAGCTAG
GAAGCAGT	GAAGCTAG
GAAGCAGN	GAAGCTAG
GAAGCATC	GAACGCAT
GAAGCATG	GAACGCAT
GAAGCATT	GAACGCAT
GAAGCATN	GAACGCAT
GAAGCCAG	GAAGCTAG
CNGTACTC	CAGTACTC
GAAGCCTA	GAAGCTAG
CNGTAGAA	CGTAGAAA
GAAGCGAG	GAAGCTAG
GACNCCTC	GACCCTCA
GAAGCGCA	GAACGCAT
GAAGCGTA	GAAGCTAG
GATTAATA	GATAATAT
GATTACAG	ATTACAGG
GAAGCTAA	GAAGCTAG
GAAGCTAC	GAAGCTAG
GAAGCTAG	GAAGCTAG
GAAGCTAT	GAAGCTAG
GAAGCTAN	GAAGCTAG
GAAGCTCA	GAAGCTAG
GACNCTCA	GACCCTCA
GAAGCTGA	GAAGCTAG
GAAGCTGC	GAAGCTAG
GAAGCTGG	GAAGCTAG
GAAGCTGT	GAAGCTAG
GAAGCTGN	GAAGCTAG
GAAGCTTA	GAAGCTAG
GAAGCTTG	GAAGCTAG
CNGTCAGA	CTGTCAGA
GATTATAT	GATAATAT
GAAGCTNA	GAAGCTAG
GAAGCTNG	GAAGCTAG
GATTATGT	AATTATGT
GAAGCNAG	GAAGCTAG
GATTATTG	GATATTGG
GAAGCNTA	GAAGCTAG
CNCTGTTT	CACTGTTT
CNGTCCGG	CGTCCGGG
CNTTGGCT	CTTTGGCT
GAAGGCAT	GAACGCAT
GAAGGCTA	GAAGCTAG
GAAGGGGC	TAAGGGGC
GAAGGTAG	GAAGCTAG
GAANCGCA	GAACGCAT
GATTCCTC	ATTCCTCC
GATTCTAC	GTTCTACG
GAAGTAGA	GAAGCTAG
GAAGTAGC	GAAGCTAG
GAAGTAGG	GAAGCTAG
GAAGTAGT	GAAGCTAG
GAAGTAGN	GAAGCTAG
GAANCTAG	GAAGCTAG
GATTCTGA	GGTTCTGA
CNTTTGGC	CTTTGGCT
GAAGTCTA	GAAGCTAG
GAAGTTAG	GAAGCTAG
GATATAAC	GGTATAAC
GATATAGG	GATATTGG
GATATATA	GATAATAT
GATATATC	GATAATAT
GATATATT	GATAATAT
GATATATN	GATAATAT
GATATCGG	GATATTGG
GATATCTG	GATATTGG
GATATGGA	GATATTGG
GATATGGC	GATATTGG
GATATGGG	GATATTGG
GATATGGT	GATATTGG
GATATGGN	GATATTGG
GATATGTG	GATATTGG
GATATTAG	GATATTGG
GATATTAT	GATAATAT
GATATTCG	GATATTGG
GATATTGA	GATATTGG
GATATTGC	GATATTGG
GATATTGG	GATATTGG
GATATTGT	GATATTGG
GATATTGN	GATATTGG
GATATTTG	GATATTGG
GATATTNG	GATATTGG
GATATNGG	GATATTGG
GATATNTG	GATATTGG
GATTTGGA	GATATTGG
GATTTGGC	GATATTGG
GATTTGGG	GATATTGG
GATTTGGT	GATATTGG
GATTTGGN	GATATTGG
GATTTTAC	AATTTTAC
GATTTTGG	GATATTGG
GATTTTTA	GCTTTTTA
GATANATA	GATAATAT
GCCAAAGT	CCAAAGTC
GAGCACCC	AAGCACCC
GCCAACGG	GCAACGGC
GATANTAT	GATAATAT
GAGAAATG	AGAAATGC
GATANTGG	GATATTGG
GAGCATAG	GGCATAGA
GATANTTG	GATATTGG
GCCAATAC	GCAATACT
GAGAATAT	GATAATAT
GAGCCCGC	AGCCCGCG
GAAAAATC	TAAAAATC
GAGCCCTC	GACCCTCA
GCCACCTA	GTCCACCT
GCCACCTC	GTCCACCT
GCCACCTG	GTCCACCT
GCCACCTT	GTCCACCT
GCCACCTN	GTCCACCT
GAGCCGTT	AGCCGTTC
GAGCCTCA	GACCCTCA
GCCACGGC	GCAACGGC
GATCAATA	GATAATAT
GAGACGCA	GAACGCAT
GAAAATAT	GATAATAT
GAGCGAGA	GGCGAGAC
GAGCGATC	GTGCGATC
GAGCGCAT	GAACGCAT
GAGCGCGA	AGAGCGCG
GAGCGCGC	AGAGCGCG
GAGACTAA	TGAGACTA
GAGCGCGG	AGAGCGCG
GAGACTAC	TGAGACTA
GAGCGCGT	AGAGCGCG
GAGCGCGN	AGAGCGCG
GAGACTAG	TGAGACTA
GAGACTAT	TGAGACTA
GAGACTAN	TGAGACTA
GAGACTCT	AGACTCTC
GAGCGTAT	AGCGTATC
GATCATAT	GATAATAT
GAGAGCAG	TAGAGCAG
GATCATTG	GATATTGG
GAGAGCGC	AGAGCGCG
GAGAGCTA	GAAGCTAG
GAGAGCTT	CAGAGCTT
GAGCTAGA	GAAGCTAG
GAGCTAGC	GAAGCTAG
GAGCTAGG	GAAGCTAG
GAGCTAGN	GAAGCTAG
GATCCACC	GTCCACCT
GCCAGTAG	GCTAGTAG
GATAAAAT	GATAATAT
GAAACGCA	GAACGCAT
GATAAATA	GATAATAT
GATAAATC	GATAATAT
GATAAATG	GATAATAT
GATAAATT	GATAATAT
GATAAATN	GATAATAT
GATAACAT	GATAATAT
GATCCCTC	GACCCTCA
GAAACGGC	GCAACGGC
GATAACCA	TGATAACC
GATAACCC	TGATAACC
GATAACCG	TGATAACC
GATAACCT	TGATAACC
GATAACCN	TGATAACC
GATAACTA	GATAATAT
GATAAGAA	AATAAGAA
GATAAGAT	GATAATAT
GCCATACT	GCAATACT
GCCATAGA	GGCATAGA
GCCATATG	CCATATGC
GATAAGTA	GATAATAT
GATCCTCA	GACCCTCA
GAGATACA	GGGATACA
GATAATAA	GATAATAT
GATAATAC	GATAATAT
GAAACTAG	GAAGCTAG
GATAATAG	GATAATAT
GATAATAT	GATAATAT
GATAATAN	GATAATAT
GATAATCA	GATAATAT
GATAATCT	GATAATAT
GATAATGA	GATAATAT
GATAATGG	GATATTGG
GATAATGT	GATAATAT
GATAATTA	GATAATAT
GATAATTC	GATAATAT
GATAATTT	GATAATAT
GATAATTN	GATAATAT
GATAATNA	GATAATAT
GATAATNT	GATAATAT
GATAANAT	GATAATAT
GATAANTA	GATAATAT
GCCATTAC	GCCTTTAC
GCCATTTA	GCCTTTAC
GATCGCAT	GAACGCAT
GATACATA	GATAATAT
GAGATTGG	GATATTGG
GAAAGATT	TAAAGATT
GATACGCA	GAACGCAT
GATCGGTC	CATCGGTC
GAAAGCAT	GAACGCAT
GAAAGCTA	GAAGCTAG
GAAAGCTC	AAAGCTCG
GATACTAT	GATAATAT
GATACTGG	GATATTGG
GACCACCT	GTCCACCT
GATACTTG	GATATTGG
GACCACTC	GACCCTCA
GATCTACG	GTTCTACG
GATAGATA	GATAATAT
GATAGCTA	GAAGCTAG
GAGGATAC	GGGATACA
GAGGATCC	GGGGATCC
GATAGTAG	GCTAGTAG
GATAGTAT	GATAATAT
GATAGTGG	GATATTGG
GATAGTTG	GATATTGG
GACCATCA	GACCCTCA
GAAATACT	GCAATACT
GAGGCCCG	CAGGCCCG
GAAATATA	GATAATAT
GAAATATC	GATAATAT
GAAATATG	GATAATAT
GAAATATT	GATAATAT
GAAATATN	GATAATAT
GATCTTGG	GATATTGG
GATCTTTG	GTCTTTGG
GACCCACA	GACCCTCA
GCAGACGG	GCAACGGC
GACCCATC	GACCCTCA
GACCCCAA	GACCCTCA
GAGGCTAG	GAAGCTAG
GAAATGAC	TAAATGAC
GAAATGCA	AGAAATGC
GAGGCTTC	GTGGCTTC
GAAATGCC	AGAAATGC
GAAATGCG	AGAAATGC
GAAATGCT	AGAAATGC
GAAATGCN	AGAAATGC
GACCCCAC	GACCCTCA
GACCCCAG	GACCCTCA
GACCCCAT	GACCCTCA
GACCCCAN	GACCCTCA
GACCCCCA	GACCCTCA
GCAGAGCT	CAGAGCTT
GANGCTAG	GAAGCTAG
GACCCCTC	GACCCTCA
GCAGATAC	GCAATACT
GAAATTGG	GATATTGG
GCCCACCT	GTCCACCT
GACCCGCA	GACCCTCA
GACCCGTC	GACCCTCA
GACCCTAA	GACCCTCA
GACCCTAC	GACCCTCA
GACCCTAG	GACCCTCA
GACCCTAT	GACCCTCA
GACCCTAN	GACCCTCA
GACCCTCA	GACCCTCA
GACCCTCC	GACCCTCA
GCCCATGC	TCCCATGC
GACCCTCG	GACCCTCA
GACCCTCT	GACCCTCA
GACCCTCN	GACCCTCA
GACCCTGA	GACCCTCA
GACCCTGC	GACCCTCA
GACCCTTG	TGACCCTT
GACCCTTT	TGACCCTT
GACCCTTN	TGACCCTT
GATGAATA	GATAATAT
GACCCTNA	GACCCTCA
GACCCTNC	GACCCTCA
GCAGCCGG	ACAGCCGG
GCAGCGGC	GCAACGGC
GACCCNCA	GACCCTCA
GCAGCTAG	GAAGCTAG
GACCCNTC	GACCCTCA
GATGATAT	GATAATAT
GATGATTG	GATATTGG
GACCGCAT	GAACGCAT
GACCGCTC	GACCCTCA
GAACACAT	GAACGCAT
GCCCCGGC	CCCCGGCA
GAACAGCA	GAACGCAT
GCCCCTCA	GACCCTCA
GCAGGCCC	CAGGCCCG
GACGTTTA	AACGTTTA
GACCGTCA	GACCCTCA
GCAGGGGG	CAGGGGGG
GCAGGGTG	GCGGGTGA
GCCCGCGA	AGCCCGCG
GCCCGCGC	AGCCCGCG
GCCCGCGG	AGCCCGCG
GCCCGCGT	AGCCCGCG
GCCCGCGN	AGCCCGCG
GCAGGTGA	GCGGGTGA
GCCCGGCA	CCCCGGCA
GAGGGATC	GGGGATCC
GCAGTAGA	GCTAGTAG
GCAGTAGC	GCTAGTAG
GCAGTAGG	GCTAGTAG
GCAGTAGT	GCTAGTAG
GCAGTAGN	GCTAGTAG
GACCTCAA	GACCCTCA
GACCTCAC	GACCCTCA
GACCTCAG	GACCCTCA
GACCTCAT	GACCCTCA
GACCTCAN	GACCCTCA
GAGGGTGA	GCGGGTGA
GACCTCTC	GACCCTCA
GACTAAAC	ACTAAACG
GACTAATA	GATAATAT
GACTAGTA	GCTAGTAG
GACTAGTT	GGCTAGTT
GACCTTCA	GACCCTCA
GAGGTCGT	GGGTCGTA
GAGGTCTG	GGGTCTGC
GCATTACT	GCAATACT
GACTATTG	GATATTGG
GACCTTGG	ACCTTGGT
GACCTTTA	GCCTTTAC
GACTCAGT	AACTCAGT
GACTCATC	ACTCATCC
GANTAATA	GATAATAT
GACTCCCG	ACTCCCGA
GACTCCTC	GACCCTCA
GCATAATA	GATAATAT
GCATTTAC	GCCTTTAC
GACCNCTC	GACCCTCA
GCATTTTA	GCTTTTTA
GCATTTTT	GCTTTTTA
GCATACGG	GCAACGGC
GCATACTA	GCAATACT
GCATACTC	GCAATACT
GCATACTG	GCAATACT
GCATACTT	GCAATACT
GCATACTN	GCAATACT
GCTTAGTA	GCTAGTAG
GCATAGAA	GGCATAGA
GCATAGAC	GGCATAGA
GCATAGAG	GGCATAGA
GCATAGAT	GGCATAGA
GCATAGAN	GGCATAGA
GCATAGTA	GCTAGTAG
GACCNTCA	GACCCTCA
GCATATAC	GCAATACT
GCTTATTA	GCTTTTTA
GCTTATTT	GCTTTTTA
GCATATGC	CCATATGC
GANTATTG	GATATTGG
GCATATTG	GATATTGG
GACTCTCC	AGACTCTC
GACTCTCT	AGACTCTC
GACTCTCN	AGACTCTC
GACGAAGG	ACGAAGGG
GCTTCCAT	ACTTCCAT
GAGTAATA	GATAATAT
GACGAGAC	GGCGAGAC
GACGAGCT	TACGAGCT
GAGTACTC	CAGTACTC
GCTTCTAC	GTTCTACG
GCTTCTGA	GGTTCTGA
GCTTCTTA	GCTTTTTA
GCTTCTTT	GCTTTTTA
GAGTATAA	GGTATAAC
GACTGAGG	ACTGAGGA
GAGTATTG	GATATTGG
GCATCGGC	GCAACGGC
GACGCATA	GAACGCAT
GACGCATC	GAACGCAT
GACGCATG	GAACGCAT
GACGCATT	GAACGCAT
GACGCATN	GAACGCAT
GAGTCAGT	AGTCAGTT
GCATCGGT	CATCGGTC
GCANACGG	GCAACGGC
GCTTGTAG	GCTAGTAG
GAGTCGTA	GGGTCGTA
GACGCCTC	GACCCTCA
GCANATAC	GCAATACT
GCTTGTTA	GCTTTTTA
GCTTGTTT	GCTTTTTA
GAGTCTGC	GGGTCTGC
GACGCTAG	GAAGCTAG
GACTGTTT	CACTGTTT
GACGCTCA	GACCCTCA
GCTTTACA	GCCTTTAC
GCTTTACC	GCCTTTAC
GCTTTACG	GCCTTTAC
GCTTTACT	GCCTTTAC
GCTTTACN	GCCTTTAC
GCTTTATA	GCTTTTTA
GCTTTATT	GCTTTTTA
GCTTTCTA	GCTTTTTA
GCTTTCTT	GCTTTTTA
GCTTTGGA	GTCTTTGG
GCTTTGGG	GTCTTTGG
GAGTGGGA	GGTGGGAA
GCANCGGC	GCAACGGC
GCTTTGGT	GTCTTTGG
GCTTTGGN	GTCTTTGG
GCTTTGTA	GCTTTTTA
GCTTTGTT	GCTTTTTA
GACTTCCA	ACTTCCAT
GCTTTTAA	GCTTTTTA
GCTTTTAG	GCTTTTTA
GCTTTTAT	GCTTTTTA
GCTTTTAN	GCTTTTTA
GCTTTTCA	GCTTTTTA
GCTTTTCT	GCTTTTTA
GCTTTTGA	GCTTTTTA
GCTTTTGT	GCTTTTTA
GCTTTTTA	GCTTTTTA
GCTTTTTC	GCTTTTTA
GCTTTTTG	GCTTTTTA
GCTTTTTT	GCTTTTTA
GCTTTTTN	GCTTTTTA
GCTTTTNA	GCTTTTTA
GCTTTTNT	GCTTTTTA
GACGGGTG	GCGGGTGA
GCAAAACT	GCAATACT
GCTTTNTA	GCTTTTTA
GCTTTNTT	GCTTTTTA
GACTTTAC	GCCTTTAC
GACTTTGG	GTCTTTGG
GCAAACGG	GCAACGGC
GCAAACTA	GCAATACT
GCAAACTC	GCAATACT
GACTTTTT	GCTTTTTA
GCAAACTG	GCAATACT
GCGAACGG	GCAACGGC
GCAAACTT	GCAATACT
GCAAACTN	GCAATACT
GCGAAGGG	ACGAAGGG
GCAAAGGC	GCAACGGC
GCAAAGTC	CCAAAGTC
GCGAATAC	GCAATACT
GCAAATAC	GCAATACT
GCTTNTTA	GCTTTTTA
GCTTNTTT	GCTTTTTA
GAGTTCTG	GGTTCTGA
GCTAAACG	ACTAAACG
GAGTTGCC	AGTTGCCT
GCGCGAGA	GGCGAGAC
GCGCGATC	GTGCGATC
GCTAACAG	CCTAACAG
GCTAACGG	GCAACGGC
GCANTACT	GCAATACT
GCTAAGTA	GCTAGTAG
GCGCGGTG	GCGGGTGA
GCTAATAC	GCAATACT
GCTAATAG	GCTAGTAG
GCTAATAT	GATAATAT
GCTNAGTA	GCTAGTAG
GCGACGGC	GCAACGGC
GATNAATA	GATAATAT
GCGCGTGA	GCGGGTGA
GCGACTTG	CCGACTTG
GCGCTAGT	GGCTAGTT
GATNATAT	GATAATAT
GCTACGGC	GCAACGGC
GCTACGTA	GCTAGTAG
GATNATTG	GATATTGG
GCTACTAG	GCTAGTAG
GCGAGACA	GGCGAGAC
GCGAGACC	GGCGAGAC
GCGCTGGC	TCGCTGGC
GCGAGACG	GGCGAGAC
GCGAGACT	GGCGAGAC
GCGAGACN	GGCGAGAC
GCTACTCG	CTACTCGT
GCGCTTTA	GCCTTTAC
GCTAGAAG	GCTAGTAG
GCTAGAGA	GCTAGTAG
GCTAGAGC	GCTAGTAG
GCTAGAGG	GCTAGTAG
GCTAGAGT	GCTAGTAG
GCTAGAGN	GCTAGTAG
GCTAGATA	GCTAGTAG
GCTAGCAG	GCTAGTAG
GCTAGCTA	GCTAGTAG
GCTAGGAA	CCTAGGAA
GCTAGGAG	GCTAGTAG
GCTAGGTA	GCTAGTAG
GCTAGTAA	GCTAGTAG
GCTAGTAC	GCTAGTAG
GCTAGTAG	GCTAGTAG
GCTAGTAT	GCTAGTAG
GCTAGTAN	GCTAGTAG
GCTAGTCA	GCTAGTAG
GCTAGTCG	GCTAGTAG
GCTAGTGA	GCTAGTAG
GCTAGTGC	GCTAGTAG
GCTAGTGG	GCTAGTAG
GCTAGTGT	GCTAGTAG
GCTAGTGN	GCTAGTAG
GCTAGTTC	GGCTAGTT
GCGAGGTG	GCGGGTGA
GCTAGTTT	GGCTAGTT
GCTAGTTN	GGCTAGTT
GCTAGTNA	GCTAGTAG
GCTAGTNG	GCTAGTAG
GCTAGNAG	GCTAGTAG
GCAACACT	GCAATACT
GCAACAGC	GCAACGGC
GCAACAGG	GCAACGGC
GCGAGTAG	GCTAGTAG
GCTAGNTA	GCTAGTAG
GCTATAAC	GGTATAAC
GGCATAAA	GGCATAGA
GGCATAAG	GGCATAGA
GCTATACT	GCAATACT
GGCATAAT	GGCATAGA
GGCATAAN	GGCATAGA
GCTATAGA	GCTAGTAG
GCGAGTGA	GCGGGTGA
GCTATAGC	GCTAGTAG
GGCATACG	GGCATAGA
GCTATAGG	GCTAGTAG
GCTATAGT	GCTAGTAG
GCTATAGN	GCTAGTAG
GGCATAGA	GGCATAGA
GANAGCTA	GAAGCTAG
GGCATAGC	GGCATAGA
GGCATAGG	GGCATAGA
GGCATAGN	GGCATAGA
GGCATATA	GGCATAGA
GGCATATG	GGCATAGA
GGCATANA	GGCATAGA
GGCATANG	GGCATAGA
GCTCCACC	GTCCACCT
GCTATGTA	GCTAGTAG
GCAACCGC	GCAACGGC
GCAACCGG	GCAACGGC
GGCATCAG	GGCATAGA
GCAACCTA	CAACCTAA
GCTATTAG	GCTAGTAG
GGCATCGA	GGCATAGA
GCTATTGG	GATATTGG
GCTATTTA	GCTTTTTA
GCTATTTT	GCTTTTTA
GCAACGAC	GCAACGGC
GCAACGAG	GCAACGGC
GCGATACA	GGGATACA
GGCATGAA	GGCATAGA
GCGATACT	GCAATACT
GGCATGAC	GGCATAGA
GGCATGAG	GGCATAGA
GGCATGAT	GGCATAGA
GCAACGCC	GCAACGGC
GCAACGCG	GCAACGGC
GCAACGCT	GCAACGGC
GGCATGAN	GGCATAGA
GCAACGCN	GCAACGGC
GCAACGGA	GCAACGGC
GCAACGGC	GCAACGGC
GCAACGGG	GCAACGGC
GCAACGGT	GCAACGGC
GCAACGGN	GCAACGGC
GCAACGTC	GCAACGGC
GCAACGTG	GCAACGGC
GGCATGGA	GGCATAGA
GCAACGNC	GCAACGGC
GCAACGNG	GCAACGGC
GCTCCCGA	ACTCCCGA
GCAACTAC	GCAATACT
GCGGACTT	TCGGACTT
GCAACTGC	GCAACGGC
GCAACTGG	GCAACGGC
GGCATTAG	GGCATAGA
GCAACNGC	GCAACGGC
GCAACNGG	GCAACGGC
GCGGAGTG	GCGGGTGA
GGCATTGA	GGCATAGA
GCGGATAC	GGGATACA
GCAAGACT	GCAATACT
GCGGATCC	GGGGATCC
GCGGATGA	GCGGGTGA
GCAAGCGG	GCAACGGC
GGCATNAG	GGCATAGA
GGCATNGA	GGCATAGA
GCAAGCTA	GAAGCTAG
GCAAGGCA	GCAACGGC
GCAAGGCC	GCAACGGC
GCAAGGCG	GCAACGGC
GCAAGGCT	GCAACGGC
GCAAGGCN	GCAACGGC
GCAAGGGC	GCAACGGC
GGCANAGA	GGCATAGA
GCTANGTA	GCTAGTAG
GCAAGTAC	GCAATACT
GCAAGTAG	GCTAGTAG
GCTANTAG	GCTAGTAG
GCGGCCCA	CGGCCCAT
GCAATAAC	GCAATACT
GCAATAAT	GCAATACT
GCAATACA	GCAATACT
GCAATACC	GCAATACT
GCAATACG	GCAATACT
GCAATACT	GCAATACT
GCAATACN	GCAATACT
GCAATAGC	GCAATACT
GCAATAGT	GCAATACT
GATNTTGG	GATATTGG
GCAATATA	GCAATACT
GCAATATC	GCAATACT
GCAATATG	GCAATACT
GCAATATT	GCAATACT
GCAATATN	GCAATACT
GCAATANC	GCAATACT
GCAATANT	GCAATACT
GCAATCAC	GCAATACT
GCAATCCT	GCAATACT
GCAATCGG	GCAACGGC
GCAATCTA	GCAATACT
GCAATCTC	GCAATACT
GCAATCTG	GCAATACT
GCAATCTT	GCAATACT
GCAATCTN	GCAATACT
GCGGCGTG	GCGGGTGA
GCAATGAC	GCAATACT
GANATTGG	GATATTGG
GCAATGCT	GCAATACT
GCAATGGC	GCAACGGC
GCAATTAC	GCAATACT
GCGGCTGA	GCGGGTGA
GCAATTCT	GCAATACT
GCGGCTTC	GTGGCTTC
GGCANTAG	GGCATAGA
GCTCGTAG	GCTAGTAG
GCAATNAC	GCAATACT
GCAATNCT	GCAATACT
GCGGGACC	TCGGGACC
GCGGGAGA	GCGGGTGA
GCTCTACG	GTTCTACG
GCAANACT	GCAATACT
GCGGGATC	GGGGATCC
GCGGGATG	GCGGGTGA
GCAANCGG	GCAACGGC
GGCCACCT	GTCCACCT
GCGGGCGA	GCGGGTGA
GCGGGCTG	GCGGGTGA
GCAANGGC	GCAACGGC
GCGGGGAA	GCGGGTGA
GCGGGGAC	GCGGGTGA
GCTCAGTA	GCTAGTAG
GGCCAGAC	GGCGAGAC
GCTCATCC	ACTCATCC
GCAANTAC	GCAATACT
GCGGGGAG	GCGGGTGA
GGCCAGTT	GGCTAGTT
GCGGGGAT	GCGGGTGA
GCGGGGAN	GCGGGTGA
GCGGGGGA	GCGGGTGA
GCGGGGTG	GCGGGTGA
GGCCATAG	GGCATAGA
GCGGGTAA	GCGGGTGA
GCGGGTAC	GCGGGTGA
GCGGGTAG	GCGGGTGA
GCGGGTAT	GCGGGTGA
GCGGGTAN	GCGGGTGA
GCGGGTCA	GCGGGTGA
GCGGGTCG	GCGGGTGA
GCGGGTGA	GCGGGTGA
GCGGGTGC	GCGGGTGA
GCGGGTGG	GCGGGTGA
GCGGGTGT	GCGGGTGA
GCGGGTGN	GCGGGTGA
GCGGGTTA	GCGGGTGA
GCGGGTTG	GCGGGTGA
GCGGGTNA	GCGGGTGA
GCGGGTNG	GCGGGTGA
GCGGGNGA	GCGGGTGA
GCGGGNTG	GCGGGTGA
GCACAATG	ACACAATG
GCACACGG	GCAACGGC
GGAGGATC	GGGGATCC
GCTCTTTG	GTCTTTGG
GCTCTTTT	GCTTTTTA
GCGCACGA	CGCACGAC
GCGGTCGT	GGGTCGTA
GCGGTCTG	GGGTCTGC
GCGGTGAA	GCGGGTGA
GCGGTGAC	GCGGGTGA
GCGGTGAG	GCGGGTGA
GCGGTGAT	GCGGGTGA
GCGGTGAN	GCGGGTGA
GGAGGGAA	GGTGGGAA
GGCCCATA	CGGCCCAT
GGCCCATC	CGGCCCAT
GGCCCATG	CGGCCCAT
GGCCCATT	CGGCCCAT
GGCCCATN	CGGCCCAT
GCGGTGTG	GCGGGTGA
GCGCATAG	GGCATAGA
GANAATAT	GATAATAT
GCACATAC	GCAATACT
GCGGTTGA	GCGGGTGA
GGCCCGCG	AGCCCGCG
GGCCCTCA	GACCCTCA
GGCCGAGA	GGCGAGAC
GCGGNGTG	GCGGGTGA
GCGGNTGA	GCGGGTGA
GGAGTCGT	GGGTCGTA
GCTGAAAG	TCTGAAAG
GANACGCA	GAACGCAT
GCACCCTC	GACCCTCA
GGAGTCTG	GGGTCTGC
GCACCGGC	GCAACGGC
GGCCGTTC	AGCCGTTC
GANCCCTC	GACCCTCA
GGCCTAGA	GGCATAGA
GGCCTAGT	GGCTAGTT
GCTGAGGA	ACTGAGGA
GCTGAGTA	GCTAGTAG
GCCCTCAA	GACCCTCA
GCCCTCAC	GACCCTCA
GCCCTCAG	GACCCTCA
GCCCTCAT	GACCCTCA
GCCCTCAN	GACCCTCA
GANCCTCA	GACCCTCA
GCACGACA	CGCACGAC
GCACGACC	CGCACGAC
GCACGACG	CGCACGAC
GCACGACT	CGCACGAC
GCACGACN	CGCACGAC
GGCCTTTA	GCCTTTAC
GCTGCGAT	GTGCGATC
GCACGCAT	GAACGCAT
GCCCTTAC	GCCTTTAC
GCCCTTTA	GCCTTTAC
GCTGGAAC	TCTGGAAC
GCACGGCA	GCAACGGC
GCACGGCC	GCAACGGC
GCACGGCG	GCAACGGC
GCACGGCT	GCAACGGC
GCACGGCN	GCAACGGC
GCTGGCCA	CTGGCCAA
GANCGCAT	GAACGCAT
GCTGGCTT	GTGGCTTC
GCTGGGAA	GGTGGGAA
GCTGGGTG	GCGGGTGA
GCTGGTAG	GCTAGTAG
GCTGGTGA	GCGGGTGA
GGATAACA	GGTATAAC
GGATAACG	GGTATAAC
GGATAACT	GGTATAAC
GGATAACN	GGTATAAC
GGATAATA	GATAATAT
GCACTACT	GCAATACT
GGATACAA	GGGATACA
GGATACAC	GGGATACA
GGATACAG	GGGATACA
GGATACAT	GGGATACA
GGATACAN	GGGATACA
GGATAGAA	GGCATAGA
GGATAGAC	GGCATAGA
GGATAGAG	GGCATAGA
GGATAGAT	GGCATAGA
GGATAGAN	GGCATAGA
GCACTCTC	CACTCTCG
GGATAGTT	GGCTAGTT
GGATATAA	GGTATAAC
GCTGTAGA	GCTAGTAG
GGCGAAAC	GGCGAGAC
GGCGAACA	GGCGAGAC
GGCGAACC	GGCGAGAC
GGCGAACG	GGCGAGAC
GGCGAACT	GGCGAGAC
GGCGAACN	GGCGAGAC
GGCGAAGA	GGCGAGAC
GCTGTAGC	GCTAGTAG
GCTGTAGG	GCTAGTAG
GCCGACTT	CCGACTTG
GCTGTAGT	GCTAGTAG
GCTGTAGN	GCTAGTAG
GGCGACAC	GGCGAGAC
GCACTGTT	CACTGTTT
GCCGAGAC	GGCGAGAC
GGCGACGA	GGCGAGAC
GGATATTG	GATATTGG
GGCGAGAA	GGCGAGAC
GGCGAGAC	GGCGAGAC
GGCGAGAG	GGCGAGAC
GCACTTTA	GCCTTTAC
GGCGAGAT	GGCGAGAC
GGCGAGAN	GGCGAGAC
GGCGAGCA	GGCGAGAC
GGCGAGCC	GGCGAGAC
GGCGAGCG	GGCGAGAC
GGCGAGCT	GGCGAGAC
GGCGAGCN	GGCGAGAC
GGCGAGGA	GGCGAGAC
GCTGTCAG	CTGTCAGA
GGCGAGGC	GGCGAGAC
GGCGAGTA	GGCGAGAC
GGCGAGTC	GGCGAGAC
GGCGAGTT	GGCTAGTT
GGCGAGNA	GGCGAGAC
GGCGAGNC	GGCGAGAC
GGCGATAG	GGCATAGA
GGCGATCA	GTGCGATC
GGCGATCG	GTGCGATC
GGCGATCT	GTGCGATC
GGCGATCN	GTGCGATC
GGCGATGA	GGCGAGAC
GCTGTGCC	CTGTGCCA
GCNTAGTA	GCTAGTAG
GGCGANAC	GGCGAGAC
GGCGANGA	GGCGAGAC
GGATCAAA	TGGATCAA
GGATCAAC	TGGATCAA
GGATCAAG	TGGATCAA
GGATCAAT	TGGATCAA
GGATCAAN	TGGATCAA
GGTTGCCT	AGTTGCCT
GCGTAGAA	CGTAGAAA
GGTTGCTG	GGTTCTGA
GGTTGGAA	GGTGGGAA
GCGTAGTA	GCTAGTAG
GGTTGGGA	GGTGGGAA
GCTGTTTA	GCTTTTTA
GCGTATAA	GGTATAAC
GCTGTTTT	GCTTTTTA
GCGTATCA	AGCGTATC
GCGTATCC	AGCGTATC
GCGTATCG	AGCGTATC
GCGTATCT	AGCGTATC
GCGTATCN	AGCGTATC
GGTTGTGA	GGTTCTGA
GGTTTAAC	GGTATAAC
GGATCGTA	GGGTCGTA
GGTTTCTG	GGTTCTGA
GCGTCCGG	CGTCCGGG
GGTTTGAA	GGTTCTGA
GGTTTGAC	GGTTCTGA
GGTTTGAG	GGTTCTGA
GGTTTGAT	GGTTCTGA
GGTTTGAN	GGTTCTGA
GGATCTGA	GGTTCTGA
GGATCTGC	GGGTCTGC
GCGTCGTA	GGGTCGTA
GGTTTTGA	GGTTCTGA
GGTTTTTA	GCTTTTTA
GCGTCTGC	GGGTCTGC
GGATGGGA	GGTGGGAA
GGTTNCTG	GGTTCTGA
GCGTGGGA	GGTGGGAA
GCCTCTAC	GCCTTTAC
GGTTNTGA	GGTTCTGA
GCGTGGTG	GCGGGTGA
GGATTCTG	GGTTCTGA
GCCTCTTA	GCCTTTAC
GCGTGTGA	GCGGGTGA
GGAAATGC	AGAAATGC
GCCGGGTG	GCGGGTGA
GCCGGTGA	GCGGGTGA
GCCTGTAC	GCCTTTAC
GCCTGTTA	GCCTTTAC
GCGTTCTG	GGTTCTGA
GGTNATAA	GGTATAAC
GCGTTTAC	GCCTTTAC
GCGTTTTA	GCTTTTTA
GCGTTTTT	GCTTTTTA
GCCTTAAC	GCCTTTAC
GGTACAAC	GGTATAAC
GCCTTACA	GCCTTTAC
GCCTTACC	GCCTTTAC
GCCTTACG	GCCTTTAC
GCCTTACT	GCCTTTAC
GCCTTACN	GCCTTTAC
GCCTTATA	GCCTTTAC
GGAACGCA	GAACGCAT
GGAACGGC	GCAACGGC
GCCTTCAC	GCCTTTAC
GCCGTTAC	GCCTTTAC
GCCGTTCA	AGCCGTTC
GCCGTTCC	AGCCGTTC
GCCGTTCG	AGCCGTTC
GCCGTTCT	AGCCGTTC
GCCGTTCN	AGCCGTTC
GCCTTCTA	GCCTTTAC
GCCGTTTA	GCCTTTAC
GGTACTAA	GGTATAAC
GCCTTGAC	GCCTTTAC
GGTNCTGA	GGTTCTGA
GGTACTGA	GGTTCTGA
GCCTTGGT	ACCTTGGT
GCCTTGTA	GCCTTTAC
GCNTTTAC	GCCTTTAC
GCNTTTTA	GCTTTTTA
GCNTTTTT	GCTTTTTA
GCCTTTAA	GCCTTTAC
GCCTTTAC	GCCTTTAC
GCCTTTAG	GCCTTTAC
GCCTTTAT	GCCTTTAC
GCCTTTAN	GCCTTTAC
GCCTTTCA	GCCTTTAC
GGAAGCTA	GAAGCTAG
GCCTTTCC	GCCTTTAC
GGTAGAAA	CGTAGAAA
GCCTTTCG	GCCTTTAC
GCCTTTCT	GCCTTTAC
GCCTTTCN	GCCTTTAC
GCCTTTGA	GCCTTTAC
GCCTTTGC	GCCTTTAC
GCCTTTGG	GTCTTTGG
GGTAGAAC	GGTATAAC
GCCTTTTC	GCCTTTAC
GCCTTTTT	GCTTTTTA
GCCTTTNA	GCCTTTAC
GCCTTTNC	GCCTTTAC
GCCTTNAC	GCCTTTAC
GGTNGGAA	GGTGGGAA
GGTNGGGA	GGTGGGAA
GCCTTNTA	GCCTTTAC
GGTAGGAA	GGTGGGAA
GGTAGGGA	GGTGGGAA
GGTAGTAA	GGTATAAC
GGTAGTAG	GCTAGTAG
GGTNTAAC	GGTATAAC
GGAATAAC	GGTATAAC
GGAATACA	GGGATACA
GGTAGTTA	GGCTAGTT
GGAATACT	GCAATACT
GGTAGTTC	GGCTAGTT
GGAATAGA	GGCATAGA
GGTAGTTG	GGCTAGTT
GGTAGTTT	GGCTAGTT
GGTAGTTN	GGCTAGTT
GGTNTCTG	GGTTCTGA
GCCTAACA	CCTAACAG
GCCTNTAC	GCCTTTAC
GGTATAAA	GGTATAAC
GCCTNTTA	GCCTTTAC
GGTATAAC	GGTATAAC
GGTATAAG	GGTATAAC
GGTATAAT	GGTATAAC
GGTATAAN	GGTATAAC
GGTATACC	GGTATAAC
GGTATACG	GGTATAAC
GGTATACT	GGTATAAC
GGTATACN	GGTATAAC
GGTATAGC	GGTATAAC
GCCTAGGA	CCTAGGAA
GGTATATA	GGTATAAC
GGTATATC	GGTATAAC
GCCTAGTA	GCTAGTAG
GGTATANA	GGTATAAC
GCCTAGTT	GGCTAGTT
GGTATANC	GGTATAAC
GCCTATAC	GCCTTTAC
GGTATCAA	GGTATAAC
GGTATCAC	GGTATAAC
GGTATCTG	GGTTCTGA
GGTATGAA	GGTATAAC
GGTATGAC	GGTATAAC
GCCTATTA	GCCTTTAC
GGTATTAA	GGTATAAC
GGTATTAC	GGTATAAC
GCGNGGTG	GCGGGTGA
GGCAAAGA	GGCATAGA
GCGNGTGA	GCGGGTGA
GGCAACGG	GCAACGGC
GGCAAGAA	GGCATAGA
GGCAAGAG	GGCATAGA
GGCAAGAT	GGCATAGA
GGCAAGAN	GGCATAGA
GGTATTGG	GATATTGG
GGGGAACC	GGGGATCC
GGGGAATC	GGGGATCC
GGCAAGTT	GGCTAGTT
GGTATNAA	GGTATAAC
GGCAATAC	GCAATACT
GGTATNAC	GGTATAAC
GGCAATAG	GGCATAGA
GGGGACCA	GGGGATCC
GGGGACCC	GGGGATCC
GGGGACCG	GGGGATCC
GGGGACCT	GGGGATCC
GGGGACCN	GGGGATCC
GGTANAAC	GGTATAAC
GGGGACTC	GGGGATCC
GGGGAGAC	GGCGAGAC
GGGGAGCC	GGGGATCC
GTCCCACC	GTCCACCT
GGGGAGTC	GGGGATCC
GGGAGACC	GGCGAGAC
GGGAGACG	GGCGAGAC
GGCACAGA	GGCATAGA
GGGAGACT	GGCGAGAC
GTCCCATG	TCCCATGC
GCTNGTAG	GCTAGTAG
GGGGATCA	GGGGATCC
GGGGATCC	GGGGATCC
GGGGATCG	GGGGATCC
GGGGATCT	GGGGATCC
GGGGATCN	GGGGATCC
GGGGATGC	GGGGATCC
GGGGATTC	GGGGATCC
GTCCCCCT	GTCCACCT
GGGGATNC	GGGGATCC
GGTANTAA	GGTATAAC
GGGAGACN	GGCGAGAC
GTCCCCTA	GTCCACCT
GTCCCCTC	GTCCACCT
GGGAGATC	GGGGATCC
GTCCCCTG	GTCCACCT
GTCCCCTT	GTCCACCT
GTCCCCTN	GTCCACCT
GGGGANCC	GGGGATCC
GGGGANTC	GGGGATCC
GTCCCTCA	GACCCTCA
GGGGCATC	GGGGATCC
GGCACGAC	CGCACGAC
GGACATAG	GGCATAGA
GGCACTAG	GGCATAGA
GGGGCGTA	GGGTCGTA
GGGGCTCC	GGGGATCC
GGGGCTGC	GGGTCTGC
GGGGCTTC	GTGGCTTC
GGGAGTAC	GGGATACA
GTCCGACC	GTCCACCT
GTCCGATC	GTGCGATC
GCTNTTTA	GCTTTTTA
GCTNTTTT	GCTTTTTA
GGTCAGTT	AGTCAGTT
GGGGGAAA	GGTGGGAA
GGTCATAA	GGTATAAC
GGGGGAAC	GGTGGGAA
GGGGGAAG	GGTGGGAA
GGGGGAAT	GGTGGGAA
GGTCATAG	GGCATAGA
GGGGGAAN	GGTGGGAA
GTCCGCCT	GTCCACCT
GGGATAAA	GGGATACA
GGGATAAG	GGGATACA
GGGATAAT	GGGATACA
GGGATAAN	GGGATACA
GGGATACA	GGGATACA
GGGATACC	GGGATACA
GGGATACG	GGGATACA
GGGATACT	GGGATACA
GGGATACN	GGGATACA
GGGATAGC	GGGATACA
GGCAGACA	GGCGAGAC
GGCAGACC	GGCGAGAC
GGCAGACG	GGCGAGAC
GGCAGACT	GGCGAGAC
GGCAGACN	GGCGAGAC
GGGATATA	GGGATACA
GGGATATC	GGGATACA
GGGATANA	GGGATACA
GGGATANC	GGGATACA
GGGGGATC	GGGGATCC
GGGATCAC	GGGATACA
GGGATCAG	GGGATACA
GGGATCAT	GGGATACA
GTCCGGGA	CGTCCGGG
GTCCGGGC	CGTCCGGG
GGGATCAN	GGGATACA
GTCCGGGG	CGTCCGGG
GTCCGGGT	CGTCCGGG
GGGATCCC	GGGGATCC
GGGATCCG	GGGGATCC
GGGATCCT	GGGGATCC
GTCCGGGN	CGTCCGGG
GGGATCCN	GGGGATCC
GGACCCTC	GACCCTCA
GGGATCGT	GGGTCGTA
GGACCCTT	TGACCCTT
GGGATCTG	GGGTCTGC
GGGGGGAA	GGTGGGAA
GGGATGAC	GGGATACA
GGTCCACC	GTCCACCT
GGGATGCA	GGGATACA
GGGATTAC	GGGATACA
GGGGGTCC	GGGGATCC
GGGATTCA	GGGATACA
GGGGGTGA	GCGGGTGA
GGGATNAC	GGGATACA
GGGATNCA	GGGATACA
GGGGTACA	GGGATACA
GGGGTATC	GGGGATCC
GGGANACA	GGGATACA
GGACGAGA	GGCGAGAC
GGTCCGGG	CGTCCGGG
GGGGTCCA	GGGGATCC
GGGGTCCC	GGGGATCC
GGGGTCCG	GGGGATCC
GGGGTCCT	GGGGATCC
GGGGTCCN	GGGGATCC
GTCCTACC	GTCCACCT
GGGGTCGT	GGGTCGTA
GTCCTACG	GTTCTACG
GGGGTCTG	GGGTCTGC
GGCAGTAG	GGCATAGA
GGGGTGAA	GCGGGTGA
GGGGTGAC	GCGGGTGA
GGGGTGAG	GCGGGTGA
GGTCCTGA	GGTTCTGA
GGGGTGAT	GCGGGTGA
GGGGTGAN	GCGGGTGA
GGCAGTTA	GGCTAGTT
GGCAGTTC	GGCTAGTT
GGCAGTTG	GGCTAGTT
GGCAGTTT	GGCTAGTT
GGCAGTTN	GGCTAGTT
GGACGCAT	GAACGCAT
GTCCTCCT	GTCCACCT
GCNAACGG	GCAACGGC
GGGGTTCC	GGGGATCC
GGTCGAGA	GGCGAGAC
GCNAATAC	GCAATACT
GTCCTTGG	GTCTTTGG
GGGGNATC	GGGGATCC
GTCCTTTA	GCCTTTAC
GTCCTTTG	GTCTTTGG
GGGANTAC	GGGATACA
GGTCGGAA	GGTGGGAA
GGTCGGGA	GGTGGGAA
GGTCGTAA	GGGTCGTA
GGTCGTAC	GGGTCGTA
GGTCGTAG	GGGTCGTA
GGTCGTAT	GGGTCGTA
GGTCGTAN	GGGTCGTA
GGGGNTCC	GGGGATCC
GTCCNACC	GTCCACCT
GTCCNCCT	GTCCACCT
GCCNTTAC	GCCTTTAC
GCCNTTTA	GCCTTTAC
GCNACGGC	GCAACGGC
GGGTACAA	GGGATACA
GGGTACAC	GGGATACA
GGGTACAG	GGGATACA
GGGTACAT	GGGATACA
GGGTACAN	GGGATACA
GGACTAGT	GGCTAGTT
GGTCTAAC	GGTATAAC
GGGTACGT	GGGTCGTA
GGGTACTG	GGGTCTGC
GGTCTACG	GTTCTACG
GGTCTAGT	GGCTAGTT
GGTGAGAA	GGTGGGAA
GTCGACCT	GTCCACCT
GGGTAGTA	GGGTCGTA
GGGTAGTT	GGCTAGTT
GGTGAGAC	GGCGAGAC
GGGTATAA	GGTATAAC
GGGTATAC	GGGATACA
GGTGAGGC	TGGTGAGG
GGTGAGGG	TGGTGAGG
GGTGAGGT	TGGTGAGG
GGGTATCC	GGGGATCC
GGTGAGGN	TGGTGAGG
GGACTCTC	AGACTCTC
GGGTATGC	GGGTCTGC
GTCGAGAC	GGCGAGAC
GGTGATAA	GGTATAAC
GGTGATAC	GGGATACA
GGTGATCC	GGGGATCC
GGTCTCTG	GGTTCTGA
GTCGATCA	GTGCGATC
GTCGATCC	GTGCGATC
GTCGATCG	GTGCGATC
GTCGATCT	GTGCGATC
GTCGATCN	GTGCGATC
GGGTCAGC	GGGTCTGC
GGGTCAGT	GGGTCGTA
GGTCTGAA	GGTTCTGA
GGTCTGAC	GGTTCTGA
GGGTCATA	GGGTCGTA
GGTCTGAG	GGTTCTGA
GGTCTGAT	GGTTCTGA
GGGTCATG	GGGTCTGC
GGTCTGAN	GGTTCTGA
GGTCTGCA	GGGTCTGC
GGTCTGCC	GGGTCTGC
GGTCTGCG	GGGTCTGC
GGTCTGCT	GGGTCTGC
GGTCTGCN	GGGTCTGC
GTCGCACC	GTCCACCT
GGGTCCGC	GGGTCTGC
GGGTCCGT	GGGTCGTA
GGGTCCTA	GGGTCGTA
GGGTCCTG	GGGTCTGC
GGGTCGAA	GGGTCGTA
GGGTCGAC	GGGTCGTA
GGGTCGAG	GGGTCGTA
GGGTCGAT	GGGTCGTA
GGGTCGAN	GGGTCGTA
GGGTCGCC	GGGTCTGC
GGGTCGCG	GGGTCTGC
GGGTCGCN	GGGTCTGC
GGGTCGGA	GGGTCGTA
GGGTCGGC	GGGTCTGC
GGGTCGGT	GGGTCGTA
GGTGCGAA	GGTGGGAA
GGTGCGAT	GTGCGATC
GGGTCGTA	GGGTCGTA
GGGTCGTC	GGGTCGTA
GGGTCGTT	GGGTCGTA
GGTGCGGA	GGTGGGAA
GGGTCGTN	GGGTCGTA
GGGTCGNA	GGGTCGTA
GGGTCGNT	GGGTCGTA
GGGTCTAA	GGGTCGTA
GGGTCTAT	GGGTCGTA
GGGTCTAN	GGGTCGTA
GGGTCTCA	GGGTCTGC
GGGTCTCC	GGGTCTGC
GGGTCTCG	GGGTCTGC
GGGCATAC	GGGATACA
GGGTCTCT	GGGTCTGC
GGGCATAG	GGCATAGA
GGGTCTCN	GGGTCTGC
GGGCATCC	GGGGATCC
GGGTCTGC	GGGTCTGC
GGGTCTGG	GGGTCTGC
GGGTCTGN	GGGTCTGC
GGGTCTTA	GGGTCGTA
GGGTCTTC	GGGTCTGC
GGGTCTTG	GGGTCTGC
GTCGCGAT	GTGCGATC
GGGTCTNC	GGGTCTGC
GGGTCTNG	GGGTCTGC
GGTCTTTG	GTCTTTGG
GGTGCTGA	GGTTCTGA
GGGTCNGC	GGGTCTGC
GTCGCTGG	TCGCTGGC
GGGTCNGT	GGGTCGTA
GTCGCTTC	GTGGCTTC
GGGTCNTA	GGGTCGTA
GGGTCNTG	GGGTCTGC
GGTGGAAA	GGTGGGAA
GGTGGAAC	GGTGGGAA
GGGTGAGG	TGGTGAGG
GGGTGATC	GGGGATCC
GGTGGAAG	GGTGGGAA
GGTGGAAT	GGTGGGAA
GGTGGAAN	GGTGGGAA
GGTGGAGA	GGTGGGAA
GGTGGATC	GGGGATCC
GTCGGACT	TCGGACTT
GGGTGCGT	GGGTCGTA
GGGTGCTG	GGGTCTGC
GGTGGCAA	GGTGGGAA
GCNAGTAG	GCTAGTAG
GGTGGCGA	GGTGGGAA
GTATAACA	GGTATAAC
GTATAACC	GGTATAAC
GGTGGCTT	GTGGCTTC
GGGTGGGA	GGTGGGAA
GTATAACG	GGTATAAC
GTATAACT	GGTATAAC
GTATAACN	GGTATAAC
GGTGGGAA	GGTGGGAA
GGTGGGAC	GGTGGGAA
GGTGGGAG	GGTGGGAA
GGTGGGAT	GGTGGGAA
GGGTGGTA	GGGTCGTA
GTATAATA	GATAATAT
GGTGGGAN	GGTGGGAA
GGTGGGCA	GGTGGGAA
GGGCCCAT	CGGCCCAT
GGTGGGGA	GGTGGGAA
GGTGGGTA	GGTGGGAA
GGTGGGNA	GGTGGGAA
GGGTGTAA	GGGTCGTA
GGGTGTAC	GGGTCGTA
GGGTGTAG	GGGTCGTA
GGGTGTAT	GGGTCGTA
GGTGGTAA	GGTGGGAA
GGGTGTAN	GGGTCGTA
GGGTGTGC	GGGTCTGC
GGTGGTGA	GGTGGGAA
GTCGGCTT	GTGGCTTC
GTCGGGAC	TCGGGACC
GGTGGNAA	GGTGGGAA
GGTGGNGA	GGTGGGAA
GTCGGGTG	GCGGGTGA
GCNATACT	GCAATACT
GGTGTAAC	GGTATAAC
GGGCCGTA	GGGTCGTA
GGGCCTGC	GGGTCTGC
GGTGTCGT	GGGTCGTA
GGGCGAGA	GGCGAGAC
GGTGTGAA	GGTGGGAA
GGTGTGGA	GGTGGGAA
GTATATTG	GATATTGG
GGGCGTAA	GGGTCGTA
GGGCGTAC	GGGTCGTA
GGGCGTAG	GGGTCGTA
GGGCGTAT	GGGTCGTA
GGGCGTAN	GGGTCGTA
GTCGTTGG	GTCTTTGG
GTCGTTTG	GTCTTTGG
GGGCTACA	GGGATACA
GGGCTAGT	GGCTAGTT
GGGCTCGT	GGGTCGTA
GGGCTCTG	GGGTCTGC
GGAGACTA	TGAGACTA
GGGCTGCA	GGGTCTGC
GGGCTGCC	GGGTCTGC
GGGCTGCG	GGGTCTGC
GGGCTGCT	GGGTCTGC
GGGCTGCN	GGGTCTGC
GTAAAAAT	TAAAAATC
GGAGAGAC	GGCGAGAC
GTAAAATA	TTAAAATA
GGTGNGAA	GGTGGGAA
GGTGNGGA	GGTGGGAA
GGGCTTCA	GTGGCTTC
GGGCTTCC	GTGGCTTC
GGGCTTCG	GTGGCTTC
GGGCTTCT	GTGGCTTC
GGGCTTCN	GTGGCTTC
GGAGATAC	GGGATACA
GGAGATCC	GGGGATCC
GTATCTAC	GTTCTACG
GTAAAGAT	TAAAGATT
GGTTAACA	GGTATAAC
GGTTAACC	GGTATAAC
GGTTAACG	GGTATAAC
GGTTAACT	GGTATAAC
GGTTAACN	GGTATAAC
GTAAATGA	TAAATGAC
GGTTACTG	GGTTCTGA
GGTTAGTT	GGCTAGTT
GGTTATAA	GGTATAAC
GGCGCAGA	GGCGAGAC
GGTTATGA	GGTTCTGA
GGAGCGCG	AGAGCGCG
GTTNCTAC	GTTCTACG
GCNCTTTA	GCCTTTAC
GGAGCTAG	GAAGCTAG
GGTTCAGA	GGTTCTGA
GGCGCGAC	GGCGAGAC
GGTTCATG	GGTTCTGA
GGTTCCGA	GGTTCTGA
GGTTCCTG	GGTTCTGA
GGTTCGAA	GGTTCTGA
GGTTCGAC	GGTTCTGA
GGTTCGAG	GGTTCTGA
GGTTCGAT	GGTTCTGA
GGTTCGAN	GGTTCTGA
GGTTCGGA	GGTTCTGA
GGTTCGTA	GGGTCGTA
GGTTCGTG	GGTTCTGA
GGTTCTAA	GGTTCTGA
GGTTCTAG	GGTTCTGA
GGTTCTAT	GGTTCTGA
GGTTCTAN	GGTTCTGA
GGTTCTCA	GGTTCTGA
GGTTCTCG	GGTTCTGA
GGTTCTGA	GGTTCTGA
GGTTCTGG	GGTTCTGA
GGTTCTGT	GGTTCTGA
GGTTCTGN	GGTTCTGA
GGTTCTTA	GGTTCTGA
GGCGGACA	GGCGAGAC
GGCGGACC	GGCGAGAC
GGCGGACG	GGCGAGAC
GGCGGACT	GGCGAGAC
GGCGGACN	GGCGAGAC
GGTTCTTG	GGTTCTGA
GGCGGAGA	GGCGAGAC
GGCGGATC	GGGGATCC
GTAACGCA	GAACGCAT
GGTTCTNA	GGTTCTGA
GGTTCTNG	GGTTCTGA
GTAACGGC	GCAACGGC
GGGTTACA	GGGATACA
GGTTCNGA	GGTTCTGA
GGCGGGAA	GGTGGGAA
GGCGGGAC	GGCGAGAC
GGTTCNTG	GGTTCTGA
GTATTGGA	GATATTGG
GTATTGGC	GATATTGG
GTATTGGG	GATATTGG
GTATTGGT	GATATTGG
GTATTGGN	GATATTGG
GGGTTCGT	GGGTCGTA
GGCGGGTG	GCGGGTGA
GGNTCGTA	GGGTCGTA
GGGTTGCA	GGGTCTGC
GGGTTGCC	GGGTCTGC
GTTNTACG	GTTCTACG
GGGTTGCG	GGGTCTGC
GTATTTGG	GTCTTTGG
GGGTTGCT	GGGTCTGC
GGGTTGCN	GGGTCTGC
GGGTTGTA	GGGTCGTA
GGGTTTGC	GGGTCTGC
GGNTCTGA	GGTTCTGA
GGNTCTGC	GGGTCTGC
GGCGTAGT	GGCTAGTT
GGCGTATC	AGCGTATC
GGCGTCGT	GGGTCGTA
GGCGTCTG	GGGTCTGC
GGCGTGAC	GGCGAGAC
GGGTNCGT	GGGTCGTA
GGGTNCTG	GGGTCTGC
GTAAGCTA	GAAGCTAG
GGNTGGGA	GGTGGGAA
GTAAGGGG	TAAGGGGC
GGGTNGTA	GGGTCGTA
GGCGNAGA	GGCGAGAC
GGGTNTGC	GGGTCTGC
GGCGNGAC	GGCGAGAC
GTCAAAAG	TTCAAAAG
GTAATACT	GCAATACT
GTAATATA	GATAATAT
GTAATATC	GATAATAT
GTAATATG	GATAATAT
GTCAACCT	GTCCACCT
GTAATATT	GATAATAT
GTAATATN	GATAATAT
GTCAACGG	GCAACGGC
GGNTTCTG	GGTTCTGA
GGCTAAGT	GGCTAGTT
GCNGGGTG	GCGGGTGA
GGCTAATT	GGCTAGTT
GTCAATAC	GCAATACT
GCNGGTGA	GCGGGTGA
GGCTACGT	GGCTAGTT
GGCTACTT	GGCTAGTT
GGCTAGAA	GGCATAGA
GGCTAGAG	GGCATAGA
GGCTAGAN	GGCATAGA
GGCTAGCT	GGCTAGTT
GGGNATAC	GGGATACA
GGCTAGGT	GGCTAGTT
GGCTAGTC	GGCTAGTT
GGCTAGTG	GGCTAGTT
GGCTAGTT	GGCTAGTT
GGCTAGTN	GGCTAGTT
GGCTAGNT	GGCTAGTT
GTCACACC	GTCCACCT
GGCTATAA	GGTATAAC
GGCTATAG	GGCATAGA
GGCTATGT	GGCTAGTT
GGCTATTA	GGCTAGTT
GGCTATTC	GGCTAGTT
GGCTATTG	GGCTAGTT
GGCTATTT	GGCTAGTT
GGCTATTN	GGCTAGTT
GGGNATCC	GGGGATCC
GTCACCTA	GTCCACCT
GTCACCTC	GTCCACCT
GGCTANGT	GGCTAGTT
GTCACCTG	GTCCACCT
GTCACCTT	GTCCACCT
GTCACCTN	GTCCACCT
GGCTANTT	GGCTAGTT
GGCTCAGT	GGCTAGTT
GGCTNAGT	GGCTAGTT
GGCTCGTA	GGGTCGTA
GGCTCGTT	GGCTAGTT
GGCTCTGA	GGTTCTGA
GGCTCTGC	GGGTCTGC
GGCTGAGA	GGCGAGAC
GGCTGAGT	GGCTAGTT
GGCTNGTT	GGCTAGTT
GGGNCGTA	GGGTCGTA
GGCTGGGA	GGTGGGAA
GTACACCT	GTCCACCT
GGGNCTGC	GGGTCTGC
GGCTGGTT	GGCTAGTT
GGCTGTTA	GGCTAGTT
GGCTGTTC	GGCTAGTT
GGCTGTTG	GGCTAGTT
GGCTGTTT	GGCTAGTT
GGCTGTTN	GGCTAGTT
GTCAGTTA	AGTCAGTT
GTCAGTTC	AGTCAGTT
GTCAGTTG	AGTCAGTT
GTCAGTTT	AGTCAGTT
GTCAGTTN	AGTCAGTT
GGGNGATC	GGGGATCC
GTACATGG	TACATGGA
GGCTTAGA	GGCATAGA
GGCTTAGT	GGCTAGTT
GTCATAGA	GGCATAGA
GGCNAGAC	GGCGAGAC
GGCNAGTT	GGCTAGTT
GGCTTCTG	GGTTCTGA
GGCNATAG	GGCATAGA
GGCTTGTT	GGCTAGTT
GTTCAAAA	TTCAAAAG
GGCTTTAC	GCCTTTAC
GGCTTTGG	GTCTTTGG
GTTCAACG	GTTCTACG
GTACCACC	GTCCACCT
GGCTTTTT	GCTTTTTA
GTTCACCT	GTCCACCT
GTTCACGA	GTTCTACG
GTTCACGC	GTTCTACG
GTTCACGG	GTTCTACG
GTTCACGT	GTTCTACG
GTTCACGN	GTTCTACG
GTCATTGG	GTCTTTGG
GTCATTTG	GTCTTTGG
GGGNTACA	GGGATACA
GTTCATAC	GTTCTACG
GTACCCTC	GACCCTCA
GGGNTCGT	GGGTCGTA
GGGNTCTG	GGGTCTGC
GTTCCACC	GTCCACCT
GTTCCACG	GTTCTACG
GNCGAGAC	GGCGAGAC
GGCNGAGA	GGCGAGAC
GTGGTCGT	GGGTCGTA
GTGGTCTG	GGGTCTGC
GTGGTCTT	GTGGCTTC
GTGGTGAG	TGGTGAGG
GTTCCTAC	GTTCTACG
GTGGTTCA	GTGGCTTC
GTTCCTCC	ATTCCTCC
GTGGTTCC	GTGGCTTC
GTGGTTCG	GTGGCTTC
GTGGTTCT	GTGGCTTC
GTGGTTCN	GTGGCTTC
GTCCAACC	GTCCACCT
GTCCAACT	GTCCACCT
GTGGTTTC	GTGGCTTC
GTCCACAC	GTCCACCT
GTCCACAT	GTCCACCT
GTCCACCA	GTCCACCT
GTCCACCC	GTCCACCT
GTCCACCG	GTCCACCT
GTCCACCT	GTCCACCT
GTCCACCN	GTCCACCT
GTCCACGC	GTCCACCT
GGTAAAAC	GGTATAAC
GTCCACGT	GTCCACCT
GTCCACTA	GTCCACCT
GGTAAACA	GGTATAAC
GTCCACTC	GTCCACCT
GGTAAACC	GGTATAAC
GTCCACTG	GTCCACCT
GGTAAACG	GGTATAAC
GTCCACTT	GTCCACCT
GGTAAACT	GGTATAAC
GTCCACTN	GTCCACCT
GGTAAACN	GGTATAAC
GTCCACNC	GTCCACCT
GTCCACNT	GTCCACCT
GTCCAGCC	GTCCACCT
GTCCAGCT	GTCCACCT
GTGGNCTT	GTGGCTTC
GTTCGACG	GTTCTACG
GTCCATCC	GTCCACCT
GTTCGATC	GTGCGATC
GTCCATCT	GTCCACCT
GGTAATAA	GGTATAAC
GGTAATAT	GATAATAT
GTCCANCC	GTCCACCT
GTCCANCT	GTCCACCT
GTGGNTTC	GTGGCTTC
GTACGAGC	TACGAGCT
GTACGATC	GTGCGATC
GTTCGTAC	GTTCTACG
GTACGCAT	GAACGCAT
GTTGGCTT	GTGGCTTC
GTTGGGAA	GGTGGGAA
GGCNTAGA	GGCATAGA
GGCNTAGT	GGCTAGTT
GGNATAAC	GGTATAAC
GGNATACA	GGGATACA
GGNATAGA	GGCATAGA
GTTCTAAC	GTTCTACG
GTTCTAAG	GTTCTACG
GTTCTACA	GTTCTACG
GTTCTACC	GTTCTACG
GTTCTACG	GTTCTACG
GTTCTACT	GTTCTACG
GTTCTACN	GTTCTACG
GTTCTAGA	GTTCTACG
GTTGTACG	GTTCTACG
GTGTATAA	GGTATAAC
GTTCTAGC	GTTCTACG
GTTCTAGG	GTTCTACG
GTTCTAGT	GTTCTACG
GTTCTAGN	GTTCTACG
GTTCTATC	GTTCTACG
GTTCTATG	GTTCTACG
GTTCTANC	GTTCTACG
GNCGGGTG	GCGGGTGA
GTGCAATC	GTGCGATC
GTTCTANG	GTTCTACG
GTTCTCAC	GTTCTACG
GTGCACCT	GTCCACCT
GTTCTCCG	GTTCTACG
GTTCTCGA	GTTCTACG
GTTGTGGG	TTGTGGGC
GTTCTCGC	GTTCTACG
GTTCTCGG	GTTCTACG
GTTCTCGT	GTTCTACG
GTTCTCGN	GTTCTACG
GTGCAGAT	GTGCGATC
GTACTACG	GTTCTACG
GTTCTGAA	GGTTCTGA
GTTCTGAG	GGTTCTGA
GTTCTGAT	GGTTCTGA
GTTCTGAN	GGTTCTGA
GTGCATAG	GGCATAGA
GTGTCAGA	CTGTCAGA
GTTCTGCG	GTTCTACG
GTACTCGT	CTACTCGT
GTGCATCA	GTGCGATC
GTGCATCC	GTGCGATC
GTGCATCG	GTGCGATC
GTGCATCT	GTGCGATC
GTGCATCN	GTGCGATC
GTTCTTAC	GTTCTACG
GTTCTTCG	GTTCTACG
GTTCTTTG	GTCTTTGG
GTTCTNAC	GTTCTACG
GTACTTTG	GTCTTTGG
GTTCTNCG	GTTCTACG
GTGTCGAT	GTGCGATC
GTGTCGTA	GGGTCGTA
GTGCCACC	GTCCACCT
GTGCCATC	GTGCGATC
GTTCNACG	GTTCTACG
GTGTCTAC	GTTCTACG
GGGAAACA	GGGATACA
GTGTCTGC	GGGTCTGC
GTGTCTTC	GTGGCTTC
GGGAACAA	GGGATACA
GGGAACAC	GGGATACA
GTTTACCC	TTTACCCT
GTTTACGA	GTTCTACG
GTTTACGC	GTTCTACG
GTTTACGG	GTTCTACG
GTTTACGT	GTTCTACG
GTTTACGN	GTTCTACG
GGGAACAG	GGGATACA
GGGAACAT	GGGATACA
GGGAACAN	GGGATACA
GTGCCGAT	GTGCGATC
GTGTGATC	GTGCGATC
GGGAATAC	GGGATACA
GGGAATCC	GGGGATCC
GTTCNTAC	GTTCTACG
GTGTGCCA	CTGTGCCA
GTAGAAAA	CGTAGAAA
GTAGAAAC	CGTAGAAA
GTAGAAAG	CGTAGAAA
GTGCCTTC	GTGGCTTC
GTAGAAAT	CGTAGAAA
GTAGAAAN	CGTAGAAA
GGNCATAG	GGCATAGA
GTGCGAAC	GTGCGATC
GTGCGAAT	GTGCGATC
GTGCGACA	GTGCGATC
GTGCGACC	GTGCGATC
GTGCGACG	GTGCGATC
GTGTGCTT	GTGGCTTC
GTGCGACT	GTGCGATC
GTGCGACN	GTGCGATC
GTGCGAGA	GGCGAGAC
GTGCGAGC	GTGCGATC
GTGCGAGT	GTGCGATC
GTGCGATA	GTGCGATC
GTGCGATC	GTGCGATC
GTGCGATG	GTGCGATC
GTGCGATT	GTGCGATC
GTGCGATN	GTGCGATC
GTGCGANC	GTGCGATC
GTGCGANT	GTGCGATC
GTGCGCAT	GTGCGATC
GTAGAGCA	TAGAGCAG
GGGACACA	GGGATACA
GTGCGCTC	GTGCGATC
GTGCGCTT	GTGGCTTC
GTGTGGGA	GGTGGGAA
GTGCGGAT	GTGCGATC
GTTTCTAC	GTTCTACG
GTGTGGGC	TTGTGGGC
GTTTCTGA	GGTTCTGA
GTGCGGTC	GTGCGATC
GTGCGTAT	GTGCGATC
GTGCGTCA	GTGCGATC
GTGCGTCC	GTGCGATC
GTGCGTCG	GTGCGATC
GTGCGTCT	GTGCGATC
GTGCGTCN	GTGCGATC
GTGCGTTC	GTGCGATC
GTGCGNAT	GTGCGATC
GTGCGNTC	GTGCGATC
GGGACGTA	GGGTCGTA
GTGCTACG	GTTCTACG
GGGACTAC	GGGATACA
GTGCTAGT	GGCTAGTT
GTGCTATC	GTGCGATC
GGGACTGC	GGGTCTGC
GTAGCGAT	GTGCGATC
GTGCTGAT	GTGCGATC
GTTTGGCT	CTTTGGCT
GTAGCTAG	GAAGCTAG
GTGCTTCA	GTGGCTTC
GTGCTTCC	GTGGCTTC
GTGCTTCG	GTGGCTTC
GGNCGAGA	GGCGAGAC
GTGCTTCT	GTGGCTTC
GGNCTAGT	GGCTAGTT
GTGCTTCN	GTGGCTTC
GTGCTTTG	GTCTTTGG
GTAGCTTC	GTGGCTTC
GNCTAGTA	GCTAGTAG
GNCTAGTT	GGCTAGTT
GTGCNATC	GTGCGATC
GTTGCCTA	AGTTGCCT
GTTGCCTC	AGTTGCCT
GTTGCCTG	AGTTGCCT
GTTGCCTT	AGTTGCCT
GTTGCCTN	AGTTGCCT
GTGTTCTG	GGTTCTGA
GTTGCGAT	GTGCGATC
GTGCNGAT	GTGCGATC
GTAGGCTT	GTGGCTTC
GTTGCTAC	GTTCTACG
GTTTTACG	GTTCTACG
GTTGCTTC	GTGGCTTC
GTGTTTGG	GTCTTTGG
GTTTTGGA	GTCTTTGG
GTGGACTT	GTGGCTTC
GTTTTGGC	GTCTTTGG
GTTTTGGG	GTCTTTGG
GTTTTGGT	GTCTTTGG
GTTTTGGN	GTCTTTGG
GTAGTAAC	TTAGTAAC
GTTTTTAA	GCTTTTTA
GTTTTTAC	GCTTTTTA
GTTTTTAG	GCTTTTTA
GTTTTTAT	GCTTTTTA
GTTTTTAN	GCTTTTTA
GTAGTAGA	GCTAGTAG
GTAGTAGC	GCTAGTAG
GTAGTAGG	GCTAGTAG
GTAGTAGT	GCTAGTAG
GTAGTAGN	GCTAGTAG
GTTTTTGG	GTCTTTGG
GTTTTTTA	GCTTTTTA
GTGGATAC	GGGATACA
GTGGATCG	GTGCGATC
GTGGATCT	GTGCGATC
GTGGATCN	GTGCGATC
GTGGATTC	GTGGCTTC
GTGGCATC	GTGGCTTC
GTGGCATT	GTGGCTTC
GTGGCCAA	CTGGCCAA
GTGGCCTC	GTGGCTTC
GTGGCCTT	GTGGCTTC
GTGGCGAT	GTGCGATC
GTGGCGTC	GTGGCTTC
GTGGCGTT	GTGGCTTC
GTCTACCT	GTCCACCT
GTGGCTAC	GTGGCTTC
GTCTACGA	GTTCTACG
GTGGCTAT	GTGGCTTC
GTGGCTCA	GTGGCTTC
GTCTACGC	GTTCTACG
GTGGCTCC	GTGGCTTC
GTCTACGG	GTTCTACG
GTGGCTCG	GTGGCTTC
GTCTACGT	GTTCTACG
GTGGCTCT	GTGGCTTC
GTCTACGN	GTTCTACG
GTGGCTCN	GTGGCTTC
GTGGCTGC	GTGGCTTC
GTGGCTGT	GTGGCTTC
GTGGCTTA	GTGGCTTC
GTGGCTTC	GTGGCTTC
GTGGCTTG	GTGGCTTC
GTGGCTTT	GTGGCTTC
GTGGCTTN	GTGGCTTC
GTGGCTNC	GTGGCTTC
GTGGCTNT	GTGGCTTC
GTCTAGTA	GCTAGTAG
GTCTAGTT	GGCTAGTT
GGNGAGAC	GGCGAGAC
GTGGCNTC	GTGGCTTC
GTGGCNTT	GTGGCTTC
GTGGGAAA	GGTGGGAA
GTGGGAAC	GGTGGGAA
GTGGGAAG	GGTGGGAA
GTGGGAAT	GGTGGGAA
GTGGGAAN	GGTGGGAA
GGNGATAC	GGGATACA
GGNGATCC	GGGGATCC
GTGGGCTT	GTGGCTTC
GTCTATGG	GTCTTTGG
GTCTATTG	GTCTTTGG
GTGGGTGA	GCGGGTGA
GTCTCACC	GTCCACCT
GTGGGTTC	GTGGCTTC
GGNGGATC	GGGGATCC
GGNGGGAA	GGTGGGAA
GTCTCTAC	GTTCTACG
GTCTCTGG	GTCTTTGG
GTCTCTTG	GTCTTTGG
GGNGTCGT	GGGTCGTA
GGNGTCTG	GGGTCTGC
GTCTGAAA	TCTGAAAG
GNCATAGA	GGCATAGA
GTGNCGAT	GTGCGATC
GNAAGCTA	GAAGCTAG
GTCTGGAA	TCTGGAAC
GTCTGTGG	GTCTTTGG
GTCTGTTG	GTCTTTGG
GTGNCTTC	GTGGCTTC
GTCTTAGG	GTCTTTGG
GNAATACT	GCAATACT
GTCTTATG	GTCTTTGG
GTCTTCGG	GTCTTTGG
GTCTTCTG	GTCTTTGG
GTCTTGGA	GTCTTTGG
GTCTTGGC	GTCTTTGG
GTCTTGGG	GTCTTTGG
GTCTTGGT	GTCTTTGG
GTCTTGGN	GTCTTTGG
GTGNGATC	GTGCGATC
GTCTTGTG	GTCTTTGG
GTCTTTAC	GCCTTTAC
GTCTTTAG	GTCTTTGG
GTCTTTCG	GTCTTTGG
GTCTTTGA	GTCTTTGG
GTCTTTGC	GTCTTTGG
GTCTTTGG	GTCTTTGG
GTCTTTGT	GTCTTTGG
GTCTTTGN	GTCTTTGG
GTCTTTTG	GTCTTTGG
GTCTTTTT	GCTTTTTA
GTCTTTNG	GTCTTTGG
GTGNGCTT	GTGGCTTC
GTCTTNGG	GTCTTTGG
GTCTTNTG	GTCTTTGG
GGNTAGTT	GGCTAGTT
GGNTATAA	GGTATAAC
GTCTNTGG	GTCTTTGG
GTCTNTTG	GTCTTTGG
GTCNACCT	GTCCACCT
GNCCACCT	GTCCACCT
GTCNCACC	GTCCACCT
GTTAAAAT	TTAAAATA
GNACCCTC	GACCCTCA
GTCNTTGG	GTCTTTGG
GTCNTTTG	GTCTTTGG
GTTAATAT	GATAATAT
GTTACAGG	ATTACAGG
GNACGCAT	GAACGCAT
GTTACCCT	TTTACCCT
GTTACTAC	GTTCTACG
GNCCCTCA	GACCCTCA
GNCAACGG	GCAACGGC
GTTAGTAA	TTAGTAAC
GTTAGTAG	GCTAGTAG
GNCAATAC	GCAATACT
GTTATAAC	GGTATAAC
GTTATACG	GTTCTACG
TACGGACT	TCGGACTT
TACGGAGC	TACGAGCT
TACGGCTA	TACGAGCT
TACGGCTC	TACGAGCT
TACGGCTG	TACGAGCT
TACGGCTT	TACGAGCT
TACGGCTN	TACGAGCT
TACGGGAC	TCGGGACC
GTTATTGG	GATATTGG
TACGGGCT	TACGAGCT
TACGGGGC	TAAGGGGC
GNAACGCA	GAACGCAT
GTGACCCT	TGACCCTT
GNAACGGC	GCAACGGC
GTGACGAT	GTGCGATC
GTNCACCT	GTCCACCT
TACGTAGC	TACGAGCT
GTGACTTC	GTGGCTTC
GNGCTAGT	GGCTAGTT
TACGTGCT	TACGAGCT
TACGTGGA	TACATGGA
GTGAGACT	TGAGACTA
GNTCTACG	GTTCTACG
GTGAGATC	GTGCGATC
TACGTTTA	AACGTTTA
GTNCCACC	GTCCACCT
GTGAGCTT	GTGGCTTC
GNCCTTTA	GCCTTTAC
TACGNAGC	TACGAGCT
GNTCTTTG	GTCTTTGG
GNAGCTAG	GAAGCTAG
TACGNGCT	TACGAGCT
GTGATAAC	TGATAACC
GTGATACA	GGGATACA
TACTAAAC	ACTAAACG
GTNCGATC	GTGCGATC
GNGTCGTA	GGGTCGTA
TACTAGCT	TACGAGCT
GNGTCTGC	GGGTCTGC
TACTATGG	TACATGGA
GNGTGGGA	GGTGGGAA
GNGGATAC	GGGATACA
GNGGATCC	GGGGATCC
GNTTCTAC	GTTCTACG
GNTTCTGA	GGTTCTGA
GTNCTACG	GTTCTACG
GNGTTCTG	GGTTCTGA
TACTCAGT	AACTCAGT
TACTCATC	ACTCATCC
GNGGCTTC	GTGGCTTC
GNTGCGAT	GTGCGATC
GTNCTTTG	GTCTTTGG
TACTCCCG	ACTCCCGA
GNGGGATC	GGGGATCC
TACTCGTA	CTACTCGT
TACTCGTC	CTACTCGT
TACTCGTG	CTACTCGT
TACTCGTT	CTACTCGT
TACTCGTN	CTACTCGT
GNGGGTGA	GCGGGTGA
TACTCTCG	CACTCTCG
GTNGCGAT	GTGCGATC
GNTGGCTT	GTGGCTTC
GNTGGGAA	GGTGGGAA
GTNGCTTC	GTGGCTTC
TACTGAAA	TCTGAAAG
GNGGTCGT	GGGTCGTA
GNGGTCTG	GGGTCTGC
TACTGAGC	TACGAGCT
TACTGAGG	ACTGAGGA
GNTTTTTA	GCTTTTTA
TACTGGAC	TACATGGA
TACTGGAG	TACATGGA
TACTGGAT	TACATGGA
TACTGGAN	TACATGGA
GNATAATA	GATAATAT
GTNGGCTT	GTGGCTTC
TACTGTTT	CACTGTTT
GNATATTG	GATATTGG
TACTTCCA	ACTTCCAT
GNGTATAA	GGTATAAC
TACTTGGA	TACATGGA
GNCTTTAC	GCCTTTAC
GNCTTTGG	GTCTTTGG
GNCTTTTT	GCTTTTTA
TAANGATT	TAAAGATT
TAACAAAT	TAAAAATC
TAACAATC	TAAAAATC
TAANGGGC	TAAGGGGC
TAANGGGG	TAAGGGGC
TAACAGAT	TAAAGATT
TACANGGA	TACATGGA
TAACATGA	TAAATGAC
TAACATGG	TACATGGA
TACANTGG	TACATGGA
TAANTGAC	TAAATGAC
TAAAAAAC	TAAAAATC
TAAAAAAT	TAAAAATC
TAAAAACA	TAAAAATC
TAAAAACC	TAAAAATC
TAAAAACG	TAAAAATC
TAAAAACT	TAAAAATC
TAAAAACN	TAAAAATC
TAACCCTT	TGACCCTT
TACCAGCT	TACGAGCT
TANAGATT	TAAAGATT
TAAAAAGC	TAAAAATC
TAAAAAGT	TAAAAATC
TAAAAATC	TAAAAATC
TAAAAATG	TAAAAATC
TAAAAATN	TAAAAATC
TAAAAANC	TAAAAATC
TACCATGC	TCCCATGC
TACCATGG	TACATGGA
TANAGCAG	TAGAGCAG
TAAAAANT	TAAAAATC
GNTAATAT	GATAATAT
TAAAACAT	TAAAAATC
TAACCTAA	CAACCTAA
GTNTCTAC	GTTCTACG
TAAAACTC	TAAAAATC
TACCCATG	TCCCATGC
TANAGGGG	TAAGGGGC
TAAAAGAC	TAAATGAC
TAAAAGTC	TAAAAATC
TAAAATAA	TTAAAATA
TAAAATAC	TTAAAATA
TAAAATAG	TTAAAATA
TAAAATAN	TTAAAATA
TAAAATCA	TAAAAATC
TAAAATCC	TAAAAATC
TAAAATCG	TAAAAATC
TAAAATCT	TAAAAATC
TAAAATCN	TAAAAATC
TAAAATGA	TAAATGAC
TACCCTCA	GACCCTCA
TAAAATTA	TAAAGATT
TAAAATTG	TAAAGATT
TAAAATTT	TAAAGATT
TAAAATTN	TAAAGATT
TACCCTTA	TGACCCTT
TACCCTTC	TGACCCTT
TACCCTTG	TGACCCTT
TACCCTTT	TGACCCTT
TACCCTTN	TGACCCTT
TAAAANAT	TAAAAATC
TAAAANTC	TAAAAATC
TAACGAGC	TACGAGCT
TAACGATT	TAAAGATT
TAAACAAT	TAAAAATC
TAACGCAT	GAACGCAT
TACCGAGC	TACGAGCT
TACAAAAG	TTCAAAAG
TACAAAAT	TAAAAATC
TAAACATC	TAAAAATC
TAAACATT	TAAAGATT
TACAAATC	TAAAAATC
TAAACGAC	TAAATGAC
TAAACGAT	TAAAGATT
GNTAGTAG	GCTAGTAG
TAAACTGA	TAAATGAC
TACAAGAT	TAAAGATT
TACAAGCT	TACGAGCT
TACAAGGA	TACATGGA
TAACGGGC	TAAGGGGC
GNTATAAC	GGTATAAC
TACAATGA	TAAATGAC
TAAAGACA	TAAATGAC
TACAATGG	TACATGGA
TAAAGACC	TAAATGAC
TAAAGACG	TAAATGAC
TAAAGACN	TAAATGAC
TAAAGAGT	TAAAGATT
TAACGGGG	TAAGGGGC
TAAAGATA	TAAAGATT
TAAAGATG	TAAAGATT
TAAAGATT	TAAAGATT
TAAAGATN	TAAAGATT
TAAAGANT	TAAAGATT
TAAAGCAG	TAGAGCAG
TAAAGCAT	TAAAGATT
TAAAGCTC	AAAGCTCG
TAAAGCTT	TAAAGATT
TACCTGGA	TACATGGA
TAAAGGAC	TAAATGAC
TAAAGGAT	TAAAGATT
TACACAAT	ACACAATG
TANATGAC	TAAATGAC
TAAAGGGC	TAAGGGGC
TAAAGGGG	TAAGGGGC
TAAAGGTT	TAAAGATT
TAAAGTAT	TAAAGATT
TAAAGTGA	TAAATGAC
TAACGTTT	AACGTTTA
TACCTTGG	ACCTTGGT
GNTATTGG	GATATTGG
TAAAGTTA	TAAAGATT
TAAAGTTC	TAAAGATT
TAAAGTTG	TAAAGATT
TAAAGTTT	TAAAGATT
TAAAGTTN	TAAAGATT
TANATGGA	TACATGGA
TAAAGNAT	TAAAGATT
TAAAGNTT	TAAAGATT
TAAATAAC	TAAATGAC
TAAATAAT	TAAAAATC
TAAATACA	TAAATGAC
TAAATACC	TAAATGAC
TAAATACG	TAAATGAC
TAAATACT	TAAATGAC
TACACGGA	TACATGGA
TAAATACN	TAAATGAC
TAAATAGA	TAAATGAC
TAAATATC	TAAAAATC
TAAATATT	TAAAGATT
GTNTTTGG	GTCTTTGG
TAAATCAC	TAAATGAC
TAACTCAG	AACTCAGT
TAAATCGA	TAAATGAC
TAAATGAA	TAAATGAC
TAAATGAC	TAAATGAC
TAACTGAC	TAAATGAC
TAAATGAG	TAAATGAC
TAAATGAN	TAAATGAC
TAAATGCA	TAAATGAC
TAAATGCC	TAAATGAC
TAAATGCG	TAAATGAC
TAAATGCT	TAAATGAC
TAAATGCN	TAAATGAC
TAAATGGC	TAAATGAC
TAAATGTA	TAAATGAC
TAAATGTC	TAAATGAC
TACACTGG	TACATGGA
TAAATGNA	TAAATGAC
TAAATGNC	TAAATGAC
TAAATTAC	TAAATGAC
TAAATTGA	TAAATGAC
TAAATNAC	TAAATGAC
TACGAACT	TACGAGCT
TACGAAGC	TACGAGCT
TACGAAGG	ACGAAGGG
TAAATNGA	TAAATGAC
TACGACCT	TACGAGCT
TACAGAGC	TACGAGCT
TACGACGC	TACGAGCT
TACAGATT	TAAAGATT
TACGACTA	TACGAGCT
TACGACTC	TACGAGCT
TACGACTG	TACGAGCT
TACGACTT	TACGAGCT
TACGACTN	TACGAGCT
TACAGCAG	TAGAGCAG
TACAGCCG	ACAGCCGG
TACGAGAC	TACGAGCT
TACGAGAT	TACGAGCT
TACGAGCC	TACGAGCT
TACAGCTA	TACGAGCT
TAAANAAT	TAAAAATC
TACGAGCG	TACGAGCT
TACAGCTC	TACGAGCT
TACGAGCT	TACGAGCT
TACAGCTG	TACGAGCT
TACGAGCN	TACGAGCT
TACAGCTT	TACGAGCT
TACGAGGC	TACGAGCT
TACAGCTN	TACGAGCT
TACGAGGT	TACGAGCT
TACGAGTA	TACGAGCT
TACGAGTC	TACGAGCT
TACGAGTG	TACGAGCT
TACGAGTT	TACGAGCT
TACAGGAA	TACATGGA
TACGAGTN	TACGAGCT
TACAGGAC	TACATGGA
TACGAGNC	TACGAGCT
TACAGGAG	TACATGGA
TACAGGAT	TACATGGA
TACGAGNT	TACGAGCT
TACAGGAN	TACATGGA
TACAGGGA	TACATGGA
TACAGGGG	TAAGGGGC
TACGATCT	TACGAGCT
TACGATGC	TACGAGCT
TACGATGG	TACATGGA
TAAANATC	TAAAAATC
TAAANATT	TAAAGATT
TACAGTGG	TACATGGA
TACGANCT	TACGAGCT
TACGANGC	TACGAGCT
TACGCAGC	TACGAGCT
TAAANGAC	TAAATGAC
TACATAGA	TACATGGA
TACATAGG	TACATGGA
TAAANGAT	TAAAGATT
TACGCGCT	TACGAGCT
TACATCGA	TACATGGA
TACATCGG	TACATGGA
TACATGAA	TACATGGA
TACATGAG	TACATGGA
TACATGAT	TACATGGA
TACATGAN	TACATGGA
TACATGCA	TACATGGA
TACATGCG	TACATGGA
TACGCTGG	TCGCTGGC
TACATGGA	TACATGGA
TACATGGC	TACATGGA
TACATGGG	TACATGGA
TACATGGT	TACATGGA
TACATGGN	TACATGGA
TACATGTA	TACATGGA
TACATGTG	TACATGGA
TACATGNA	TACATGGA
TACATGNG	TACATGGA
TAAANTGA	TAAATGAC
TACATTGA	TACATGGA
TACATTGG	TACATGGA
TANCATGG	TACATGGA
TACATNGA	TACATGGA
TACATNGG	TACATGGA
TAGGCAGA	TAGAGCAG
TAGGCAGC	TAGAGCAG
TAGGCAGG	TAGAGCAG
TAGGCAGT	TAGAGCAG
TAGGCAGN	TAGAGCAG
TATGAAAG	TCTGAAAG
TAGGCCCG	CAGGCCCG
TAAGAAAT	TAAAAATC
TATTTTAC	AATTTTAC
TAAGAATC	TAAAAATC
TATGAGCA	TAGAGCAG
TATGAGCT	TACGAGCT
TAAGACTA	TGAGACTA
TAAGAGAT	TAAAGATT
TANCGAGC	TACGAGCT
TAAGAGCA	TAGAGCAG
GNTCCACC	GTCCACCT
TAAGAGCT	TACGAGCT
TAAGAGGC	TAAGGGGC
TAAGAGGG	TAAGGGGC
TAGGGACC	TCGGGACC
TAAGATGA	TAAATGAC
TAAGATTA	TAAAGATT
TAAGATTC	TAAAGATT
TAAGATTG	TAAAGATT
TAAGATTT	TAAAGATT
TAAGATTN	TAAAGATT
GNGATACA	GGGATACA
TAGGGCAG	TAGAGCAG
TAAGCACC	AAGCACCC
TAAGCAGA	TAGAGCAG
TAAGCAGC	TAGAGCAG
TAAGCAGG	TAGAGCAG
TAAGCAGT	TAGAGCAG
TAAGCAGN	TAGAGCAG
TAGGGGCA	TAAGGGGC
TAAGTAAC	TTAGTAAC
TAGGGGCC	TAAGGGGC
TAGGGGCG	TAAGGGGC
TAGGGGCT	TAAGGGGC
TAGGGGCN	TAAGGGGC
TAGGGGGC	TAAGGGGC
TAGGGGGG	CAGGGGGG
TAAGCGGC	TAAGGGGC
TAAGCGGG	TAAGGGGC
TAAGTGAC	TAAATGAC
TATGGAAC	TCTGGAAC
TAAGTGGC	TAAGGGGC
TAAGCTAG	GAAGCTAG
TAAGTGGG	TAAGGGGC
TAAGCTCG	AAAGCTCG
TCCTAACA	CCTAACAG
TATGGGGC	TAAGGGGC
TAGGTGAG	TGGTGAGG
TCCTAGGA	CCTAGGAA
TAAGGAGC	TAAGGGGC
TAAGGAGG	TAAGGGGC
TAAGGATT	TAAAGATT
TCCTATGC	TCCCATGC
TAAGGCGC	TAAGGGGC
TAAGGCGG	TAAGGGGC
TAAGNGGC	TAAGGGGC
TAAGNGGG	TAAGGGGC
TAAGGGAC	TAAGGGGC
TAAGGGAG	TAAGGGGC
TAAGGGCA	TAAGGGGC
TAAGGGCC	TAAGGGGC
TAAGGGCG	TAAGGGGC
TAAGGGCT	TAAGGGGC
TAAGGGCN	TAAGGGGC
TAAGGGGA	TAAGGGGC
TAAGGGGC	TAAGGGGC
TAAGGGGG	TAAGGGGC
TAAGGGGT	TAAGGGGC
TAAGGGGN	TAAGGGGC
TCCTCATG	TCCCATGC
TAAGGGTC	TAAGGGGC
TAAGGGTG	TAAGGGGC
TAAGGGNC	TAAGGGGC
TAAGGGNG	TAAGGGGC
TAAGGTGC	TAAGGGGC
GNGCATAG	GGCATAGA
TAAGGTGG	TAAGGGGC
TATGTCGT	AATGTCGT
TAAGGNGC	TAAGGGGC
TAAGGNGG	TAAGGGGC
TATGTGGG	TTGTGGGC
TATGTTGT	AATGTTGT
TAATAAAT	TAAAAATC
TAATAACC	TGATAACC
TAATAAGA	AATAAGAA
TCCTGAAA	TCTGAAAG
TAATAATC	TAAAAATC
TAATAGAT	TAAAGATT
TCCTGGAA	TCTGGAAC
TCCTGGCA	TCGCTGGC
TCCTGGCC	TCGCTGGC
TCCTGGCG	TCGCTGGC
TCCTGGCT	TCGCTGGC
TCCTGGCN	TCGCTGGC
TAGTAACA	TTAGTAAC
TAGTAACC	TTAGTAAC
TAGTAACG	TTAGTAAC
TAGTAACT	TTAGTAAC
TAATATGA	TAAATGAC
TAGTAACN	TTAGTAAC
GNGCGAGA	GGCGAGAC
GNGCGATC	GTGCGATC
TAGTACTC	CAGTACTC
TAGTAGCA	TAGAGCAG
TAGNAGCA	TAGAGCAG
TCCTTGGT	ACCTTGGT
TATTACAG	ATTACAGG
TCCTTTAC	GCCTTTAC
TATTACCC	TTTACCCT
TATTATGT	AATTATGT
TAGTCAGT	AGTCAGTT
TACNAGCT	TACGAGCT
TACNATGG	TACATGGA
TAATGACA	TAAATGAC
TAATGACC	TAAATGAC
TAATGACG	TAAATGAC
TAATGACT	TAAATGAC
TAATGACN	TAAATGAC
TAATGATT	TAAAGATT
TATTCCTC	ATTCCTCC
TAGTGAGG	TGGTGAGG
TAGTGCAG	TAGAGCAG
TAGTGGGC	TTGTGGGC
TANAAAAT	TAAAAATC
TAGNGCAG	TAGAGCAG
TAATGGAA	TACATGGA
TAATGGAC	TACATGGA
TAATGGAG	TACATGGA
TAATGGAT	TACATGGA
TAATGGAN	TACATGGA
TANAAATC	TAAAAATC
TAATGGGC	TAAGGGGC
TAATGGGG	TAAGGGGC
TANAAGAT	TAAAGATT
TAATGTCG	AATGTCGT
TCCNATGC	TCCCATGC
TAATGTTG	AATGTTGT
TACNGAGC	TACGAGCT
TAGTTGCC	AGTTGCCT
TANAATGA	TAAATGAC
TCCNCATG	TCCCATGC
TAATTATG	AATTATGT
TCAAAAAT	TAAAAATC
TCAAAAGA	TTCAAAAG
TCAAAAGC	TTCAAAAG
TCAAAAGG	TTCAAAAG
TCAAAAGT	TTCAAAAG
TCAAAAGN	TTCAAAAG
TCAAAATA	TTAAAATA
TAATTGAC	TAAATGAC
TCCCGATG	TCCCATGC
TCAAAATC	TAAAAATC
TAATTTTA	AATTTTAC
TCCCGGCA	CCCCGGCA
TACNTGGA	TACATGGA
TCAAAGAT	TAAAGATT
TCCAAAAG	TTCAAAAG
TCCAAAGT	CCAAAGTC
TCCCGTGC	TCCCATGC
TCAAAGTC	CCAAAGTC
TCAAATGA	TAAATGAC
TCCCTATG	TCCCATGC
TCAACCTA	CAACCTAA
TCCAATGC	TCCCATGC
TCCCTGCA	TCCCATGC
TCCCTGCC	TCCCATGC
TCAACGGC	GCAACGGC
TCCCTGCG	TCCCATGC
TCCCTGCT	TCCCATGC
TCCCTGCN	TCCCATGC
TCCCTGGC	TCGCTGGC
TAANAAAT	TAAAAATC
TCCCTTGC	TCCCATGC
TCCACATG	TCCCATGC
TAGAAAAT	TAAAAATC
TAANAATC	TAAAAATC
TAGAAATC	TAAAAATC
TAGAAATG	AGAAATGC
TAGAACAG	TAGAGCAG
TCCACCTA	GTCCACCT
TCCACCTC	GTCCACCT
TCCACCTG	GTCCACCT
TCCACCTT	GTCCACCT
TCCACCTN	GTCCACCT
TAGAAGAT	TAAAGATT
TAGAAGCA	TAGAGCAG
TAGAATGA	TAAATGAC
TCAAGATT	TAAAGATT
TAANAGAT	TAAAGATT
TCCCNATG	TCCCATGC
TAANATGA	TAAATGAC
TAGACAGA	TAGAGCAG
TAGACAGC	TAGAGCAG
TAGACAGG	TAGAGCAG
TAGACAGT	TAGAGCAG
TAGACAGN	TAGAGCAG
TCNCATGC	TCCCATGC
TAGACCAG	TAGAGCAG
TAGACCCT	TGACCCTT
TCAAGGGG	TAAGGGGC
TAGACGCA	TAGAGCAG
TAGACTAA	TGAGACTA
TAGACTAC	TGAGACTA
TCNCCATG	TCCCATGC
TAGACTAG	TGAGACTA
TAGACTAT	TGAGACTA
TAGACTAN	TGAGACTA
TATAAATC	TAAAAATC
TAGACTCT	AGACTCTC
TATAGATT	TAAAGATT
TATAGCAG	TAGAGCAG
TATAACCA	TGATAACC
TATAACCC	TGATAACC
TATAACCG	TGATAACC
TCCCNTGC	TCCCATGC
TATAACCT	TGATAACC
TATAACCN	TGATAACC
TAGAGAAG	TAGAGCAG
TAGAGACA	TAGAGCAG
TAGAGACT	TGAGACTA
TAGAGAGA	TAGAGCAG
TAGAGAGC	TAGAGCAG
TAGAGAGG	TAGAGCAG
TAGAGAGT	TAGAGCAG
TAGAGAGN	TAGAGCAG
TATAAGAA	AATAAGAA
TAGAGATT	TAAAGATT
TATAAGAT	TAAAGATT
TAGAGCAA	TAGAGCAG
TAGAGCAC	TAGAGCAG
TAGAGCAG	TAGAGCAG
TAGAGCAT	TAGAGCAG
TAGAGCAN	TAGAGCAG
TAGAGCCA	TAGAGCAG
TAGAGCCG	TAGAGCAG
TAGAGCGA	TAGAGCAG
TAGAGCGG	TAGAGCAG
TAGAGCGT	TAGAGCAG
TAGAGCGN	TAGAGCAG
TCCGAAAG	TCTGAAAG
TAGAGCTC	TACGAGCT
TAGAGCTN	TACGAGCT
TAGAGCNA	TAGAGCAG
TCCATATG	CCATATGC
TAGAGCNG	TAGAGCAG
TATAATAT	GATAATAT
TCAATACT	GCAATACT
TAGAGGAG	TAGAGCAG
TAGAGGCA	TAGAGCAG
TATAATGA	TAAATGAC
TAGAGGGG	TAAGGGGC
TAGAGTAG	TAGAGCAG
TAGAGTCA	TAGAGCAG
TCCATGCA	TCCCATGC
TATAGGGG	TAAGGGGC
TCCATGCC	TCCCATGC
TCCATGCG	TCCCATGC
TCCATGCT	TCCCATGC
TCCATGCN	TCCCATGC
TCAATGAC	TAAATGAC
TCCATGGA	TACATGGA
TATAGTAA	TTAGTAAC
TAGAGNAG	TAGAGCAG
TAGAGNCA	TAGAGCAG
TCCGAGCT	TACGAGCT
TATACCCT	TTTACCCT
TATATGAC	TAAATGAC
TATATGGA	TACATGGA
TCCGATGC	TCCCATGC
TATATTGG	GATATTGG
TCNCTGGC	TCGCTGGC
TCCCAAGC	TCCCATGC
TCCGCATG	TCCCATGC
TCCCAATG	TCCCATGC
TANGAGCA	TAGAGCAG
TANGAGCT	TACGAGCT
TCCCACGC	TCCCATGC
TCCCACTG	TCCCATGC
TATCAAAA	TTCAAAAG
TCCCAGCA	TCCCATGC
TCCCAGCC	TCCCATGC
TCCCAGCG	TCCCATGC
TCCCAGCT	TCCCATGC
TCCCAGCN	TCCCATGC
TAGATAAC	TGATAACC
TCACAATG	ACACAATG
TCCGCTGG	TCGCTGGC
TAGATCAA	TGGATCAA
TAGATCAG	TAGAGCAG
TCACTCTC	CACTCTCG
TCCCAGGC	TCCCATGC
TCCCAGTG	TCCCATGC
TCACATGC	TCCCATGC
TCACATGG	TACATGGA
TCCCATAC	TCCCATGC
TCCCATAG	TCCCATGC
TCCCATCA	TCCCATGC
TCCCATCC	TCCCATGC
TCCCATCG	TCCCATGC
TCCCATCT	TCCCATGC
TCCCATCN	TCCCATGC
TCCCATGA	TCCCATGC
TCCCATGC	TCCCATGC
TCCCATGG	TCCCATGC
TAGATGAC	TAAATGAC
TAGATGCA	TAGAGCAG
TAGATGGA	TACATGGA
TCCGGAAC	TCTGGAAC
TCACTGGC	TCGCTGGC
TCCGGACC	TCGGGACC
TCCCATGT	TCCCATGC
TCCCATGN	TCCCATGC
TCCGGACT	TCGGACTT
TCCCATTC	TCCCATGC
TCCCATTG	TCCCATGC
TCCCATNC	TCCCATGC
TCCCATNG	TCCCATGC
TCACCATG	TCCCATGC
TCACTGTT	CACTGTTT
TCCCANGC	TCCCATGC
TCCCANTG	TCCCATGC
TATCATGG	TACATGGA
TCCGGGAC	TCGGGACC
TCCCCATG	TCCCATGC
TCACCCTT	TGACCCTT
TCCCCGGC	CCCCGGCA
TCCCCTGC	TCCCATGC
TANGGGGC	TAAGGGGC
TCNGAAAG	TCTGAAAG
TCTGTAAA	TCTGAAAG
TCTGTAAC	TCTGGAAC
TCTGTAAG	TCTGAAAG
TAGANCAG	TAGAGCAG
TCACGAGC	TACGAGCT
TCTGTCAG	CTGTCAGA
TCNGACTT	TCGGACTT
TAGANGCA	TAGAGCAG
TCTGTGAA	TCTGGAAC
TCTGTGCC	CTGTGCCA
TCTGTGGG	TTGTGGGC
TATCGAGC	TACGAGCT
TCGGNACC	TCGGGACC
TCGGNACT	TCGGACTT
TCTGNAAA	TCTGAAAG
TCTGNAAC	TCTGGAAC
TCTGNAAG	TCTGAAAG
TATCGGTC	CATCGGTC
TCAGAAAG	TCTGAAAG
TCGGNCTT	TCGGACTT
TCGGNGAC	TCGGGACC
TCAGACTA	TGAGACTA
TCAGACTT	TCGGACTT
TCTGNGAA	TCTGGAAC
TCAGAGCA	TAGAGCAG
TCAGAGCT	CAGAGCTT
TCNGCTGG	TCGCTGGC
TAGCACCC	AAGCACCC
TCTTAAAG	TCTGAAAG
TCTTACCC	TTTACCCT
TAGCAGCA	TAGAGCAG
TCAGCCGG	ACAGCCGG
TCGTACTT	TCGGACTT
TCGTAGAA	CGTAGAAA
TAGCATGG	TACATGGA
TCAGCTGG	TCGCTGGC
TCGTCCGG	CGTCCGGG
TGCTTTTT	GCTTTTTA
TCTNGAAA	TCTGAAAG
TCTNGAAC	TCTGGAAC
TCGTCTGG	TCGCTGGC
TCAGGAAC	TCTGGAAC
TCAGGACC	TCGGGACC
TCAGGACT	TCGGACTT
TCTNGGAA	TCTGGAAC
TAGCCCGC	AGCCCGCG
TCAGGCCC	CAGGCCCG
TCGTGAAA	TCTGAAAG
TCGTGACC	TCGGGACC
TCGTGACT	TCGGACTT
TCGTGAGG	TGGTGAGG
TCAGGGAC	TCGGGACC
TCAGGGGC	TAAGGGGC
TCAGGGGG	CAGGGGGG
TAGCCGTT	AGCCGTTC
TCGTGGAA	TCTGGAAC
TCGTGGAC	TCGGGACC
TCGTGGCA	TCGCTGGC
TCGTGGCC	TCGCTGGC
TCTTCCAT	ACTTCCAT
TCGTGGCG	TCGCTGGC
TCGTGGCT	TCGCTGGC
TCGTGGCN	TCGCTGGC
TCGTGGGC	TTGTGGGC
TCAGTAAC	TTAGTAAC
TCAGTACT	CAGTACTC
TAGCGAGC	TACGAGCT
TAGCGCAG	TAGAGCAG
TCATCGGT	CATCGGTC
TAGCGTAT	AGCGTATC
TCATGAAA	TCTGAAAG
TCTTGAAA	TCTGAAAG
TCTTGAAC	TCTGGAAC
TCGTTGGC	TCGCTGGC
TCTTGGAA	TCTGGAAC
TAGCTGGC	TCGCTGGC
TCATGGAC	TACATGGA
TCATGGAG	TACATGGA
TCATGGAT	TACATGGA
TCATGGAN	TACATGGA
TCGAAAGA	TCTGAAAG
TCGAAAGC	TCTGAAAG
TCGAAAGG	TCTGAAAG
TCGAAAGT	TCTGAAAG
TCGAAAGN	TCTGAAAG
TCATAACC	TGATAACC
TCGAACTT	TCGGACTT
TCGAAGGG	ACGAAGGG
TCTTTGGA	GTCTTTGG
TCTTTGGG	GTCTTTGG
TCTTTGGT	GTCTTTGG
TCTTTGGN	GTCTTTGG
TCGNACTT	TCGGACTT
TCTTTTTA	GCTTTTTA
TCGACCCT	TGACCCTT
TCATATGC	CCATATGC
TAGGACTT	TCGGACTT
TCGACTGG	TCGCTGGC
TCGACTTA	TCGGACTT
TCGACTTC	TCGGACTT
TCGACTTT	TCGGACTT
TCGACTTN	TCGGACTT
TAGGAGCA	TAGAGCAG
TAGGAGCT	TACGAGCT
TCGNGACC	TCGGGACC
TCGNGACT	TCGGACTT
TAGGATCA	TGGATCAA
TCGAGACC	TCGGGACC
TCGNGGAC	TCGGGACC
TCGAGCAG	TAGAGCAG
TCGAGCTA	TACGAGCT
TCGAGCTC	TACGAGCT
TCGAGCTG	TACGAGCT
TCGAGCTT	TACGAGCT
TCGAGCTN	TACGAGCT
TCGNCTGG	TCGCTGGC
TCGAGGAC	TCGGGACC
TGGAACAA	TGGATCAA
TGAATAAC	TGATAACC
TCTNAAAG	TCTGAAAG
TCGATAAC	TGATAACC
TCGNTGGC	TCGCTGGC
TCGATCAA	TGGATCAA
TCGATGGC	TCGCTGGC
TGAATCAA	TGGATCAA
TGAATGAC	TAAATGAC
TGGAATCA	TGGATCAA
TGCAGACT	TGAGACTA
TCTAAAAG	TCTGAAAG
TCTAAAAT	TTAAAATA
TCTAAACG	ACTAAACG
TCTAAAGA	TCTGAAAG
TCTAAAGC	TCTGAAAG
TCTAAAGG	TCTGAAAG
TCTAAAGT	TCTGAAAG
TCTAAAGN	TCTGAAAG
TCTAACAG	CCTAACAG
TCGCACGA	CGCACGAC
TCGCACTT	TCGGACTT
TCGCAGGC	TCGCTGGC
TGCATAAC	TGATAACC
TGCATAGA	GGCATAGA
TGCATCAA	TGGATCAA
TGCGACTA	TGAGACTA
TCGCATGC	TCCCATGC
TCGCATGG	TCGCTGGC
TGCGAGAC	GGCGAGAC
TGCGAGCT	TACGAGCT
TGCATGGA	TACATGGA
TCNGGAAC	TCTGGAAC
TGCGATCC	GTGCGATC
TGCGATCG	GTGCGATC
TGCGATCT	GTGCGATC
TGCGATCN	GTGCGATC
TCNGGACC	TCGGGACC
TGACAACC	TGATAACC
TCNGGACT	TCGGACTT
TCTACCCT	TTTACCCT
TGACACCT	TGACCCTT
TGACACTA	TGAGACTA
TGACACTT	TGACCCTT
TCNGGGAC	TCGGGACC
TCTACTCG	CTACTCGT
TGACATGG	TACATGGA
TCTAGAAA	TCTGAAAG
TCTAGAAC	TCTGGAAC
TCTCAAAA	TTCAAAAG
TCTCAAAG	TCTGAAAG
TGACCACT	TGACCCTT
TGACCATT	TGACCCTT
TGACCCAT	TGACCCTT
TGCGCTGG	TCGCTGGC
TGACCCCT	TGACCCTT
TGACCCGT	TGACCCTT
TCTAGTAA	TTAGTAAC
TCTAGTAG	GCTAGTAG
TGACCCTA	TGACCCTT
TGACCCTG	TGACCCTT
TGACCCTT	TGACCCTT
TGACCCTN	TGACCCTT
TGACCCNT	TGACCCTT
TGACCGCT	TGACCCTT
TGACCGTT	TGACCCTT
TCTCATCC	ACTCATCC
TGACCTCT	TGACCCTT
TCTCATGC	TCCCATGC
TGCGGACT	TCGGACTT
TGACCTTA	TGACCCTT
TGACCTTC	TGACCCTT
TGACCTTG	TGACCCTT
TGACCTTT	TGACCCTT
TGACCTTN	TGACCCTT
TGACCNCT	TGACCCTT
TCTCCATG	TCCCATGC
TGACCNTT	TGACCCTT
TGACGACT	TGAGACTA
TCTCCCGA	ACTCCCGA
TGACGAGC	TACGAGCT
TGCGGGAC	TCGGGACC
TGACGCCT	TGACCCTT
TGACGCTT	TGACCCTT
TGCGGGTG	GCGGGTGA
TGCCATGC	TCCCATGC
TCTCGAAA	TCTGAAAG
TCTCGAAC	TCTGGAAC
TGACTAAC	TGATAACC
TGCGTATC	AGCGTATC
TGCCCATG	TCCCATGC
TCTCGGAA	TCTGGAAC
TGAGCACT	TGAGACTA
TGCCCCTT	TGACCCTT
TGAGCAGA	TAGAGCAG
TGAGCAGC	TAGAGCAG
TGAGCAGG	TAGAGCAG
TGAGCAGT	TAGAGCAG
TGAGCAGN	TAGAGCAG
TGCCCGCG	AGCCCGCG
TGCGTGAG	TGGTGAGG
TGAGCCCT	TGACCCTT
TGAGCCTA	TGAGACTA
TGAGCCTT	TGACCCTT
TGACTCCT	TGACCCTT
TGAGCGCG	AGAGCGCG
TGACTCTC	AGACTCTC
TGCCCTTA	TGACCCTT
TGCCCTTC	TGACCCTT
TGCCCTTG	TGACCCTT
TGCCCTTT	TGACCCTT
TGCCCTTN	TGACCCTT
TGACTCTT	TGACCCTT
TGAGCTAA	TGAGACTA
TGAGCTAC	TGAGACTA
TGAGCTAG	TGAGACTA
TGAGCTAT	TGAGACTA
TGAGCTAN	TGAGACTA
TGNGACTA	TGAGACTA
TCTCTGGC	TCGCTGGC
TCNTGAAA	TCTGAAAG
TGNGATCA	TGGATCAA
TGCCGTTC	AGCCGTTC
TGCTAACC	TGATAACC
TCNTGGAA	TCTGGAAC
TGAGGACT	TGAGACTA
TGCTAGTA	GCTAGTAG
TGCTAGTT	GGCTAGTT
TCGCCATG	TCCCATGC
TGAGGCTA	TGAGACTA
TGACNCCT	TGACCCTT
TGACNCTT	TGACCCTT
TGAGGGGC	TAAGGGGC
TCGCCGGC	TCGCTGGC
TGCCTTTA	GCCTTTAC
TCGCCTGG	TCGCTGGC
TCTGAAAA	TCTGAAAG
TCTGAAAG	TCTGAAAG
TCTGAAAT	TCTGAAAG
TCTGAAAN	TCTGAAAG
TCTGAACC	TCTGGAAC
TGAGAACC	TGATAACC
TCTGAACT	TCTGGAAC
TCTGAACN	TCTGGAAC
TGAGAACT	TGAGACTA
TCTGAAGA	TCTGAAAG
TCTGAAGC	TCTGAAAG
TCTGAAGG	TCTGAAAG
TCTGAAGT	TCTGAAAG
TCGCGACC	TCGGGACC
TCTGAAGN	TCTGAAAG
TCTGAATA	TCTGAAAG
TCGCGACT	TCGGACTT
TGAGTACT	TGAGACTA
TCTGAATG	TCTGAAAG
TGAGAATA	TGAGACTA
TCTGAANA	TCTGAAAG
TCTGAANG	TCTGAAAG
TCTGACAA	TCTGAAAG
TCTGACAG	TCTGAAAG
TCTGACTT	TCGGACTT
TGAGTCTA	TGAGACTA
TCTGAGAG	TCTGAAAG
TGAGTGAG	TGGTGAGG
TCGCGGAC	TCGGGACC
TCTGAGGA	ACTGAGGA
TGCTGAAA	TCTGAAAG
TCGCGGCA	TCGCTGGC
TCGCGGCC	TCGCTGGC
TCGCGGCG	TCGCTGGC
TCGCGGCT	TCGCTGGC
TCGCGGCN	TCGCTGGC
TGAGACAA	TGAGACTA
TGAGACAC	TGAGACTA
TGAGACAG	TGAGACTA
TGCTGAGG	TGGTGAGG
TCGCGGGC	TCGCTGGC
TCTGATAA	TCTGAAAG
TCTGATAG	TCTGAAAG
TGAGACAT	TGAGACTA
TGAGACAN	TGAGACTA
TGAGACCA	TGAGACTA
TGAGACCT	TGAGACTA
TGAGACGA	TGAGACTA
TGAGACGT	TGAGACTA
TGAGACTA	TGAGACTA
TGAGACTC	TGAGACTA
TGAGACTG	TGAGACTA
TGAGACTT	TGAGACTA
TGAGACTN	TGAGACTA
TGAGACNA	TGAGACTA
TGAGACNT	TGAGACTA
TCTGANAA	TCTGAAAG
TCTGANAG	TCTGAAAG
TGAGAGCA	TAGAGCAG
TGAGAGCT	TGAGACTA
TGCTGGAA	TCTGGAAC
TGAGAGTA	TGAGACTA
TGCTGGCA	TCGCTGGC
TGCTGGCC	TCGCTGGC
TGCTGGCG	TCGCTGGC
TGCTGGCT	TCGCTGGC
TGCTGGCN	TCGCTGGC
TGAGATAA	TGAGACTA
TCGCGTGG	TCGCTGGC
TGAGATAC	TGAGACTA
TGAGATAG	TGAGACTA
TGAGATAT	TGAGACTA
TGAGATAN	TGAGACTA
TGAGATCA	TGGATCAA
TCTGCAAA	TCTGAAAG
TCTGCAAC	TCTGGAAC
TGAGATCT	TGAGACTA
TCTGCAAG	TCTGAAAG
TGAGATTA	TGAGACTA
TGAGANCT	TGAGACTA
TGAGANTA	TGAGACTA
TGGTGAAG	TGGTGAGG
TGGTGACG	TGGTGAGG
TGGTGAGA	TGGTGAGG
TGGTGAGC	TGGTGAGG
TGGTGAGG	TGGTGAGG
TGGTGAGT	TGGTGAGG
TGGTGAGN	TGGTGAGG
TGGTGATG	TGGTGAGG
TGGTGANG	TGGTGAGG
TCGCTAGC	TCGCTGGC
TCGCTAGG	TCGCTGGC
TCTGCGAA	TCTGGAAC
TGAGNACT	TGAGACTA
TGGTGCAG	TGGTGAGG
TGGTGCGG	TGGTGAGG
TGGTGGAG	TGGTGAGG
TCGCTCGC	TCGCTGGC
TGGTGGGG	TGGTGAGG
TGGTGGGT	TGGTGAGG
TGGTGGGN	TGGTGAGG
TCGCTCGG	TCGCTGGC
TGGTGTAG	TGGTGAGG
TGGTGTGG	TGGTGAGG
TGAGNCTA	TGAGACTA
TGNGTGAG	TGGTGAGG
TGGTGNAG	TGGTGAGG
TCGCTGAC	TCGCTGGC
TCGCTGAG	TCGCTGGC
TCGCTGCA	TCGCTGGC
TCGCTGCC	TCGCTGGC
TCGCTGCG	TCGCTGGC
TGTTCTAC	GTTCTACG
TCGCTGCT	TCGCTGGC
TCGCTGCN	TCGCTGGC
TCGCTGGA	TCGCTGGC
TCGCTGGC	TCGCTGGC
TGGTGNGG	TGGTGAGG
TCGCTGGG	TCGCTGGC
TCGCTGGT	TCGCTGGC
TCGCTGGN	TCGCTGGC
TCTGCTGG	TCGCTGGC
TCGCTGTC	TCGCTGGC
TCGCTGTG	TCGCTGGC
TGTTCTGA	GGTTCTGA
TCGCTGNC	TCGCTGGC
TCGCTGNG	TCGCTGGC
TGGTTAGG	TGGTGAGG
TCGCTTGC	TCGCTGGC
TCGCTTGG	TCGCTGGC
TCTGGAAC	TCTGGAAC
TCTGGAAT	TCTGGAAC
TCTGGAAN	TCTGGAAC
TCTGGACA	TCTGGAAC
TCTGGACG	TCTGGAAC
TGGTTCAA	TGGATCAA
TCTGGACN	TCTGGAAC
TCTGGAGA	TCTGGAAC
TCTGGAGC	TCTGGAAC
TGTTGAGG	TGGTGAGG
TCTGGATA	TCTGGAAC
TCTGGATC	TCTGGAAC
TCTGGANA	TCTGGAAC
TCGCTNGC	TCGCTGGC
TGGTTCTG	GGTTCTGA
TCGCTNGG	TCGCTGGC
TCTGGANC	TCTGGAAC
TGTTGCCT	AGTTGCCT
TCTGGCAA	TCTGGAAC
TCTGGCAC	TCTGGAAC
TGGTTGAG	TGGTGAGG
TCTGGCCA	CTGGCCAA
TGATAAAC	TGATAACC
TGATAACA	TGATAACC
TGATAACC	TGATAACC
TCTGGGAA	TCTGGAAC
TGATAACG	TGATAACC
TGATAACT	TGATAACC
TGATAACN	TGATAACC
TGATAAGC	TGATAACC
TGATAATA	GATAATAT
TGATAATC	TGATAACC
TGATAANC	TGATAACC
TGATACAC	TGATAACC
TGATACCA	TGATAACC
TGATACCC	TGATAACC
TGATACCG	TGATAACC
TGATACCT	TGATAACC
TGATACCN	TGATAACC
TCTGGTAA	TCTGGAAC
TCTGGTAC	TCTGGAAC
TGATACTA	TGAGACTA
TGATAGAC	TGATAACC
TCTGGNAA	TCTGGAAC
TCTGGNAC	TCTGGAAC
TGATAGCC	TGATAACC
TCGCNGGC	TCGCTGGC
TGATATAC	TGATAACC
TGGACAAA	TGGATCAA
TGGACAAC	TGGATCAA
TGGACAAG	TGGATCAA
TGGACAAT	TGGATCAA
TGGACAAN	TGGATCAA
TGATATCC	TGATAACC
TGATNAAC	TGATAACC
TGGTNAGG	TGGTGAGG
TGATNACC	TGATAACC
TGATATTG	GATATTGG
TCGCNTGG	TCGCTGGC
TGATANAC	TGATAACC
TGGACCAA	TGGATCAA
TGATANCC	TGATAACC
TGGACCCT	TGACCCTT
TGNACCCT	TGACCCTT
TGATCAAA	TGGATCAA
TGATCAAG	TGGATCAA
TGATCAAT	TGGATCAA
TGATCAAN	TGGATCAA
TGATCACC	TGATAACC
TCGGAAAG	TCTGAAAG
TCGGAACA	TCTGGAAC
TCGGAACG	TCTGGAAC
TCGGAACN	TCTGGAAC
TCGGAATT	TCGGACTT
TGGACTAA	TGAGACTA
TGGACTAC	TGAGACTA
TCGGACAT	TCGGACTT
TCGGACCA	TCGGGACC
TCGGACCC	TCGGGACC
TCGGACCG	TCGGGACC
TGGACTAG	TGAGACTA
TGGACTAT	TGAGACTA
TCGGACCN	TCGGGACC
TCGGACGT	TCGGACTT
TCGGACTA	TCGGACTT
TGGACTAN	TGAGACTA
TGGACTCA	TGGATCAA
TCGGACTC	TCGGACTT
TCGGACTG	TCGGACTT
TCGGACTT	TCGGACTT
TGGTNGAG	TGGTGAGG
TCGGACTN	TCGGACTT
TGGACTTA	TCGGACTT
TGGACTTC	TCGGACTT
TGGACTTG	TCGGACTT
TGGACTTT	TCGGACTT
TGATCCCT	TGACCCTT
TGGACTTN	TCGGACTT
TCGGACNT	TCGGACTT
TCGGAGAC	TCGGGACC
TGATCCTT	TGACCCTT
TGNAGACT	TGAGACTA
TGANAACC	TGATAACC
TGGAGACT	TGAGACTA
TGGAGAGG	TGGTGAGG
TCGGAGCT	TCGGACTT
TCGGAGTT	TCGGACTT
TGANACTA	TGAGACTA
TGGAGCAA	TGGATCAA
TCGGATCA	TGGATCAA
TGGAGCAG	TAGAGCAG
TCGGATCT	TCGGACTT
TCGGATTA	TCGGACTT
TCGGATTC	TCGGACTT
TCGGATTG	TCGGACTT
TCGGATTT	TCGGACTT
TCGGATTN	TCGGACTT
TCGGANCT	TCGGACTT
TGATGAAC	TGATAACC
TGATGACC	TGATAACC
TGATGACT	TGAGACTA
TCGGANTT	TCGGACTT
TGATGAGG	TGGTGAGG
TCGGCACC	TCGGGACC
TCGGCACT	TCGGACTT
TGGAGTCA	TGGATCAA
TGNATAAC	TGATAACC
TCGGCCCA	CGGCCCAT
TCGGCCTT	TCGGACTT
TCGGCGAC	TCGGGACC
TGNATCAA	TGGATCAA
TGGATAAA	TGGATCAA
TGGATAAG	TGGATCAA
TGGATAAT	TGGATCAA
TGGATAAN	TGGATCAA
TCGGCTGG	TCGCTGGC
TCGGCTTA	TCGGACTT
TCGGCTTC	TCGGACTT
TCGGCTTG	TCGGACTT
TCGGCTTT	TCGGACTT
TCGGCTTN	TCGGACTT
TGGNATCA	TGGATCAA
TGGATCAA	TGGATCAA
TGGATCAC	TGGATCAA
TGGATCAG	TGGATCAA
TGGATCAT	TGGATCAA
TGGATCAN	TGGATCAA
TGGATCCA	TGGATCAA
TGGATCGA	TGGATCAA
TGGATCTA	TGGATCAA
TGGATCNA	TGGATCAA
TGGATGAA	TGGATCAA
TGGATGAG	TGGTGAGG
TGGATGCA	TGGATCAA
TCGGGACA	TCGGGACC
TCGGGACC	TCGGGACC
TCGGGACG	TCGGGACC
TCGGGACN	TCGGGACC
TCGGGAGC	TCGGGACC
TCGGGATC	TCGGGACC
TGANCCCT	TGACCCTT
TCGGGANC	TCGGGACC
TGGATTAA	TGGATCAA
TCGGGCAC	TCGGGACC
TGGATTCA	TGGATCAA
TCGGGCCA	TCGGGACC
TGANCCTT	TGACCCTT
TCGGGCCC	TCGGGACC
TCGGGCCG	TCGGGACC
TCGGGCCT	TCGGGACC
TCGGGCCN	TCGGGACC
TCGGGCTT	TCGGACTT
TCGGGGAC	TCGGGACC
TGGATNAA	TGGATCAA
TCGGGGCC	TCGGGACC
TGGATNCA	TGGATCAA
TCGGGTAC	TCGGGACC
TCGGGTCC	TCGGGACC
TCGGGTGA	GCGGGTGA
TCGGGNAC	TCGGGACC
TCGGGNCC	TCGGGACC
TGGANCAA	TGGATCAA
TCGGTACC	TCGGGACC
TCGGTACT	TCGGACTT
TGATTAAC	TGATAACC
TCGGTCTT	TCGGACTT
TGGANTCA	TGGATCAA
TCGGTGAC	TCGGGACC
TCGGTGAG	TGGTGAGG
TGATTACC	TGATAACC
TCGGTGGC	TCGCTGGC
TTGAAAAG	TTCAAAAG
TTGAAAAT	TTAAAATA
TGANGACT	TGAGACTA
TGGCATAG	GGCATAGA
TGGCATCA	TGGATCAA
TTGAAAGA	TCTGAAAG
TTGAAAGC	TCTGAAAG
TTGAAAGG	TCTGAAAG
TTGAAAGT	TCTGAAAG
TTGAAAGN	TCTGAAAG
TTGAAATA	TTAAAATA
TGGCCAAA	CTGGCCAA
TGGCCAAC	CTGGCCAA
TGGCCAAG	CTGGCCAA
TGGCCAAT	CTGGCCAA
TGGCCAAN	CTGGCCAA
TGGNGAGG	TGGTGAGG
TGGCCCAT	CGGCCCAT
TGGCCCTT	TGACCCTT
TGTAAAAT	TTAAAATA
TGANTAAC	TGATAACC
TGTAACCA	TGATAACC
TGTAACCC	TGATAACC
TGTAACCG	TGATAACC
TGTAACCT	TGATAACC
TGTAACCN	TGATAACC
TGGCGAGA	GGCGAGAC
TGGCGAGG	TGGTGAGG
TTGAGACT	TGAGACTA
TTGAGCAG	TAGAGCAG
TGNCCCTT	TGACCCTT
TTGAGGGC	TTGTGGGC
TGGNTCAA	TGGATCAA
TTGAGTAA	TTAGTAAC
TTGATAAC	TGATAACC
TGGNTGAG	TGGTGAGG
TGGCTAGT	GGCTAGTT
TTGATCAA	TGGATCAA
TTCGTAAC	TTAGTAAC
TGGCTCAA	TGGATCAA
TTCCAAAA	TTCAAAAG
TTCCAAAG	TTCAAAAG
TGGCTGAG	TGGTGAGG
TGGCTGGC	TCGCTGGC
TTGATGGG	TTGTGGGC
TTCCACCT	GTCCACCT
TGGCTTCA	GTGGCTTC
TGGCTTCC	GTGGCTTC
TGGCTTCG	GTGGCTTC
TGGCTTCT	GTGGCTTC
TGGCTTCN	GTGGCTTC
TTCGTGGG	TTGTGGGC
TGNTAACC	TGATAACC
TTCCATGC	TCCCATGC
TGTAGAAA	CGTAGAAA
TGTAGACT	TGAGACTA
TTCCCATG	TCCCATGC
TGCAAAAG	TTCAAAAG
TGTAGTAA	TTAGTAAC
TTCTAAAA	TTCAAAAG
TTCTAAAG	TTCAAAAG
TGCAACGG	GCAACGGC
TTCTACCC	TTTACCCT
TTCTACGA	GTTCTACG
TTCTACGC	GTTCTACG
TTCTACGG	GTTCTACG
TTCTACGT	GTTCTACG
TTCTACGN	GTTCTACG
TTACCCTA	TTTACCCT
TTACCCTC	TTTACCCT
TTACCCTG	TTTACCCT
TTACCCTN	TTTACCCT
TGTATCAA	TGGATCAA
TGCAATAC	GCAATACT
TTACGAGC	TACGAGCT
TTACGTAA	TTAGTAAC
TGAAAAAT	TAAAAATC
TGAAAACC	TGATAACC
TGAAAATA	TTAAAATA
TGAAAATC	TAAAAATC
TGCACCCT	TGACCCTT
TGAAACCA	TGATAACC
TGAAACCC	TGATAACC
TGAAACCG	TGATAACC
TGAAACCT	TGATAACC
TGAAACCN	TGATAACC
TGAAACTA	TGAGACTA
TGCACGAC	CGCACGAC
TTACTAAC	TTAGTAAC
TGNTGAGG	TGGTGAGG
TTCTGAAA	TCTGAAAG
TGAAAGAT	TAAAGATT
TGTCAAAA	TTCAAAAG
TTCCTCCA	ATTCCTCC
TTCCTCCC	ATTCCTCC
TTCCTCCG	ATTCCTCC
TTCCTCCT	ATTCCTCC
TTCCTCCN	ATTCCTCC
TTNGTAAC	TTAGTAAC
TTACTCGT	CTACTCGT
TGAAATGA	TAAATGAC
TGAAATGC	AGAAATGC
TTCTGGAA	TCTGGAAC
TTCTGGGC	TTGTGGGC
TGTCAGAA	CTGTCAGA
TGTCAGAC	CTGTCAGA
TGTCAGAG	CTGTCAGA
TGTCAGAT	CTGTCAGA
TGTCAGAN	CTGTCAGA
TGTCAGTT	AGTCAGTT
TTNGTGGG	TTGTGGGC
TGAACCCT	TGACCCTT
TGAACCTT	TGACCCTT
TGTCCACC	GTCCACCT
TGAACGCA	GAACGCAT
TGAACTAA	TGAGACTA
TGAACTAC	TGAGACTA
TGAACTAG	TGAGACTA
TGAACTAT	TGAGACTA
TGAACTAN	TGAGACTA
TGTCCCTT	TGACCCTT
TGTCTTTG	GTCTTTGG
TGTCCGGG	CGTCCGGG
TTAGAAAC	TTAGTAAC
TTAGAAAT	TTAAAATA
TTAGAACA	TTAGTAAC
TTAGAACC	TTAGTAAC
TTAGAACG	TTAGTAAC
TTAGAACT	TTAGTAAC
TTAGAACN	TTAGTAAC
TTAGAATA	TTAAAATA
TTAGACTA	TGAGACTA
TTCTTTGG	GTCTTTGG
TGAAGACT	TGAGACTA
TGAAGATT	TAAAGATT
TTAGAGCA	TAGAGCAG
TTCGAAAA	TTCAAAAG
TTCGAAAG	TTCAAAAG
TTAGATAA	TTAGTAAC
TGAAGCTA	GAAGCTAG
TTNTACCC	TTTACCCT
TTAGCAAC	TTAGTAAC
TGTGAAAG	TCTGAAAG
TGAAGGGG	TAAGGGGC
TTCGAGCT	TACGAGCT
TGTGACTA	TGAGACTA
TTAGNAAC	TTAGTAAC
TGTGAGGA	TGGTGAGG
TGTGAGGC	TGGTGAGG
TGTGAGGG	TGGTGAGG
TGTGAGGT	TGGTGAGG
TGTGAGGN	TGGTGAGG
TTAGCTAA	TTAGTAAC
TGTGATCA	TGGATCAA
TTCNAAAA	TTCAAAAG
TTCNAAAG	TTCAAAAG
TTAGNTAA	TTAGTAAC
TTAGGAAC	TTAGTAAC
TTATAAAT	TTAAAATA
TTATAACA	TTAGTAAC
TTATAACG	TTAGTAAC
TTATAACT	TTAGTAAC
TTATAACN	TTAGTAAC
TTATAATA	TTAAAATA
TTAGGGGC	TAAGGGGC
TGTGCCAA	CTGTGCCA
TGTGCCAC	CTGTGCCA
TGTGCCAG	CTGTGCCA
TTATACCC	TTTACCCT
TGTGCCAT	CTGTGCCA
TGTGCCAN	CTGTGCCA
TTAGGTAA	TTAGTAAC
TGTGCGAT	GTGCGATC
TTCGCTGG	TCGCTGGC
TGTGGAAC	TCTGGAAC
TTAGTAAA	TTAGTAAC
TTAGTAAC	TTAGTAAC
TTAGTAAG	TTAGTAAC
TTAGTAAT	TTAGTAAC
TTAGTAAN	TTAGTAAC
TTAGTACA	TTAGTAAC
TTAGTACC	TTAGTAAC
TTAGTACG	TTAGTAAC
TTAGTACT	TTAGTAAC
TTAGTACN	TTAGTAAC
TGGGACCA	TCGGGACC
TTAGTAGA	TTAGTAAC
TGGGACCC	TCGGGACC
TTAGTAGC	TTAGTAAC
TGGGACCG	TCGGGACC
TGGGACCT	TCGGGACC
TGGGACCN	TCGGGACC
TTAGTATA	TTAGTAAC
TTAGTATC	TTAGTAAC
TTAGTANA	TTAGTAAC
TGGGACTA	TGAGACTA
TTAGTANC	TTAGTAAC
TGGGACTT	TCGGACTT
TTAGTCAA	TTAGTAAC
TTAGTCAC	TTAGTAAC
TGTGGCTT	GTGGCTTC
TGTGGGAA	GGTGGGAA
TGGGAGGA	TGGTGAGG
TGGGAGGC	TGGTGAGG
TGGGAGGG	TGGTGAGG
TGTGGGCA	TTGTGGGC
TGGGAGGT	TGGTGAGG
TGTGGGCC	TTGTGGGC
TGGGAGGN	TGGTGAGG
TGTGGGCG	TTGTGGGC
TGTGGGCT	TTGTGGGC
TGTGGGCN	TTGTGGGC
TTAGTGAA	TTAGTAAC
TTAGTGAC	TTAGTAAC
TGGGATAC	GGGATACA
TGGGATCA	TGGATCAA
TGGGATCC	GGGGATCC
TTNAGTAA	TTAGTAAC
TTAGTGGG	TTGTGGGC
TTAGTTAA	TTAGTAAC
TTAGTTAC	TTAGTAAC
TTAGTNAA	TTAGTAAC
TTAGTNAC	TTAGTAAC
TTCGGACT	TCGGACTT
TGTGTGAG	TGGTGAGG
TTNTGGGC	TTGTGGGC
TGTGTGGG	TTGTGGGC
TTCGGGAC	TCGGGACC
TTATGGGC	TTGTGGGC
TGGGGACC	TCGGGACC
TGGGGAGG	TGGTGAGG
TTATGTAA	TTAGTAAC
TGGGGATC	GGGGATCC
TTATTAAC	TTAGTAAC
TGTTAACC	TGATAACC
TTNCAAAA	TTCAAAAG
TGTTACCC	TTTACCCT
TGGGTCAA	TGGATCAA
TGGGTCGT	GGGTCGTA
TTGCAAAA	TTCAAAAG
TGGGTCTG	GGGTCTGC
TGGGTGAG	TGGTGAGG
TNGACCCT	TGACCCTT
TTGNGGGC	TTGTGGGC
TTTNACCC	TTTACCCT
TNGAGACT	TGAGACTA
TTANAAAT	TTAAAATA
TTANAATA	TTAAAATA
TNGAGCAG	TAGAGCAG
TTGNTGGG	TTGTGGGC
TTGCGATC	GTGCGATC
TTANGTAA	TTAGTAAC
TTTNCCCT	TTTACCCT
TTGCGGGC	TTGTGGGC
TNGATAAC	TGATAACC
TTANTAAC	TTAGTAAC
TNGATCAA	TGGATCAA
TTGCTGGC	TCGCTGGC
TTGCTGGG	TTGTGGGC
TGGTAACC	TGATAACC
TGGTAAGG	TGGTGAGG
TGGTAGAG	TGGTGAGG
TTTAAAAG	TTCAAAAG
TTTAAAAT	TTAAAATA
TGGTAGGA	TGGTGAGG
TGGTAGGC	TGGTGAGG
TGGTAGGG	TGGTGAGG
TGGTAGGT	TGGTGAGG
TGGTAGGN	TGGTGAGG
TGGTATAA	GGTATAAC
TTTAAATA	TTAAAATA
TGGTATCA	TGGATCAA
TTTAACCC	TTTACCCT
TTTATCCC	TTTACCCT
TTTAACCT	TTTACCCT
TTTATCCT	TTTACCCT
TTGGAACA	TCTGGAAC
TTGGAACC	TCTGGAAC
TTGGAACG	TCTGGAAC
TTGGAACT	TCTGGAAC
TTGGAACN	TCTGGAAC
TTGGACTT	TCGGACTT
TGGTCAAA	TGGATCAA
TGGTCAAC	TGGATCAA
TGGTCAAG	TGGATCAA
TGGTCAAT	TGGATCAA
TGGTCAAN	TGGATCAA
TGGTCAGG	TGGTGAGG
TTGGATCA	TGGATCAA
TTCAAAAA	TTCAAAAG
TTCAAAAC	TTCAAAAG
TTCAAAAG	TTCAAAAG
TTCAAAAN	TTCAAAAG
TTCAAACA	TTCAAAAG
TTCAAACG	TTCAAAAG
TTCAAAGA	TTCAAAAG
TTCAAAGC	TTCAAAAG
TTCAAAGG	TTCAAAAG
TTCAAAGT	TTCAAAAG
TTCAAAGN	TTCAAAAG
TTCAAATG	TTCAAAAG
TTCAAANA	TTCAAAAG
TTCAAANG	TTCAAAAG
TTCAACAA	TTCAAAAG
TTCAACAG	TTCAAAAG
TGGTCGAG	TGGTGAGG
TTTACACC	TTTACCCT
TTTACACT	TTTACCCT
TTTACAGG	ATTACAGG
TTTACCAC	TTTACCCT
TGGTCGTA	GGGTCGTA
TTTACCAT	TTTACCCT
TTTACCCA	TTTACCCT
TTTACCCC	TTTACCCT
TTTACCCG	TTTACCCT
TTTACCCT	TTTACCCT
TTTACCCN	TTTACCCT
TTTACCGC	TTTACCCT
TTTACCGT	TTTACCCT
TTGGCCAA	CTGGCCAA
TTTACCTA	TTTACCCT
TTTACCTC	TTTACCCT
TTTACCTG	TTTACCCT
TTTACCTT	TTTACCCT
TTTACCTN	TTTACCCT
TTTACCNC	TTTACCCT
TGGTCTGC	GGGTCTGC
TTTACCNT	TTTACCCT
TTTACGCC	TTTACCCT
TTTACGCT	TTTACCCT
TNCTGAAA	TCTGAAAG
TTCAAGAA	TTCAAAAG
TTCAAGAG	TTCAAAAG
TTTACTCC	TTTACCCT
TTTACTCT	TTTACCCT
TTGGCTTC	GTGGCTTC
TTTACNCC	TTTACCCT
TTTACNCT	TTTACCCT
TNCTGGAA	TCTGGAAC
TTCAATAA	TTCAAAAG
TTCAATAG	TTCAAAAG
TTCAANAA	TTCAAAAG
TTCAANAG	TTCAAAAG
TTTAGCCC	TTTACCCT
TTTAGCCT	TTTACCCT
TTTANCCC	TTTACCCT
TTTANCCT	TTTACCCT
TTCACAAA	TTCAAAAG
TTCACAAG	TTCAAAAG
TTTAGTAA	TTAGTAAC
TTNAAAAG	TTCAAAAG
TTNAAAAT	TTAAAATA
TTCACCCT	TTTACCCT
TTNAAATA	TTAAAATA
TTTCAAAA	TTCAAAAG
TTAAAAAA	TTAAAATA
TTAAAAAC	TTAAAATA
TTTCACCC	TTTACCCT
TTAAAAAN	TTAAAATA
TTAAAACA	TTAAAATA
TTAAAACT	TTAAAATA
TTAAAAGC	TTCAAAAG
TTAAAAGG	TTCAAAAG
TTAAAAGN	TTCAAAAG
TTAAAATA	TTAAAATA
TTAAAATG	TTAAAATA
TTAAAATT	TTAAAATA
TTAAAATN	TTAAAATA
TTCAGAAA	TTCAAAAG
TTAAAANA	TTAAAATA
TTCAGAAG	TTCAAAAG
TTAAAANT	TTAAAATA
TTAAACAT	TTAAAATA
TTAAACTA	TTAAAATA
TTNACCCT	TTTACCCT
TTAAAGTA	TTAAAATA
TTAAATAA	TTAAAATA
TTAAATAC	TTAAAATA
TTAAATAG	TTAAAATA
TTAAATAT	TTAAAATA
TTAAATAN	TTAAAATA
TTCAGTAA	TTAGTAAC
TTAAATGA	TAAATGAC
TTAAATTA	TTAAAATA
TTAAANAT	TTAAAATA
TTAAANTA	TTAAAATA
TTAACAAT	TTAAAATA
TTCATAAA	TTCAAAAG
TTCATAAG	TTCAAAAG
TTAACATA	TTAAAATA
TTAACCCT	TTTACCCT
TNAGACTA	TGAGACTA
TNAGAGCA	TAGAGCAG
TTCATGGA	TACATGGA
TTTCCCCT	TTTACCCT
TTTCCCTA	TTTACCCT
TTTCCCTC	TTTACCCT
TTTCCCTG	TTTACCCT
TTTCCCTT	TTTACCCT
TTTCCCTN	TTTACCCT
TTAAGAAT	TTAAAATA
TTCANAAA	TTCAAAAG
TTCANAAG	TTCAAAAG
TTAAGATA	TTAAAATA
TTAAGATT	TAAAGATT
TTTCCTCC	ATTCCTCC
TTAAGGGG	TAAGGGGC
TTAAGTAA	TTAGTAAC
TTAATAAC	TTAGTAAC
TTAATAAT	TTAAAATA
TTAATATA	TTAAAATA
TNAGGGGC	TAAGGGGC
TTTGCCCT	TTTACCCT
TTTCTACG	GTTCTACG
TNCGAGCT	TACGAGCT
TTAATGAC	TAAATGAC
TNAGTAAC	TTAGTAAC
TTAANAAT	TTAAAATA
TTAANATA	TTAAAATA
TNCGCTGG	TCGCTGGC
TTTGGAAC	TCTGGAAC
TTACAAAA	TTCAAAAG
TTACAAAT	TTAAAATA
TTACAATA	TTAAAATA
TNCGGACT	TCGGACTT
TTTGGCTA	CTTTGGCT
TTTGGCTC	CTTTGGCT
TTTGGCTG	CTTTGGCT
TTTGGCTT	CTTTGGCT
TTTGGCTN	CTTTGGCT
TTTGGGCA	TTGTGGGC
TTTGGGCC	TTGTGGGC
TTTGGGCG	TTGTGGGC
TTTGGGCT	TTGTGGGC
TTTGGGCN	TTGTGGGC
TNCGGGAC	TCGGGACC
TTACAGGA	ATTACAGG
TTACAGGC	ATTACAGG
TTACAGGG	ATTACAGG
TTACAGGT	ATTACAGG
TTACAGGN	ATTACAGG
TTTGTAAC	TTAGTAAC
TTACATGG	TACATGGA
TNAAAAAT	TAAAAATC
TNATAACC	TGATAACC
TNAAAATA	TTAAAATA
TNAAAATC	TAAAAATC
TTTGTGGG	TTGTGGGC
TTGGGACC	TCGGGACC
TTTGAAAG	TCTGAAAG
TNAAAGAT	TAAAGATT
TTGGGGCA	TTGTGGGC
TTGGGGCC	TTGTGGGC
TTGGGGCG	TTGTGGGC
TTTGACCC	TTTACCCT
TTGGGGCT	TTGTGGGC
TTGGGGCN	TTGTGGGC
TTGGGGGC	TTGTGGGC
TTGGTAAC	TTAGTAAC
TTGGTGAG	TGGTGAGG
TTGGTGGG	TTGTGGGC
TTTTACCC	TTTACCCT
TNAAATGA	TAAATGAC
NAGAGCAG	TAGAGCAG
NAGAGCGC	AGAGCGCG
NAGAGCTT	CAGAGCTT
TTTTCCCT	TTTACCCT
TTGTAACA	TTAGTAAC
TTGTAACC	TTAGTAAC
TTGTAACG	TTAGTAAC
TTGTAACT	TTAGTAAC
TTGTAACN	TTAGTAAC
TNTAAAAT	TTAAAATA
TTGTACCC	TTTACCCT
TTGTAGGC	TTGTGGGC
TTGTAGGG	TTGTGGGC
TTTTGGCT	CTTTGGCT
TTTTGGGC	TTGTGGGC
TTGTCAGA	CTGTCAGA
TNTACCCT	TTTACCCT
TNGCTGGC	TCGCTGGC
NAGCACCC	AAGCACCC
TTGTCGGC	TTGTGGGC
TTGTCGGG	TTGTGGGC
TNCAAAAG	TTCAAAAG
TTGTGAGC	TTGTGGGC
TNTAGTAA	TTAGTAAC
NAGCCCGC	AGCCCGCG
TTGTGCCA	CTGTGCCA
NAGCCGTT	AGCCGTTC
TTGTGCGC	TTGTGGGC
TTGTGCGG	TTGTGGGC
TTGTGGAC	TTGTGGGC
TTGTGGAG	TTGTGGGC
TTGTGGCA	TTGTGGGC
TTGTGGCC	TTGTGGGC
TTGTGGCG	TTGTGGGC
TTGTGGCT	TTGTGGGC
TTGTGGCN	TTGTGGGC
TTGTGGGA	TTGTGGGC
TTGTGGGC	TTGTGGGC
TTGTGGGG	TTGTGGGC
TTGTGGGT	TTGTGGGC
TTGTGGGN	TTGTGGGC
TTGTGGTC	TTGTGGGC
TTGTGGTG	TTGTGGGC
TTGTGGNC	TTGTGGGC
TTGTGGNG	TTGTGGGC
TTGTGTGC	TTGTGGGC
TTGTGTGG	TTGTGGGC
TNGGACTT	TCGGACTT
TTGTGNGC	TTGTGGGC
TTGTGNGG	TTGTGGGC
NAGCGTAT	AGCGTATC
TNGGATCA	TGGATCAA
TTGTTGGC	TTGTGGGC
TTGTTGGG	TTGTGGGC
TNCATGGA	TACATGGA
TNTCAAAA	TTCAAAAG
TNGGGACC	TCGGGACC
TTGTNGGC	TTGTGGGC
TTGTNGGG	TTGTGGGC
NAAGGGGC	TAAGGGGC
TNGGTGAG	TGGTGAGG
TNAAGATT	TAAAGATT
TNAAGGGG	TAAGGGGC
TNCCATGC	TCCCATGC
TNCCCATG	TCCCATGC
TNAATGAC	TAAATGAC
NAATAAGA	AATAAGAA
TNTGAAAG	TCTGAAAG
TNACATGG	TACATGGA
TNACCCTT	TGACCCTT
NAATGTCG	AATGTCGT
NAATGTTG	AATGTTGT
TNTTACCC	TTTACCCT
NAATTATG	AATTATGT
TNTGGAAC	TCTGGAAC
TNACGAGC	TACGAGCT
NAATTTTA	AATTTTAC
NACGTTTA	AACGTTTA
NAAAAATC	TAAAAATC
TNTGTGGG	TTGTGGGC
NAGAAATG	AGAAATGC
NACTAAAC	ACTAAACG
NAGACTCT	AGACTCTC
NAAAGATT	TAAAGATT
NAAAGCTC	AAAGCTCG
TNGTGAGG	TGGTGAGG
NACTCAGT	AACTCAGT
TNGTGGGC	TTGTGGGC
NACTCATC	ACTCATCC
NACTCCCG	ACTCCCGA
NAAATGAC	TAAATGAC
NACTCTCG	CACTCTCG
NATATTGG	GATATTGG
NACTGAGG	ACTGAGGA
NACTGTTT	CACTGTTT
NCGCACGA	CGCACGAC
NAGGCCCG	CAGGCCCG
NACTTCCA	ACTTCCAT
NACACAAT	ACACAATG
NACATGGA	TACATGGA
NAGGGGGG	CAGGGGGG
NACAGCCG	ACAGCCGG
NATCGGTC	CATCGGTC
NCGCTGGC	TCGCTGGC
NCATATGC	CCATATGC
NCGGACTT	TCGGACTT
NACCCTCA	GACCCTCA
NAGTACTC	CAGTACTC
NCATCGGT	CATCGGTC
NCGGCCCA	CGGCCCAT
NAGTCAGT	AGTCAGTT
NCGGGACC	TCGGGACC
NACCTTGG	ACCTTGGT
NCGGGTGA	GCGGGTGA
NAACCTAA	CAACCTAA
NAACGCAT	GAACGCAT
NAACGTTT	AACGTTTA
NACGAAGG	ACGAAGGG
NACGAGCT	TACGAGCT
NATGTCGT	AATGTCGT
NAACTCAG	AACTCAGT
NATGTTGT	AATGTTGT
NCAAAGTC	CCAAAGTC
NCGAAGGG	ACGAAGGG
NATTACAG	ATTACAGG
NATTATGT	AATTATGT
NATTTTAC	AATTTTAC
NATTCCTC	ATTCCTCC
NAAGCACC	AAGCACCC
NCAACCTA	CAACCTAA
NCAACGGC	GCAACGGC
NAAGCTAG	GAAGCTAG
NAAGCTCG	AAAGCTCG
NCGACTTG	CCGACTTG
NAGTTGCC	AGTTGCCT
NCCTAACA	CCTAACAG
NCCTAGGA	CCTAGGAA
NCAATACT	GCAATACT
NCCAAAGT	CCAAAGTC
NCTCATCC	ACTCATCC
NCACAATG	ACACAATG
NCTCCCGA	ACTCCCGA
NCCATATG	CCATATGC
NGAAATGC	AGAAATGC
NCCCCGGC	CCCCGGCA
NGAACGCA	GAACGCAT
NCCTTGGT	ACCTTGGT
NCCTTTAC	GCCTTTAC
NGGCTAGT	GGCTAGTT
NCCCGGCA	CCCCGGCA
NCCCATGC	TCCCATGC
NATAAGAA	AATAAGAA
NATAATAT	GATAATAT
NCTGGAAC	TCTGGAAC
NCTGGCCA	CTGGCCAA
NCTGAAAG	TCTGAAAG
NCTGAGGA	ACTGAGGA
NCTGTCAG	CTGTCAGA
NGGGATAC	GGGATACA
NGGGATCC	GGGGATCC
NCCGACTT	CCGACTTG
NCTGTGCC	CTGTGCCA
NCACTCTC	CACTCTCG
NCGTAGAA	CGTAGAAA
NCACTGTT	CACTGTTT
NCGTCCGG	CGTCCGGG
NGGGGATC	GGGGATCC
NCAGAGCT	CAGAGCTT
NCTTCCAT	ACTTCCAT
NCAGCCGG	ACAGCCGG
NGGGTCGT	GGGTCGTA
NGGGTCTG	GGGTCTGC
NGGATACA	GGGATACA
NGGATCAA	TGGATCAA
NCTTTGGC	CTTTGGCT
NCTTTTTA	GCTTTTTA
NCAGGCCC	CAGGCCCG
NCAGGGGG	CAGGGGGG
NGAAGCTA	GAAGCTAG
NGGTATAA	GGTATAAC
NCAGTACT	CAGTACTC
NGCACGAC	CGCACGAC
NGGCATAG	GGCATAGA
NGGCCCAT	CGGCCCAT
NGCATAGA	GGCATAGA
NGGCGAGA	GGCGAGAC
NGCAACGG	GCAACGGC
NGCAATAC	GCAATACT
NGACCCTC	GACCCTCA
NGACCCTT	TGACCCTT
NTAAAAAT	TAAAAATC
NTAAAATA	TTAAAATA
NTAAAGAT	TAAAGATT
NGTCTTTG	GTCTTTGG
NTAAATGA	TAAATGAC
NGCCCGCG	AGCCCGCG
NGACTCTC	AGACTCTC
NCTAAACG	ACTAAACG
NCTAACAG	CCTAACAG
NGCTTTTT	GCTTTTTA
NGTGCGAT	GTGCGATC
NGCCGTTC	AGCCGTTC
NTAAGGGG	TAAGGGGC
NGTGGCTT	GTGGCTTC
NGTGGGAA	GGTGGGAA
NGCCTTTA	GCCTTTAC
NCTACTCG	CTACTCGT
NCTAGGAA	CCTAGGAA
NCTAGTAG	GCTAGTAG
NGGTCGTA	GGGTCGTA
NGTTCTAC	GTTCTACG
NGGTCTGC	GGGTCTGC
NGTTCTGA	GGTTCTGA
NGCGAGAC	GGCGAGAC
NGTTGCCT	AGTTGCCT
NGGTGAGG	TGGTGAGG
NGAGACTA	TGAGACTA
NGGTGGGA	GGTGGGAA
NTGGCCAA	CTGGCCAA
NTGGCTTC	GTGGCTTC
NGAGCGCG	AGAGCGCG
NTGATAAC	TGATAACC
NGGTTCTG	GGTTCTGA
NGCGGGTG	GCGGGTGA
NTGGTGAG	TGGTGAGG
NGCGTATC	AGCGTATC
NTCAAAAG	TTCAAAAG
NGATAACC	TGATAACC
NGATAATA	GATAATAT
NTGTCAGA	CTGTCAGA
NTGCGATC	GTGCGATC
NGCTAGTA	GCTAGTAG
NGCTAGTT	GGCTAGTT
NGATATTG	GATATTGG
NTGTGCCA	CTGTGCCA
NTGTGGGC	TTGTGGGC
NTCCACCT	GTCCACCT
NTACATGG	TACATGGA
NTCCCATG	TCCCATGC
NTACGAGC	TACGAGCT
NTACTCGT	CTACTCGT
NTGGATCA	TGGATCAA
NGTAGAAA	CGTAGAAA
NTTGTGGG	TTGTGGGC
NTAGAGCA	TAGAGCAG
NGTATAAC	GGTATAAC
NTCGCTGG	TCGCTGGC
NGTCAGTT	AGTCAGTT
NTTTACCC	TTTACCCT
NGTCCACC	GTCCACCT
NGTCCGGG	CGTCCGGG
NTAGTAAC	TTAGTAAC
NTCGGACT	TCGGACTT
NTCGGGAC	TCGGGACC
NTTTGGCT	CTTTGGCT
NTGACCCT	TGACCCTT
NTGAGACT	TGAGACTA
NTTAAAAT	TTAAAATA
NTCTGAAA	TCTGAAAG
NTTAGTAA	TTAGTAAC
NTTACAGG	ATTACAGG
NTCTGGAA	TCTGGAAC
NTTACCCT	TTTACCCT
NTCTTTGG	GTCTTTGG
NTTCAAAA	TTCAAAAG
NTTCCTCC	ATTCCTCC
NTTCTACG	GTTCTACG
