AACCGAAC	ACCCGAAC
AAAAAATG	AAAACATG
AACTAACA	AAACTAAC
AACTAACC	AAACTAAC
AACTAACG	AAACTAAC
AAACTAAA	AAACTAAC
AAAAACAT	AAAACATG
AACTAACT	AAACTAAC
AACTAACN	AAACTAAC
AAAAACCC	AAAATCCC
AACTAAGC	ACTAAGCG
AACCGCCA	ATCCGCCA
AAACTAAC	AAACTAAC
AAACTAAG	AAACTAAC
AAACTAAT	AAACTAAC
AAACTAAN	AAACTAAC
AAACTACA	AAACTAAC
AAACTACC	AAACTAAC
AAACTACG	AAACTAAC
AAACTACT	AAACTAAC
AAACTACN	AAACTAAC
AAACTAGA	AAACTAAC
AAACTAGC	AAACTAAC
AAATCATG	AAAACATG
AAACTATA	AAACTAAC
AACCGCTG	AACCCTGG
AAACTATC	AAACTAAC
AAACTANA	AAACTAAC
AAAAATCC	AAAATCCC
AAACTANC	AAACTAAC
AAACTCAA	AAACTAAC
AAATCCCA	AAAATCCC
AAAAATGA	AAAACATG
AAACTCAC	AAACTAAC
AAATCCCC	AAAATCCC
AAAAATGC	AAAACATG
AAATCCCG	AAAATCCC
AAAAATGG	AAAACATG
AAATCCCT	AAAATCCC
AAAAATGT	AAAACATG
AAATCCCN	AAAATCCC
AAAAATGN	AAAACATG
AAACTCCC	AAAATCCC
AAAAATTT	GAAAATTT
AACTAGCT	AATAGCTT
AAACTGAA	AAACTAAC
AAACTGAC	AAACTAAC
AACTAGTT	CACTAGTT
AAATCGTA	AAATGTAG
AAAACAAG	AAAACATG
AAAACAAT	AAAACATG
AAATCGTT	AAACGTTC
AAACTGTA	AAATGTAG
AAAACACG	AAAACATG
AAACTGTT	AAACGTTC
AACCGTGG	AACCCTGG
AACCGTTC	AAACGTTC
AAAACACT	AAAACATG
AAAACAGA	AAAACATG
AAACTTAA	AAACTAAC
AAAACAGC	AAAACATG
AAACTTAC	AAACTAAC
AAAACAGG	AAAACATG
AAAACAGT	AAAACATG
AAAACAGN	AAAACATG
AAAACATA	AAAACATG
AAACTTCA	AAACGTTC
AAAACATC	AAAACATG
AAACTTCC	AAACGTTC
AAAACATG	AAAACATG
AAAACATT	AAAACATG
AAACTTCG	AAACGTTC
AAAACATN	AAAACATG
AAACTTCT	AAACGTTC
AAACTTCN	AAACGTTC
AAGCCCTG	AACCCTGG
AAAACANG	AAAACATG
AAAACANT	AAAACATG
AAACTTTC	AAACGTTC
AAATCTAA	AAACTAAC
AAAACCAT	AAAACATG
AAATCTAG	AAATGTAG
AAAACCCA	AAAATCCC
AAAACCCC	AAAATCCC
AAAACCCG	AAAATCCC
AAAACCCT	AAAATCCC
AAAACCCN	AAAATCCC
AAACTNAA	AAACTAAC
AAACTNAC	AAACTAAC
AACAAAGG	AGCAAAGG
AAAACCTG	AAAACATG
AACAACAT	AAAACATG
AAAACGAT	AAAACATG
AACCTAAC	AAACTAAC
AAACNAAC	AAACTAAC
AAAACGTG	AAAACATG
AAAACGTT	AAACGTTC
AAAACTAA	AAACTAAC
AAAACTAT	AAAACATG
AAAACTCC	AAAATCCC
AAAACTGA	AAAACATG
AAAACTGC	AAAACATG
AAAACTGG	AAAACATG
AAAACTGT	AAAACATG
AAAACTGN	AAAACATG
AAAACTTG	AAAACATG
AACAATCC	AAAATCCC
AAAACNAT	AAAACATG
AACTCCTG	AACCCTGG
AAGCCTGG	AACCCTGG
AAAACNTG	AAAACATG
AAATGAAG	AAATGTAG
AAATGACC	AATGACCG
AACCTCTG	AACCCTGG
AAATGAGA	AAATGTAG
AAATGAGC	AAATGTAG
AAATGAGG	AAATGTAG
AAATGAGT	AAATGTAG
AAATGAGN	AAATGTAG
AAATGATA	AAATGTAG
AAAAGATG	AAAACATG
AAATGCAG	AAATGTAG
AAAAGCAT	AAAACATG
AAAAGCCC	AAAATCCC
AACTCTGG	AACCCTGG
AACCTGGA	AACCCTGG
AACCTGGC	AACCCTGG
AAAAGCTT	AATAGCTT
AACCTGGG	AACCCTGG
AACCTGGT	AACCCTGG
AACCTGGN	AACCCTGG
AAACNGTT	AAACGTTC
AAATGCTA	AAATGTAG
AACCTTCG	CACCTTCG
AAATGGAG	AAATGTAG
AAACNTAA	AAACTAAC
AACCTTGG	AACCCTGG
AAAAGTAG	AAATGTAG
AAAAGTCC	AAAATCCC
AAATGGTA	AAATGTAG
AACACATG	AAAACATG
AAAAGTTC	AAACGTTC
AACTGACC	AATGACCG
AAATGTAA	AAATGTAG
AAATGTAC	AAATGTAG
AAATGTAG	AAATGTAG
AAATGTAT	AAATGTAG
AAATGTAN	AAATGTAG
AAATGTCA	AAATGTAG
AAACNTTC	AAACGTTC
AAATGTCG	AAATGTAG
AAATGTGA	AAATGTAG
AAATGTGC	AAATGTAG
AAATGTGG	AAATGTAG
AAATGTGT	AAATGTAG
AAATGTGN	AAATGTAG
AAATGTTA	AAATGTAG
AAATGTTC	AAACGTTC
AAATGTTG	AAATGTAG
AAATGTNA	AAATGTAG
AAAATAAC	AAACTAAC
AAATGTNG	AAATGTAG
AAATGNAG	AAATGTAG
AAAATACC	AAAATCCC
AAATGNTA	AAATGTAG
AAAATATG	AAAACATG
AAATTAAC	AAACTAAC
AAAATCAC	AAAATCCC
AACACCTG	AACCCTGG
AAAATCAT	AAAACATG
AAAATCCA	AAAATCCC
AAATTACA	TAATTACA
AAAATCCC	AAAATCCC
AAAATCCG	AAAATCCC
AAAATCCT	AAAATCCC
AAAATCCN	AAAATCCC
AAAATCGC	AAAATCCC
AAATTAGA	AAATGTAG
AAATTAGC	AAATGTAG
AAATTAGG	AAATGTAG
AAATTAGT	AAATGTAG
AAAATCTC	AAAATCCC
AAATTAGN	AAATGTAG
AAAATCNC	AAAATCCC
AAAATGCC	AAAATCCC
AACACGTT	AAACGTTC
AAAATGTA	AAATGTAG
AAATTCCC	AAAATCCC
AACCNCTG	AACCCTGG
AAATTCGT	GAATTCGT
AAAATTCC	AAAATCCC
AAAGACAT	AAAACATG
AACTGTAG	AAATGTAG
AAAGACCG	AATGACCG
AAAATTGG	CAAATTGG
AACACTAA	AAACTAAC
AAAATTTA	GAAAATTT
AAAATTTC	GAAAATTT
AAAATTTG	GAAAATTT
AAAATTTT	GAAAATTT
AAATTGCG	AAGTTGCG
AAATTGGA	CAAATTGG
AAAATTTN	GAAAATTT
AAATTGGC	CAAATTGG
AAATTGGG	CAAATTGG
AAATTGGT	CAAATTGG
AAATTGGN	CAAATTGG
AAATTGTA	AAATGTAG
AACACTGG	AACCCTGG
AAAATNCC	AAAATCCC
AAATTTAG	AAATGTAG
AACCNTGG	AACCCTGG
AAGAACAT	AAAACATG
AAAGATCC	AAAATCCC
AAAGATCG	TAAGATCG
AAAANATG	AAAACATG
AAGCGTTC	AAACGTTC
AAAANCAT	AAAACATG
AAAANCCC	AAAATCCC
AACAGATC	CACAGATC
AACTTCTT	AGCTTCTT
AAAGCATG	AAAACATG
AAAANTCC	AAAATCCC
AACTTGCG	AAGTTGCG
AAGCTAAC	AAACTAAC
AACGACCG	AATGACCG
AACAGCTT	AATAGCTT
AACGACTT	ATCGACTT
AAGAATCC	AAAATCCC
AAATNGTA	AAATGTAG
AACAGGAC	ACAGGACT
AAACAAAC	AAACTAAC
AAATNTAG	AAATGTAG
AACGATAC	ACGATACG
AAACAACA	AAACTAAC
AAACAACC	AAACTAAC
AAACAACG	AAACTAAC
AAACAACT	AAACTAAC
AAACAACN	AAACTAAC
AAACACAT	AAAACATG
AAGCTGCG	AAGTTGCG
AAAGCGTT	AAACGTTC
AAAGCTAA	AAACTAAC
AAGCTTAA	AGGCTTAA
AAANACAT	AAAACATG
AAACAGTT	AAACGTTC
AAAGCTTA	AATAGCTT
AAAGCTTC	AATAGCTT
AAACATAA	AAACTAAC
AAAGCTTG	AATAGCTT
AAAGCTTT	AATAGCTT
AAAGCTTN	AATAGCTT
AAACATCC	AAAATCCC
AAGCTTCT	AGCTTCTT
AAGCTTGC	AAGTTGCG
AAACATGA	AAAACATG
AAACATGC	AAAACATG
AAACATGG	AAAACATG
AAACATGT	AAAACATG
AAACATGN	AAAACATG
AAACATTC	AAACGTTC
AACGCCCA	TACGCCCA
AAGACATG	AAAACATG
AAANATCC	AAAATCCC
AACGCCTG	AACCCTGG
AAGACCGA	AATGACCG
AAGACCGC	AATGACCG
AAGACCGG	AATGACCG
AAGACCGT	AATGACCG
AAGACCGN	AATGACCG
AAACCAAC	AAACTAAC
AAACCAGC	TAACCAGC
AAAGGACT	ACAGGACT
AAACCATG	AAAACATG
AACATCCC	AAAATCCC
AACGCTGG	AACCCTGG
AAANCATG	AAAACATG
AAACCCTG	AACCCTGG
AAAGGCCG	AGAGGCCG
AAGACGTT	AAACGTTC
AAACCGTT	AAACGTTC
AAACCTAA	AAACTAAC
AACGGAAA	ATCGGAAA
AAGACTAA	AAACTAAC
AAACCTGG	AACCCTGG
AAACCTTC	AAACGTTC
AAANCGTT	AAACGTTC
AACATGTA	AAATGTAG
AAANCTAA	AAACTAAC
AAAGGGTA	GAAGGGTA
AAAGGTAG	AAATGTAG
AACATTAT	GACATTAT
AAAGGTCC	CAAGGTCC
AAAGGTTC	AAACGTTC
AAACGAAC	AAACTAAC
AAACGATC	AAACGTTC
AAACGATT	AAACGTTC
AAAGTAAC	AAACTAAC
AAACGCTC	AAACGTTC
AAACGCTT	AAACGTTC
AACGGTAT	TACGGTAT
AAGGACCG	AATGACCG
AAAGTAGA	AAATGTAG
AAAGTAGC	AAATGTAG
AAAGTAGG	AAATGTAG
AAAGTAGT	AAATGTAG
AAAGTAGN	AAATGTAG
AAGGACTA	ACAGGACT
AAGGACTC	ACAGGACT
AAGGACTG	ACAGGACT
AAGGACTT	ACAGGACT
AAGGACTN	ACAGGACT
AAAGTCCC	AAAATCCC
AAANGTAG	AAATGTAG
AAACGGTC	AAACGTTC
AAACGGTT	AAACGTTC
AAGAGCTT	AATAGCTT
AACNCCTG	AACCCTGG
AAACGTAA	AAACTAAC
AAACGTAC	AAACGTTC
AAGAGGCC	AGAGGCCG
AAACGTAG	AAATGTAG
AAACGTAT	AAACGTTC
AAANGTTC	AAACGTTC
AAACGTCA	AAACGTTC
AAACGTCC	AAACGTTC
AAACGTCG	AAACGTTC
AAACGTCT	AAACGTTC
AAACGTCN	AAACGTTC
AAACGTGC	AAACGTTC
AAACGTGT	AAACGTTC
AAAGTGTA	AAATGTAG
AAACGTTA	AAACGTTC
AAACGTTC	AAACGTTC
AAACGTTG	AAACGTTC
AAACGTTT	AAACGTTC
AAACGTTN	AAACGTTC
AAACGTNC	AAACGTTC
AAACGTNT	AAACGTTC
AAAGTTCA	AAACGTTC
AAAGTTCC	AAACGTTC
AAAGTTCG	AAACGTTC
AAAGTTCT	AAACGTTC
AAAGTTCN	AAACGTTC
AAAGTTGC	AAGTTGCG
AAACGNTC	AAACGTTC
AACNCTGG	AACCCTGG
AAACGNTT	AAACGTTC
AAGATAAT	CAGATAAT
AAGATACG	ACGATACG
AACGTTCA	AAACGTTC
AACGTTCC	AAACGTTC
AACGTTCG	AAACGTTC
AACGTTCT	AAACGTTC
AACGTTCN	AAACGTTC
AAGATCCC	AAAATCCC
AACGTTGC	AAGTTGCG
AAGATCGA	TAAGATCG
AAANTAAC	AAACTAAC
AAGATCGC	TAAGATCG
AAGATCGG	TAAGATCG
AAGATCGT	TAAGATCG
AAGATCGN	TAAGATCG
AAGATGCG	AAGTTGCG
AAGGCCGA	AGAGGCCG
AAGGCCGC	AGAGGCCG
AAGGCCGG	AGAGGCCG
AAGGCCGT	AGAGGCCG
AAGGCCGN	AGAGGCCG
AAGATGTA	AAATGTAG
AAGATTGC	AAGTTGCG
AAANTCCC	AAAATCCC
AACCACTG	AACCCTGG
AACCAGAG	CACCAGAG
AACCAGCA	TAACCAGC
AACCAGCC	TAACCAGC
AACCAGCG	TAACCAGC
AACCAGCT	TAACCAGC
AACCAGCN	TAACCAGC
AAGGCTTA	AGGCTTAA
AACCATGG	AACCCTGG
AAANTGTA	AAATGTAG
AAGGGCTA	ATGGGCTA
AACCCAGG	AACCCTGG
AACCCATG	AACCCTGG
AAGGGTAA	GAAGGGTA
AAGGGTAC	GAAGGGTA
AAGGGTAG	GAAGGGTA
AAGGGTAT	GAAGGGTA
AAGGGTAN	GAAGGGTA
AACCCCGG	AACCCTGG
AACCCCTG	AACCCTGG
AATCAACC	ATTCAACC
AAGCAAAG	AGCAAAGG
AACCCGAA	ACCCGAAC
AAGTAGCG	AAGTTGCG
AAGTAGCT	AATAGCTT
AATCACCG	AATGACCG
AACCCGGA	AACCCTGG
AACCCGGC	AACCCTGG
AACCCGGG	AACCCTGG
AACCCGGT	AACCCTGG
AACCCGGN	AACCCTGG
AAGTATGC	AAGTTGCG
AATCAGCT	AATAGCTT
AACCCGTC	GACCCGTC
AACCCGTG	AACCCTGG
AAATAACA	AAACTAAC
AAATAACC	AAACTAAC
AAATAACG	AAACTAAC
AAATAACT	AAACTAAC
AAATAACN	AAACTAAC
AACCCTAG	AACCCTGG
AAGGTCCA	CAAGGTCC
AAGGTCCC	CAAGGTCC
AAGGTCCG	CAAGGTCC
AACCCTCG	AACCCTGG
AAGGTCCT	CAAGGTCC
AAGGTCCN	CAAGGTCC
AACCCTGA	AACCCTGG
AACCCTGC	AACCCTGG
AACCCTGG	AACCCTGG
AAATACAT	AAAACATG
AACCCTGT	AACCCTGG
AACCCTGN	AACCCTGG
AACCCTTG	AACCCTGG
AAGGTGCG	AAGTTGCG
AACCCTNG	AACCCTGG
AAGGTGGT	AGGTGGTT
AACCCNGG	AACCCTGG
AAGGTTGC	AAGTTGCG
AACCCNTG	AACCCTGG
AAATAGCT	AATAGCTT
AAATAGTA	AAATGTAG
AATNGACC	AATGACCG
AATGTACC	AATGACCG
AATGTAGA	AAATGTAG
AATGTAGC	AAATGTAG
AATGTAGG	AAATGTAG
AATGTAGT	AAATGTAG
AATGTAGN	AAATGTAG
AAATATAG	AAATGTAG
AAATATCC	AAAATCCC
AATCCCTG	AACCCTGG
AATCCGCC	ATCCGCCA
AATNGCTT	AATAGCTT
AATGTCCG	AATGACCG
AAGTCGCG	AAGTTGCG
AAGTCGCT	ATGTCGCT
AATGTCGC	ATGTCGCT
AAGTCGGT	GAGTCGGT
AATCCTGA	ATTCCTGA
AATCCTGG	AACCCTGG
AAGTCTCA	AGTCTCAG
AAGTCTGC	AAGTTGCG
AATGTTGC	AAGTTGCG
AAGTGACC	AATGACCG
AATCGACC	AATGACCG
AAGTGCGA	AAGTTGCG
AAGTGCGC	AAGTTGCG
AATCGACT	ATCGACTT
AAGTGCGG	AAGTTGCG
AAGTGCGT	AAGTTGCG
AAGTGCGN	AAGTTGCG
AATGNACC	AATGACCG
AAGTGGCG	AAGTTGCG
AANCCCTG	AACCCTGG
AAGTGGTT	AGGTGGTT
AAGTGTAG	AAATGTAG
AATGNCCG	AATGACCG
AATCGCTT	AATAGCTT
AAGTGTGC	AAGTTGCG
AATCGGAA	ATCGGAAA
AATCGTTC	AAACGTTC
AAGNTGCG	AAGTTGCG
AANCCTGG	AACCCTGG
AAGTTACG	AAGTTGCG
AATCTAAC	AAACTAAC
AAGTTAGC	AAGTTGCG
AAGNTTGC	AAGTTGCG
AATCTCAG	AGTCTCAG
AATTACAA	TAATTACA
AATTACAC	TAATTACA
AATTACAG	TAATTACA
AATTACAT	TAATTACA
AATTACAN	TAATTACA
AATTACCG	AATGACCG
AATTAGCT	AATAGCTT
AAGTTCCG	AAGTTGCG
AANGTTGC	AAGTTGCG
AAGTTCGA	AAGTTGCG
AAGTTCGC	AAGTTGCG
AAGTTCGG	AAGTTGCG
AAGTTCGT	AAGTTGCG
AAGTTCGN	AAGTTGCG
AAGTTGAC	AAGTTGCG
AAGTTGAG	AAGTTGCG
AAGTTGCA	AAGTTGCG
AAGTTGCC	AAGTTGCG
AAGTTGCG	AAGTTGCG
AATTATAT	ATTATATC
AAGTTGCT	AAGTTGCG
AAGTTGCN	AAGTTGCG
AAGTTGGA	AAGTTGCG
AAGTTGGC	AAGTTGCG
AAGTTGGG	AAGTTGCG
AAGTTGGT	AAGTTGCG
AAGTTGGN	AAGTTGCG
AAGTTGTC	AAGTTGCG
AAGTTGTG	AAGTTGCG
AAGTTGNC	AAGTTGCG
AAGTTGNG	AAGTTGCG
AATTCAAC	ATTCAACC
AAGTTTCG	AAGTTGCG
AAGTTTGC	AAGTTGCG
AAGTTNCG	AAGTTGCG
AAGTTNGC	AAGTTGCG
AANAACAT	AAAACATG
AATTCCTG	ATTCCTGA
AATTCGTA	GAATTCGT
AATTCGTC	GAATTCGT
AATTCGTG	GAATTCGT
AATTCGTT	GAATTCGT
AATTCGTN	GAATTCGT
AANCGTTC	AAACGTTC
AAGTNGCG	AAGTTGCG
AATGAACC	AATGACCG
AATGAACG	AATGACCG
AANAATCC	AAAATCCC
AANCTAAC	AAACTAAC
AAGTNTGC	AAGTTGCG
AATGACAC	AATGACCG
AATGACAG	AATGACCG
AATGACCA	AATGACCG
AATGACCC	AATGACCG
AATGACCG	AATGACCG
AATGACCT	AATGACCG
AATGACCN	AATGACCG
AATGACGA	AATGACCG
AATGACGC	AATGACCG
AATGACGG	AATGACCG
AATGACGT	AATGACCG
AATGACGN	AATGACCG
AATGACTC	AATGACCG
AATGACTG	AATGACCG
AATGACNC	AATGACCG
AATGACNG	AATGACCG
AATGAGCC	AATGACCG
AATGAGCG	AATGACCG
AATGAGCT	AATAGCTT
AATTGACC	AATGACCG
AATGATCC	AATGACCG
AATGATCG	AATGACCG
AANTAGCT	AATAGCTT
AATGANCC	AATGACCG
AATGANCG	AATGACCG
AATGCACC	AATGACCG
AATTGCGA	AAGTTGCG
AATTGCGC	AAGTTGCG
AATTGCGG	AAGTTGCG
AATAACAT	AAAACATG
AATTGCGT	AAGTTGCG
AATTGCGN	AAGTTGCG
AATTGCTT	AATAGCTT
AANACATG	AAAACATG
AATTGGCG	TATTGGCG
AATGCCCG	AATGACCG
AATGCCGA	AATGACCG
AATGCCGC	AATGACCG
AATGCCGG	AATGACCG
AATGCCGT	AATGACCG
AATGCCGN	AATGACCG
AATAACCG	AATGACCG
AATAACTT	AATAGCTT
AATTGTAG	AAATGTAG
AATAAGCG	ACTAAGCG
AATAAGCT	AATAGCTT
AATAAGGG	TATAAGGG
AANACGTT	AAACGTTC
AATGCTTA	AATAGCTT
AATGCTTC	AATAGCTT
AATGCTTG	AATAGCTT
AATAATCC	AAAATCCC
AATGCTTT	AATAGCTT
AATGCTTN	AATAGCTT
AANACTAA	AAACTAAC
AATGGACC	AATGACCG
ACAAACAT	AAAACATG
AATTTCCC	GATTTCCC
AATACATG	AAAACATG
AATGGCCG	AATGACCG
AATACCGA	AATGACCG
AATACCGC	AATGACCG
AATACCGG	AATGACCG
AATACCGT	AATGACCG
AATACCGN	AATGACCG
AATACCTT	AATAGCTT
AATTTGCG	AAGTTGCG
AANTGACC	AATGACCG
ACAAAGAG	CCAAAGAG
AATGGCTT	AATAGCTT
AATACGCT	AATAGCTT
ACAAAGCG	ACTAAGCG
ACAAAGGA	AGCAAAGG
ACAAAGGC	AGCAAAGG
ACAAAGGG	AGCAAAGG
ACAAAGGT	AGCAAAGG
ACAAAGGN	AGCAAAGG
AATACGTT	AAACGTTC
AANAGCTT	AATAGCTT
AATACTAA	AAACTAAC
ACAAATCC	AAAATCCC
AATACTTA	AATAGCTT
AATACTTC	AATAGCTT
AATACTTG	AATAGCTT
ACAAATTG	CAAATTGG
AATGGGCT	ATGGGCTA
AANGACCG	AATGACCG
AATACTTT	AATAGCTT
AATACTTN	AATAGCTT
ACAACAAC	TCAACAAC
AANTGTAG	AAATGTAG
ACAACATG	AAAACATG
AATAGAAA	GATAGAAA
AATAGACC	AATGACCG
AATAGACT	AATAGCTT
AATAGATT	AATAGCTT
ACAACGTT	AAACGTTC
AANATCCC	AAAATCCC
ACAACTAA	AAACTAAC
ACAATACG	ACGATACG
AATAGCAT	AATAGCTT
AATAGCCT	AATAGCTT
AATAGCGT	AATAGCTT
AATAGCTA	AATAGCTT
AATAGCTC	AATAGCTT
AATAGCTG	AATAGCTT
AATAGCTT	AATAGCTT
AANTTGCG	AAGTTGCG
AATAGCTN	AATAGCTT
AATAGCNT	AATAGCTT
AANATGTA	AAATGTAG
AATAGGCT	AATAGCTT
AATAGGTT	AATAGCTT
ACAATCCC	AAAATCCC
AATAGTCT	AATAGCTT
AATAGTTA	AATAGCTT
AATAGTTC	AATAGCTT
AATAGTTG	AATAGCTT
AATAGTTT	AATAGCTT
AATAGTTN	AATAGCTT
ACAAGACT	ACAGGACT
ACAATGTA	AAATGTAG
AATAGNCT	AATAGCTT
ACAAGCGA	ACTAAGCG
ACAAGCGC	ACTAAGCG
ACAAGCGG	ACTAAGCG
ACAAGCGT	ACTAAGCG
ACAAGCGN	ACTAAGCG
AATAGNTT	AATAGCTT
ACAAGGAC	ACAGGACT
ACCGAACA	ACCCGAAC
ACAAGGTC	CAAGGTCC
ACCGAACC	ACCCGAAC
ACCGAACG	ACCCGAAC
ACCGAACT	ACCCGAAC
ACCGAACN	ACCCGAAC
AATATATC	ATTATATC
AATATCCC	AAAATCCC
AATATCTT	AATAGCTT
ACCGACGG	CCGACGGA
ACCGACTT	ATCGACTT
AATNACCG	AATGACCG
AATATGCT	AATAGCTT
AATATGTA	AAATGTAG
AATNAGCT	AATAGCTT
ACCGATAC	ACGATACG
ACGACACG	ACGATACG
ACGGAAAA	ATCGGAAA
ACGGAAAC	ATCGGAAA
ACGGAAAG	ATCGGAAA
ACGGAAAT	ATCGGAAA
ACGGAAAN	ATCGGAAA
ACGACGGA	CCGACGGA
ACCAGAAC	ACCCGAAC
ACCAGAGA	CACCAGAG
ACGACTAC	ACGATACG
ACCAGAGC	CACCAGAG
ACGGACTA	ACAGGACT
ACCAGAGG	CACCAGAG
ACGGACTC	ACAGGACT
ACGGACTG	ACAGGACT
ACCAGAGT	CACCAGAG
ACGGACTT	ACAGGACT
ACCAGAGN	CACCAGAG
ACGGACTN	ACAGGACT
ACCGCCAA	ATCCGCCA
AATANCTT	AATAGCTT
ACCGCCAC	ATCCGCCA
ACCGCCAG	ATCCGCCA
ACCGCCAT	ATCCGCCA
ACCGCCAN	ATCCGCCA
ACGACTTA	ATCGACTT
ACGACTTC	ATCGACTT
ACGACTTG	ATCGACTT
ACGACTTT	ATCGACTT
ACGACTTN	ATCGACTT
ACCGCCCT	CCGCCCTA
AATANGCT	AATAGCTT
ACCTTCGA	CACCTTCG
ACGGATAC	ACGATACG
ACCTTCGC	CACCTTCG
ACCTTCGG	CACCTTCG
ACCAGGAC	ACAGGACT
ACCTTCGT	CACCTTCG
ACCTTCGN	CACCTTCG
ACCTTCTT	AGCTTCTT
ACGAGACG	ACGATACG
ACCGCGAA	ACCCGAAC
ACGAGGAC	ACAGGACT
ACACAGAT	CACAGATC
ACGAGGCC	AGAGGCCG
ACGAGTAC	ACGATACG
ACACATAG	GCACATAG
ACGAGTCC	TCGAGTCC
ACGAGTTT	CGAGTTTA
ACAGCACT	ACAGGACT
ACCATACG	ACGATACG
ACGGCTTA	AGGCTTAA
ACGATAAC	ACGATACG
ACGATAAG	ACGATACG
ACGATACA	ACGATACG
ACGATACC	ACGATACG
ACCGGAAA	ATCGGAAA
ACGATACG	ACGATACG
ACCGGAAC	ACCCGAAC
ACGATACT	ACGATACG
ACGATACN	ACGATACG
ACACCAGA	CACCAGAG
ACGATAGA	ACGATACG
ACGATAGC	ACGATACG
ACAGCGAC	ACAGGACT
ACGATAGG	ACGATACG
ACGATAGT	ACGATACG
ACCGGACT	ACAGGACT
ACGATAGN	ACGATACG
ACGATATC	ACGATACG
ACGATATG	ACGATACG
ACGATANC	ACGATACG
ACGATANG	ACGATACG
ACGGGAAC	CGGGAACC
ACGATCAC	ACGATACG
ACGGGACT	ACAGGACT
ACGATCCG	ACGATACG
ACGATCGA	ACGATACG
ACGATCGC	ACGATACG
ACGATCGG	ACGATACG
ACGATCGT	ACGATACG
ACGATCGN	ACGATACG
ACACCCTG	AACCCTGG
ACCATTGT	CCATTGTC
ACGATGAC	ACGATACG
ACGGGCGT	CCGGGCGT
ACGGGCTA	ATGGGCTA
ACCGGGCG	CCGGGCGT
ACGATGCG	ACGATACG
ACACCGAA	ACCCGAAC
ACGATTAC	ACGATACG
ACAGGAAC	ACAGGACT
ACAGGAAT	ACAGGACT
ACAGGACA	ACAGGACT
ACGATTCG	ACGATACG
ACAGGACC	ACAGGACT
ACAGGACG	ACAGGACT
ACAGGACT	ACAGGACT
ACAGGACN	ACAGGACT
ACGGGTAG	CGGGTAGG
ACAGGAGC	ACAGGACT
ACAGGAGT	ACAGGACT
ACAGGATA	ACAGGACT
ACAGGATC	ACAGGACT
ACAGGATG	ACAGGACT
ACAGGATT	ACAGGACT
ACAGGATN	ACAGGACT
ACAGGANC	ACAGGACT
ACAGGANT	ACAGGACT
ACAGGCAC	ACAGGACT
ACGATNAC	ACGATACG
ACANGACT	ACAGGACT
ACAGGCCG	AGAGGCCG
ACAGGCCT	ACAGGACT
ACGATNCG	ACGATACG
ACAGGCTA	ACAGGACT
ACAGGCTC	ACAGGACT
ACAGGCTG	ACAGGACT
ACAGGCTT	ACAGGACT
ACAGGCTN	ACAGGACT
ACAGGGAC	ACAGGACT
ACAGGGCT	ACAGGACT
ACGANACG	ACGATACG
ACGGTACG	ACGATACG
ACACCTTC	CACCTTCG
ACGGTATA	TACGGTAT
ACGGTATC	TACGGTAT
ACGGTATG	TACGGTAT
ACGGTATT	TACGGTAT
ACAGGTAC	ACAGGACT
ACGGTATN	TACGGTAT
ACAGGTCT	ACAGGACT
ACANGGAC	ACAGGACT
ACAGGNAC	ACAGGACT
ACAGGNCT	ACAGGACT
ACACGAAC	ACCCGAAC
ACACGACT	ACAGGACT
ACAGTACT	ACAGGACT
ACAGTGAC	ACAGGACT
ACGGTGGT	AGGTGGTT
ACGANTAC	ACGATACG
ACACGGAC	ACAGGACT
ACAGTTGC	AAGTTGCG
ACACGTTC	AAACGTTC
ACCCAAAC	ACCCGAAC
ACCCAACA	ACCCGAAC
ACCCAACC	ACCCGAAC
ACCCAACG	ACCCGAAC
ACCCAACT	ACCCGAAC
ACCCAACN	ACCCGAAC
ACACTAAC	AAACTAAC
ACAGNACT	ACAGGACT
ACACTAGT	CACTAGTT
ACCCAATT	CCCAATTT
ACCGTTGA	CCGTTGAA
ACCCACCG	CCCACCGT
ACGCAAAG	AGCAAAGG
ACAGNGAC	ACAGGACT
ACCCAGAA	ACCCGAAC
ACGCATAC	ACGATACG
ACCNCGAA	ACCCGAAC
ACATAAGC	ACTAAGCG
ACATACGA	ACGATACG
ACATACGC	ACGATACG
ACATACGG	ACGATACG
ACATACGT	ACGATACG
ACATACGN	ACGATACG
ACGCCCAA	TACGCCCA
ACGCCCAC	TACGCCCA
ACGCCCAG	TACGCCCA
ACGCCCAT	TACGCCCA
ACGCCCAN	TACGCCCA
ACATAGCT	AATAGCTT
ACGCCCTA	CCGCCCTA
ACGCCGAA	ACCCGAAC
ACGCCGGG	GCGCCGGG
ACCCCAAC	ACCCGAAC
ACGTAAGC	ACTAAGCG
ACCNGAAC	ACCCGAAC
ACAGAACT	ACAGGACT
ACGTACGA	ACGATACG
ACGTACGC	ACGATACG
ACGTACGG	ACGATACG
ACGTACGT	ACGATACG
ACGTACGN	ACGATACG
ACCTAAGC	ACTAAGCG
ACCTAATA	GCCTAATA
ACGTATAC	ACGATACG
ACAGACTA	ACAGGACT
ACAGACTC	ACAGGACT
ACGCGAAC	ACCCGAAC
ACAGACTG	ACAGGACT
ACGCGAAG	GCGCGAAG
ACAGACTT	ACAGGACT
ACAGACTN	ACAGGACT
ACATCCAT	GCATCCAT
ACAGAGAC	ACAGGACT
ACCCCGAA	ACCCGAAC
ACCTAGCG	TCCTAGCG
ACCAAAGA	CCAAAGAG
ACAGATAA	CAGATAAT
ACAGATAC	ACGATACG
ACCAAAGG	AGCAAAGG
ACAGATCA	CACAGATC
ACAGATCC	CACAGATC
ACAGATCG	CACAGATC
ACAGATCT	CACAGATC
ACAGATCN	CACAGATC
ACCCCTGG	AACCCTGG
ACCAAGCG	ACTAAGCG
ACGTCGCT	ATGTCGCT
ACATGACC	AATGACCG
ACATGACT	ACAGGACT
ACGTCTCA	AGTCTCAG
ACGTCTGG	TCGTCTGG
ACCCGAAA	ACCCGAAC
ACCCGAAC	ACCCGAAC
ACCAATTT	CCCAATTT
ACCCGAAG	ACCCGAAC
ACCCGAAT	ACCCGAAC
ACCCGAAN	ACCCGAAC
ACCCGACA	ACCCGAAC
ACCCGACC	ACCCGAAC
ACCCGACG	ACCCGAAC
ACCCGACT	ACCCGAAC
ACCCGACN	ACCCGAAC
ACCCGAGA	ACCCGAAC
ACCCGAGC	ACCCGAAC
ACATGGAC	ACAGGACT
ACCCGATA	ACCCGAAC
ACCCGATC	ACCCGAAC
ACCCGANA	ACCCGAAC
ACCCGANC	ACCCGAAC
ACCCGCAA	ACCCGAAC
ACCCGCAC	ACCCGAAC
ACCCGCCA	ATCCGCCA
ACATGTAG	AAATGTAG
ACGCTACG	ACGATACG
ACGTGGTT	AGGTGGTT
ACCCGGAA	ACCCGAAC
ACCTCGAA	ACCCGAAC
ACCCGGAC	ACCCGAAC
ACCCGGCT	TCCCGGCT
ACGTGTTA	GCGTGTTA
ACCCGTAA	ACCCGAAC
ACCCGTAC	ACCCGAAC
ACCCGTCA	GACCCGTC
ACCCGTCC	GACCCGTC
ACCCGTCG	GACCCGTC
ACCCGTCT	GACCCGTC
ACCCGTCN	GACCCGTC
ACATTATA	GACATTAT
ACATTATC	GACATTAT
ACGTTACG	ACGATACG
ACATTATG	GACATTAT
ACCCGNAA	ACCCGAAC
ACGCTTAA	AGGCTTAA
ACATTATT	GACATTAT
ACCCGNAC	ACCCGAAC
ACATTATN	GACATTAT
ACGCTTCT	AGCTTCTT
ACCACCGT	CCCACCGT
ACCTCTCT	TCCTCTCT
ACCACGAA	ACCCGAAC
ACCCTAAC	ACCCGAAC
ACGTTGAA	CCGTTGAA
ACGTTGCG	AAGTTGCG
ACATTGTC	CCATTGTC
ACCTGAAC	ACCCGAAC
ACCCTGAA	ACCCGAAC
ACNTAAGC	ACTAAGCG
ACCCTGGA	AACCCTGG
ACCCTGGC	AACCCTGG
ACCCTGGG	AACCCTGG
ACCCTGGT	AACCCTGG
ACCCTGGN	AACCCTGG
ACGAAACG	ACGATACG
ACTAAACG	ACTAAGCG
ACTAAAGC	ACTAAGCG
ACTAACCG	ACTAAGCG
ACTAACGA	ACTAAGCG
ACTAACGC	ACTAAGCG
ACTAACGG	ACTAAGCG
ACTAACGT	ACTAAGCG
ACTAACGN	ACTAAGCG
ACGAACGA	ACGATACG
ACGAACGC	ACGATACG
ACTAAGAC	ACTAAGCG
ACCCNAAC	ACCCGAAC
ACGAACGG	ACGATACG
ACTAAGAG	ACTAAGCG
ACGAACGT	ACGATACG
ACGAACGN	ACGATACG
ACTAAGCA	ACTAAGCG
ACTAAGCC	ACTAAGCG
ACTAAGCG	ACTAAGCG
ACTAAGCT	ACTAAGCG
ACTAAGCN	ACTAAGCG
ACTAAGGA	ACTAAGCG
ACTAAGGC	ACTAAGCG
ACTAAGGG	ACTAAGCG
ACTAAGGT	ACTAAGCG
ACTAAGGN	ACTAAGCG
ACTAAGTC	ACTAAGCG
ACTAAGTG	ACTAAGCG
ACTAAGNC	ACTAAGCG
ACGAAGCG	ACTAAGCG
ACTAAGNG	ACTAAGCG
ACCTGGTA	CCTGGTAC
ACTAATCG	ACTAAGCG
ACTAATGC	ACTAAGCG
ACGAATAC	ACGATACG
ACTAANCG	ACTAAGCG
ACTAANGC	ACTAAGCG
ACTCTCAG	AGTCTCAG
ACCCNGAA	ACCCGAAC
ACTACAGC	ACTAAGCG
ACNCGAAC	ACCCGAAC
ACTCTCCA	CTCTCCAT
ACTACGCG	ACTAAGCG
AGAAAAGG	AGCAAAGG
AGAAAATT	GAAAATTT
ACGNATAC	ACGATACG
AGAAACAT	AAAACATG
AGAAAGGA	AGCAAAGG
AGAAAGGC	AGCAAAGG
AGAAAGGG	AGCAAAGG
AGAAAGGT	AGCAAAGG
AGAAAGGN	AGCAAAGG
ACTAGAGC	ACTAAGCG
AGAAATCC	AAAATCCC
ACTCTTTA	CTCTTTAA
ACTTCAAC	ATTCAACC
ACTAGCGA	ACTAAGCG
ACTAGCGC	ACTAAGCG
ACTAGCGG	ACTAAGCG
ACTAGCGT	ACTAAGCG
ACTAGCGN	ACTAAGCG
ACTAGCTC	GCTAGCTC
ACTAGCTT	AATAGCTT
ACTAGGAC	ACAGGACT
ACTAGGCG	ACTAAGCG
ACTTCCTG	ATTCCTGA
AGAACATG	AAAACATG
ACTAGTTA	CACTAGTT
ACTAGTTC	CACTAGTT
ACTAGTTG	CACTAGTT
ACTAGTTT	CACTAGTT
ACTAGTTN	CACTAGTT
ACNAAGCG	ACTAAGCG
AGAACGTT	AAACGTTC
AGAACTAA	AAACTAAC
ACTATACG	ACGATACG
ACTATAGC	ACTAAGCG
ACTTCTTA	AGCTTCTT
ACTATATC	ATTATATC
ACTTCTTC	AGCTTCTT
ACTTCTTG	AGCTTCTT
ACTTCTTT	AGCTTCTT
ACTTCTTN	AGCTTCTT
ACTGAAGC	ACTAAGCG
ACTATGCA	CTATGCAA
ACTATGCG	ACTAAGCG
AGAAGCCG	AGAGGCCG
ACTGACCG	AATGACCG
AGAAGGCC	AGAGGCCG
AGAAGGGT	GAAGGGTA
ACTGAGCG	ACTAAGCG
ACTGATAC	ACGATACG
ACGNTACG	ACGATACG
ACTANAGC	ACTAAGCG
ACTANGCG	ACTAAGCG
AGAATCCC	AAAATCCC
AGAATGTA	AAATGTAG
AGAATTCG	GAATTCGT
ACTCAACC	ATTCAACC
ACNAGGAC	ACAGGACT
ACTCAAGC	ACTAAGCG
ACTCAGCG	ACTAAGCG
ACTGGACT	ACAGGACT
ACNATACG	ACGATACG
ACTNAAGC	ACTAAGCG
ACTGGGCT	ATGGGCTA
ACTGGTAC	CCTGGTAC
ACTCCGAA	ACCCGAAC
ACTCCGCC	ATCCGCCA
ACTNAGCG	ACTAAGCG
AGACAAAG	AGCAAAGG
ACTCCTGA	ATTCCTGA
ACNGATAC	ACGATACG
ACTGTAGT	CTGTAGTC
ACTCGAAC	ACCCGAAC
AGACCCGT	GACCCGTC
ACTCGACT	ATCGACTT
AGACCCTG	AACCCTGG
ACTGTCGC	ATGTCGCT
AGACATTA	GACATTAT
ACTCGGAA	ATCGGAAA
AGACGCCG	AGAGGCCG
AGACGGCC	AGAGGCCG
AGGGGCCG	AGAGGCCG
AGGGGCTA	ATGGGCTA
AGGGGGTT	AGGTGGTT
AGACGTTC	AAACGTTC
AGGGGTTA	AGGTGGTT
AGGGGTTC	AGGTGGTT
AGGGGTTG	AGGTGGTT
AGGGGTTT	AGGTGGTT
AGGGGTTN	AGGTGGTT
AGACTAAC	AAACTAAC
ACTTAAGC	ACTAAGCG
ACTTAATG	CTTAATGA
AGACTCAG	AGTCTCAG
ACTTACCG	CTTACCGG
AGAGNCCG	AGAGGCCG
ACNGGACT	ACAGGACT
ACTTAGCG	ACTAAGCG
AGAGNGCC	AGAGGCCG
ACTTATAT	ATTATATC
AGGGTAGG	CGGGTAGG
AGACTTAA	AGGCTTAA
AGACTTCT	AGCTTCTT
ACNCCGAA	ACCCGAAC
AGANGCCG	AGAGGCCG
AGATAATA	CAGATAAT
AGANGGCC	AGAGGCCG
AGATAATC	CAGATAAT
AGATAATG	CAGATAAT
AGATAATT	CAGATAAT
AGATAATN	CAGATAAT
AGGGTGGT	AGGTGGTT
AGATACGA	ACGATACG
AGATACGC	ACGATACG
AGATACGG	ACGATACG
AGATACGT	ACGATACG
AGGGTTAA	AGGCTTAA
AGATACGN	ACGATACG
AGGCAAAG	AGCAAAGG
AGATAGAA	GATAGAAA
AGATAGCT	AATAGCTT
AGCCAAAG	AGCAAAGG
AGCCAAGG	AGCAAAGG
AGCGTCTT	AGCTTCTT
AGGCATAA	AGGCTTAA
AGCGTGGT	AGGTGGTT
AGGCATTA	AGGCTTAA
AGCGTGTT	GCGTGTTA
AGCGTTCT	AGCTTCTT
AGCCATGT	TGCCATGT
AGAGACCG	AGAGGCCG
AGAGAGCC	AGAGGCCG
AGATCTCA	AGTCTCAG
AGGCCTAA	AGGCTTAA
AGGCCTTA	AGGCTTAA
AGATGACC	AATGACCG
AGAGCCCG	AGAGGCCG
AGAGCCGA	AGAGGCCG
AGAGCCGC	AGAGGCCG
AGAGCCGG	AGAGGCCG
AGAGCCGT	AGAGGCCG
AGAGCCGN	AGAGGCCG
AGCCCGAA	ACCCGAAC
AGATGCCG	AGAGGCCG
AGAGCGCC	AGAGGCCG
AGATGGCC	AGAGGCCG
AGGTAGGT	AGGTGGTT
AGGTAGTT	AGGTGGTT
AGAGCTTA	AGGCTTAA
AGATGGTT	AGGTGGTT
AGATGTAG	AAATGTAG
AGCCCTGG	AACCCTGG
AGAGGACC	AGAGGCCG
AGAGGACG	AGAGGCCG
AGAGGACT	ACAGGACT
AGGCGGTT	AGGTGGTT
AGGCGTAA	AGGCTTAA
AGAGGCAC	AGAGGCCG
AGAGGCAG	AGAGGCCG
AGAGGCAT	TGAGGCAT
AGAGGCCA	AGAGGCCG
AGAGGCCC	AGAGGCCG
AGAGGCCG	AGAGGCCG
AGCAAAAG	AGCAAAGG
AGAGGCCT	AGAGGCCG
AGCCGAAC	ACCCGAAC
AGAGGCCN	AGAGGCCG
AGAGGCGA	AGAGGCCG
AGAGGCGC	AGAGGCCG
AGAGGCGG	AGAGGCCG
AGCAAACG	AGCAAAGG
AGAGGCGT	AGAGGCCG
AGAGGCGN	AGAGGCCG
AGCAAAGA	AGCAAAGG
AGAGGCTC	AGAGGCCG
AGCAAAGC	AGCAAAGG
AGAGGCTG	AGAGGCCG
AGCAAAGG	AGCAAAGG
AGGCGTTA	AGGCTTAA
AGCAAAGT	AGCAAAGG
AGCTAAAG	AGCAAAGG
AGCAAAGN	AGCAAAGG
AGCTAAAT	TGCTAAAT
AGAGGCNC	AGAGGCCG
AGAGGCNG	AGAGGCCG
AGCAAATG	AGCAAAGG
AGCAAANG	AGCAAAGG
AGCTAAGC	ACTAAGCG
AGCTAAGG	AGCAAAGG
AGAGGGCC	AGAGGCCG
AGAGGGCG	AGAGGCCG
AGCAACAG	AGCAAAGG
AGCAACGG	AGCAAAGG
AGCCGCCA	ATCCGCCA
AGATTCTT	AGCTTCTT
AGGTCGCT	ATGTCGCT
AGAGGTCC	AGAGGCCG
AGCAAGAG	AGCAAAGG
AGAGGTCG	AGAGGCCG
AGGTCGGT	AGGTGGTT
AGGCTAAA	AGGCTTAA
AGGCTAAC	AGGCTTAA
AGCAAGGA	AGCAAAGG
AGGCTAAG	AGGCTTAA
AGCAAGGC	AGCAAAGG
AGGTCGTT	AGGTGGTT
AGCAAGGG	AGCAAAGG
AGCAAGGT	AGCAAAGG
AGCAAGGN	AGCAAAGG
AGGCTAAT	AGGCTTAA
AGGCTAAN	AGGCTTAA
AGCTACTT	AGCTTCTT
AGGTCTCA	AGTCTCAG
AGAGGNCC	AGAGGCCG
AGCAATAG	AGCAAAGG
AGAGGNCG	AGAGGCCG
AGATTTCC	GATTTCCC
AGGTCTTA	AGGCTTAA
AGCTAGCT	GCTAGCTC
AGGCTATA	AGGCTTAA
AGCAATGG	AGCAAAGG
AGGCTCAA	AGGCTTAA
AGGCTCAG	AGTCTCAG
AGCAANAG	AGCAAAGG
AGCAANGG	AGCAAAGG
AGGCTCTA	AGGCTTAA
AGAGTCCG	AGAGGCCG
AGCACAAG	AGCAAAGG
AGGCTGAA	AGGCTTAA
AGAGTCGG	GAGTCGGT
AGGTGAGT	AGGTGGTT
AGCTATCT	AGCTTCTT
AGCACAGG	AGCAAAGG
AGCACATA	GCACATAG
AGCCTAAT	GCCTAATA
AGGCTGGT	AGGTGGTT
AGAGTGCC	AGAGGCCG
AGAGTGGT	AGGTGGTT
AGGTGATT	AGGTGGTT
AGGCTGTA	AGGCTTAA
AGCCTCAG	AGTCTCAG
AGAGTTGC	AAGTTGCG
AGCCTCTT	AGCTTCTT
AGAGTTTA	CGAGTTTA
AGGCTTAA	AGGCTTAA
AGGTGCGT	AGGTGGTT
AGGCTTAC	AGGCTTAA
AGGCTTAG	AGGCTTAA
AGGCTTAT	AGGCTTAA
AGGCTTAN	AGGCTTAA
AGGCTTCA	AGGCTTAA
AGGTGCTT	AGGTGGTT
AGGCTTCT	AGCTTCTT
AGGCTTGA	AGGCTTAA
AGGCTTTA	AGGCTTAA
AGGCTTNA	AGGCTTAA
AGGCTNAA	AGGCTTAA
AGCCTTAA	AGGCTTAA
AGCCTTCT	AGCTTCTT
AGCTCAGA	AGTCTCAG
AGCTCAGC	AGTCTCAG
AGGCTNTA	AGGCTTAA
AGCTCAGG	AGTCTCAG
AGCTCAGT	AGTCTCAG
AGCTCAGN	AGTCTCAG
AGGTGGAT	AGGTGGTT
AGGTGGCT	AGGTGGTT
AGGTGGGT	AGGTGGTT
AGCAGAAG	AGCAAAGG
AGGTGGTA	AGGTGGTT
AGGTGGTC	AGGTGGTT
AGGTGGTG	AGGTGGTT
AGGTGGTT	AGGTGGTT
AGGTGGTN	AGGTGGTT
AGGTGGNT	AGGTGGTT
AGCAGAGG	AGCAAAGG
AGCTCCTT	AGCTTCTT
AGCAGGAC	ACAGGACT
AGCAGGCC	AGAGGCCG
AGGTGTGT	AGGTGGTT
AGGTGTTA	AGGTGGTT
AGGTGTTC	AGGTGGTT
AGGTGTTG	AGGTGGTT
AGGTGTTT	AGGTGGTT
AGGTGTTN	AGGTGGTT
AGGTGNGT	AGGTGGTT
AGGTGNTT	AGGTGGTT
AGGTTAAA	AGGCTTAA
AGGTTAAC	AGGCTTAA
AGGTTAAG	AGGCTTAA
AGGTTAAT	AGGCTTAA
AGGTTAAN	AGGCTTAA
AGCATAAG	AGCAAAGG
AGCATAGG	AGCAAAGG
AGGCNTAA	AGGCTTAA
AGCTCTCA	AGTCTCAG
AGCTCTCT	AGCTTCTT
AGCTCTTA	AGCTTCTT
AGCTCTTC	AGCTTCTT
AGCATCCA	GCATCCAT
AGGCNTTA	AGGCTTAA
AGCGAAAG	AGCAAAGG
AGCTCTTG	AGCTTCTT
AGCTCTTT	AGCTTCTT
AGCATCTT	AGCTTCTT
AGCTCTTN	AGCTTCTT
AGGNCTTA	AGGCTTAA
AGCGAAGG	AGCAAAGG
AGCNTCTT	AGCTTCTT
AGGGAACC	CGGGAACC
AGCGACTT	ATCGACTT
AGGTTCTT	AGCTTCTT
AGGTTGCG	AAGTTGCG
AGCATTCT	AGCTTCTT
AGGTTGGT	AGGTGGTT
AGCNTTCT	AGCTTCTT
AGGTTGTT	AGGTGGTT
AGCGATAC	ACGATACG
AGGTTTAA	AGGCTTAA
AGGNGGTT	AGGTGGTT
AGCTGCTT	AGCTTCTT
AGCANAAG	AGCAAAGG
AGTATATC	ATTATATC
AGCANAGG	AGCAAAGG
AGCTGGTT	AGGTGGTT
AGTATCAG	AGTCTCAG
AGCTGTCT	AGCTTCTT
AGCGCCGG	GCGCCGGG
AGGTNGGT	AGGTGGTT
AGCGCGAA	GCGCGAAG
AGGTNGTT	AGGTGGTT
AGCTTAAA	AGGCTTAA
AGCTTAAC	AGGCTTAA
AGCTTAAG	AGGCTTAA
AGCTTAAT	AGGCTTAA
AGCTTAAN	AGGCTTAA
AGCTTACT	AGCTTCTT
AGCGCTTA	AGGCTTAA
AGGAAAGG	AGCAAAGG
AGGNTGGT	AGGTGGTT
AGGNTTAA	AGGCTTAA
ATAACATG	AAAACATG
AGCTTATT	AGCTTCTT
ATAACCAG	TAACCAGC
AGCTTCAT	AGCTTCTT
AGCTTCCT	AGCTTCTT
AGCGGAAA	ATCGGAAA
AGGGCCGA	AGAGGCCG
AGCTTCGT	AGCTTCTT
AGGGCCGC	AGAGGCCG
AGCTTCTA	AGCTTCTT
AGGGCCGG	AGAGGCCG
AGCTTCTC	AGCTTCTT
AGCTTCTG	AGCTTCTT
AGGGCCGT	AGAGGCCG
AGCTTCTT	AGCTTCTT
AGGGCCGN	AGAGGCCG
AGCTTCTN	AGCTTCTT
AGCTTCNT	AGCTTCTT
AGCTTGCT	AGCTTCTT
ATAACGTT	AAACGTTC
ATAACTAA	AAACTAAC
AGCGGCCG	AGAGGCCG
AGCTTGTT	AGCTTCTT
AGGGCTAA	ATGGGCTA
AGGGCTAC	ATGGGCTA
AGGGCTAG	ATGGGCTA
AGGGCTAT	ATGGGCTA
AGGGCTAN	ATGGGCTA
AGCTTTCT	AGCTTCTT
AGCTTTTA	AGCTTCTT
AGCTTTTC	AGCTTCTT
AGCTTTTG	AGCTTCTT
AGCTTTTT	AGCTTCTT
AGCTTTTN	AGCTTCTT
AGTGCTCA	AGTCTCAG
AGTGCTTA	AGGCTTAA
AGGGCTTA	AGGCTTAA
AGCTTNCT	AGCTTCTT
AGTCAAAG	AGCAAAGG
AGTCAAAT	GTCAAATG
AGTCAACC	ATTCAACC
AGCTTNTT	AGCTTCTT
AGGACTTA	AGGCTTAA
AGTCACAG	AGTCTCAG
ATAAGATC	TAAGATCG
AGTAAAGG	AGCAAAGG
AGTCAGGC	GTCAGGCT
AGCTNCTT	AGCTTCTT
AGGAGACT	TGGAGACT
ATAAGCGA	ACTAAGCG
ATAAGCGC	ACTAAGCG
AGTGGCAC	GTGGCACC
ATAAGCGG	ACTAAGCG
ATAAGCGT	ACTAAGCG
ATAAGCGN	ACTAAGCG
AGTCATCA	AGTCTCAG
AGTGGCCG	AGAGGCCG
AGNTTCTT	AGCTTCTT
ATAAGGGA	TATAAGGG
ATAAGGGC	TATAAGGG
ATAAGGGG	TATAAGGG
ATAAGGGT	TATAAGGG
ATAAGGGN	TATAAGGG
AGCTNTCT	AGCTTCTT
AGTAAGCG	ACTAAGCG
AGTGGGCT	ATGGGCTA
AGTGGGGT	TGTGGGGT
AGTCCAGA	AGTCTCAG
AGGAGGCC	AGAGGCCG
AGTCCAGC	AGTCTCAG
AGTCCAGG	AGTCTCAG
AGTCCAGT	AGTCTCAG
AGTCCAGN	AGTCTCAG
AGGAGGTT	AGGTGGTT
AGCNAAAG	AGCAAAGG
AGTCCCAG	AGTCTCAG
AGCNAAGG	AGCAAAGG
AGTGGTTA	AGGTGGTT
AGTGGTTC	AGGTGGTT
AGTGGTTG	AGGTGGTT
AGTGGTTT	AGGTGGTT
AGTGGTTN	AGGTGGTT
ATAATATC	ATTATATC
AGTCCGCC	ATCCGCCA
ATAATCCC	AAAATCCC
AGGATACG	ACGATACG
AGTCCTCA	AGTCTCAG
AGTACCGA	GTACCGAA
AGTCCTGA	ATTCCTGA
ATAATGTA	AAATGTAG
AGTGTCAG	AGTCTCAG
ATAATTAC	TAATTACA
AGGATGGT	AGGTGGTT
AGTGTCGA	TGTGTCGA
AGTGTCGC	ATGTCGCT
AGGATTAA	AGGCTTAA
AGTCGACT	ATCGACTT
AGTGTGGT	AGGTGGTT
AGTACTCA	AGTCTCAG
AGTCGCAG	AGTCTCAG
AGTCGCTA	ATGTCGCT
AGTCGCTC	ATGTCGCT
AGTCGCTG	ATGTCGCT
AGTCGCTT	ATGTCGCT
AGTCGCTN	ATGTCGCT
AGTCGGAA	ATCGGAAA
AGNAGGCC	AGAGGCCG
AGTNCTCA	AGTCTCAG
AGTCGGTA	GAGTCGGT
AGTCGGTC	GAGTCGGT
AGTCGGTG	GAGTCGGT
AGTCGGTT	GAGTCGGT
AGTCGGTN	GAGTCGGT
AGTCGTCA	AGTCTCAG
AGTAGCTT	AATAGCTT
AGTCTAAG	AGTCTCAG
AGTCTACA	AGTCTCAG
AGTCTAGA	AGTCTCAG
AGTCTAGC	AGTCTCAG
AGTCTAGG	AGTCTCAG
AGTCTAGT	AGTCTCAG
AGTCTAGN	AGTCTCAG
AGTCTCAA	AGTCTCAG
AGTCTCAC	AGTCTCAG
AGTCTCAG	AGTCTCAG
AGTCTCAT	AGTCTCAG
AGTCTCAN	AGTCTCAG
AGTCTCCA	AGTCTCAG
AGTCTCCG	AGTCTCAG
AGTCTCGA	AGTCTCAG
AGTCTCGC	AGTCTCAG
AGTAGGCC	AGAGGCCG
AGTCTCGG	AGTCTCAG
AGTCTCGT	AGTCTCAG
AGTCTCGN	AGTCTCAG
AGTCTCTA	AGTCTCAG
AGTCTCTG	AGTCTCAG
AGTCTCNA	AGTCTCAG
AGTCTCNG	AGTCTCAG
AGTCTGAG	AGTCTCAG
AGTCTGCA	AGTCTCAG
AGTCTTAA	AGGCTTAA
AGTCTTAG	AGTCTCAG
AGTCTTCA	AGTCTCAG
AGTCTTCT	AGCTTCTT
AGNGCTTA	AGGCTTAA
AGTCTNAG	AGTCTCAG
AGTCTNCA	AGTCTCAG
AGTTATAT	ATTATATC
AGNGGCCG	AGAGGCCG
AGTNTCAG	AGTCTCAG
ATACAACC	ATTCAACC
AGTCNCAG	AGTCTCAG
AGTTCAAC	ATTCAACC
AGTTCAGA	AGTCTCAG
AGTTCAGC	AGTCTCAG
AGTTCAGG	AGTCTCAG
AGTTCAGT	AGTCTCAG
AGTTCAGN	AGTCTCAG
AGTTCCTG	ATTCCTGA
ATAGAAAA	GATAGAAA
ATAGAAAC	GATAGAAA
ATAGAAAG	GATAGAAA
ATAGAAAT	GATAGAAA
ATAGAAAN	GATAGAAA
AGTTCTCA	AGTCTCAG
AGNGTGGT	AGGTGGTT
AGTTCTTA	AGCTTCTT
AGTTCTTC	AGCTTCTT
AGTTCTTG	AGCTTCTT
AGTTCTTT	AGCTTCTT
AGTTCTTN	AGCTTCTT
ATAGACTT	ATCGACTT
AGTCNTCA	AGTCTCAG
AGNCAAAG	AGCAAAGG
ATACCCTG	AACCCTGG
ATACCGAA	GTACCGAA
ATACCGCC	ATCCGCCA
AGTTGCGA	AAGTTGCG
AGTTGCGC	AAGTTGCG
AGTTGCGG	AAGTTGCG
AGTTGCGT	AAGTTGCG
AGTTGCGN	AAGTTGCG
AGTGACCG	AATGACCG
AGNAAAGG	AGCAAAGG
ATACCTGA	ATTCCTGA
AGTTGGTT	AGGTGGTT
ATAGCTTA	AATAGCTT
ATAGCTTC	AATAGCTT
ATAGCTTG	AATAGCTT
ATAGCTTT	AATAGCTT
ATAGCTTN	AATAGCTT
ATAGGAAA	ATCGGAAA
ATAGGACG	TTAGGACG
ATAGGACT	ACAGGACT
AGTTTAAA	GTTTAAAG
ATACGACT	ATCGACTT
ATAGGCCG	AGAGGCCG
ATAGGCTA	ATGGGCTA
AGTTTCAG	AGTCTCAG
ATACGCCA	ATCCGCCA
ATACGCCC	TACGCCCA
ATAGGGCT	ATGGGCTA
AGTTTCTT	AGCTTCTT
AGTTTGAC	GTTTGACT
ATACGGAA	ATCGGAAA
ATATGACC	AATGACCG
ATACGGTA	TACGGTAT
ATATGCAA	CTATGCAA
AGTTTTGC	TGTTTTGC
ATACGTTC	AAACGTTC
ATACTAAC	AAACTAAC
ATCAAAGG	AGCAAAGG
ATCAAATG	GTCAAATG
ATCAACAA	TCAACAAC
ATCAACCA	ATTCAACC
ATCAACCC	ATTCAACC
ATCAACCG	ATTCAACC
ATCAACCT	ATTCAACC
ATCAACCN	ATTCAACC
ATATGTAG	AAATGTAG
AGNTCTCA	AGTCTCAG
ATCAACTT	ATCGACTT
ATAGTCGC	ATGTCGCT
ATCCTAGC	TCCTAGCG
ATCCTCCA	ATCCGCCA
ATCCTCTC	TCCTCTCT
ATCCTGAA	ATTCCTGA
ATCCTGAC	ATTCCTGA
ATCCTGAG	ATTCCTGA
ATCCTGAT	ATTCCTGA
ATCCTGAN	ATTCCTGA
ATCCTGCC	ATCCGCCA
ATAGTTGC	AAGTTGCG
ATAAACAT	AAAACATG
ATAAATCC	AAAATCCC
ATGTACGC	ATGTCGCT
AGNTGGTT	AGGTGGTT
ATATTGGC	TATTGGCG
ATGTAGCT	ATGTCGCT
ATGTAGTC	CTGTAGTC
ATCACGCC	ATCCGCCA
ATCCNCCA	ATCCGCCA
ATGCGACT	ATCGACTT
ATGTATAT	ATTATATC
AGNCTCAG	AGTCTCAG
ATCCNGCC	ATCCGCCA
ATCACTTA	ATCGACTT
ATCACTTC	ATCGACTT
ATCACTTG	ATCGACTT
ATCACTTT	ATCGACTT
ATGCGCCA	ATCCGCCA
ATCACTTN	ATCGACTT
ATGCGCTC	ATGTCGCT
ATGCGCTG	ATGTCGCT
ATGCGCTT	ATGTCGCT
ATGCGCTN	ATGTCGCT
ATGCGGAA	ATCGGAAA
ATGCGGCT	ATGGGCTA
AGNCTTAA	AGGCTTAA
ATCAGAAA	ATCGGAAA
AGNCTTCT	AGCTTCTT
ATCAGACT	ATCGACTT
ATGCGTTC	TTGCGTTC
ATCGAAAA	ATCGGAAA
ATATAAGG	TATAAGGG
ATCGAAAC	ATCGGAAA
ATCGAAAG	ATCGGAAA
ATCGAAAT	ATCGGAAA
ATCGAAAN	ATCGGAAA
ATGTCAAC	ATTCAACC
ATCGAACT	ATCGACTT
ATGCTAAA	TGCTAAAT
ATCAGCCA	ATCCGCCA
ATCGAATT	ATCGACTT
ATGTCACT	ATGTCGCT
ATGTCAGC	ATGTCGCT
ATCGACAT	ATCGACTT
ATCGACCT	ATCGACTT
ATCGACGT	ATCGACTT
ATCGACTA	ATCGACTT
ATATAGCT	AATAGCTT
ATCGACTC	ATCGACTT
ATGTCCCT	ATGTCGCT
ATCGACTG	ATCGACTT
ATCGACTT	ATCGACTT
ATCGACTN	ATCGACTT
ATGTCCGA	TTGTCCGA
ATGCTCGC	ATGTCGCT
ATGTCCGC	ATGTCGCT
ATCGACNT	ATCGACTT
ATCGAGAA	ATCGGAAA
ATGTCCTA	ATGTCGCT
ATGTCCTC	ATGTCGCT
ATGTCCTT	ATGTCGCT
ATGTCCTN	ATGTCGCT
ATCGAGCT	ATCGACTT
ATGTCGAC	ATGTCGCT
ATCAGGAA	ATCGGAAA
ATCAGGAC	ACAGGACT
ATGTCGAT	ATGTCGCT
ATGTCGCA	ATGTCGCT
ATCGAGTC	TCGAGTCC
ATGTCGCC	ATGTCGCT
ATGTCGCG	ATGTCGCT
ATCGAGTT	ATCGACTT
ATGTCGCT	ATGTCGCT
ATGTCGCN	ATGTCGCT
ATGTCGGC	ATGTCGCT
ATCAGGCT	GTCAGGCT
ATGTCGGT	ATGTCGCT
ATCGATAC	ACGATACG
ATGTCGTA	ATGTCGCT
ATGTCGTC	ATGTCGCT
ATGTCGTG	ATGTCGCT
ATGTCGTT	ATGTCGCT
ATGTCGTN	ATGTCGCT
ATGTCGNC	ATGTCGCT
ATGCTTAA	AGGCTTAA
ATGTCGNT	ATGTCGCT
ATATATAT	ATTATATC
ATCGATCT	ATCGACTT
ATATATCA	ATTATATC
ATATATCC	ATTATATC
ATGTCTCA	AGTCTCAG
ATGCTTCT	AGCTTCTT
ATATATCG	ATTATATC
ATATATCT	ATTATATC
ATATATCN	ATTATATC
ATGTCTCT	ATGTCGCT
ATCGATTA	ATCGACTT
ATCGATTC	ATCGACTT
ATGTCTGC	ATGTCGCT
ATCGATTG	ATCGACTT
ATCGATTT	ATCGACTT
ATCGATTN	ATCGACTT
ATCGANCT	ATCGACTT
ATGTCNCT	ATGTCGCT
ATGTCNGC	ATGTCGCT
ATCGANTT	ATCGACTT
ATCGCAAA	ATCGGAAA
ATCGCACT	ATCGACTT
ATCGCCAA	ATCCGCCA
ATCGCCAC	ATCCGCCA
ATATCAAC	ATTCAACC
ATCGCCAG	ATCCGCCA
ATGTGCGC	ATGTCGCT
ATCGCCAT	ATCCGCCA
ATCGCCAN	ATCCGCCA
ATGTGCTC	ATGTCGCT
ATGTGCTG	ATGTCGCT
ATGTGCTT	ATGTCGCT
ATGTGCTN	ATGTCGCT
ATATCACT	TTATCACT
ATCATATC	ATTATATC
ATCGCCTT	ATCGACTT
ATCTCAAC	ATTCAACC
ATGTGGGG	TGTGGGGT
ATCGCGAA	ATCGGAAA
ATCTCAGA	AGTCTCAG
ATCTCAGC	AGTCTCAG
ATCTCAGG	AGTCTCAG
ATCTCAGT	AGTCTCAG
ATCTCAGN	AGTCTCAG
ATGTGGTT	AGGTGGTT
ATCGCGCC	ATCCGCCA
ATCTCCAT	CTCTCCAT
ATGTGTCG	TGTGTCGA
ATCTCCTG	ATTCCTGA
ATCTCGCC	ATCCGCCA
ATCTCGCT	ATGTCGCT
ATCGCTTA	ATCGACTT
ATCGCTTC	ATCGACTT
ATCGCTTG	ATCGACTT
ATCGCTTT	ATCGACTT
ATCGCTTN	ATCGACTT
ATATCCTG	ATTCCTGA
ATATCGCT	ATGTCGCT
ATCGGAAA	ATCGGAAA
ATCGGAAC	ATCGGAAA
ATCGGAAG	ATCGGAAA
ATCGGAAT	ATCGGAAA
ATCGGAAN	ATCGGAAA
ATCGGACA	ATCGGAAA
ATCGGACT	ATCGACTT
ATGGAAAA	ATCGGAAA
ATCGGAGA	ATCGGAAA
ATGGAAAC	ATCGGAAA
ATGGAAAG	ATCGGAAA
ATGGAAAT	ATCGGAAA
ATGGAAAN	ATCGGAAA
ATGTTCGC	ATGTCGCT
ATCGGATA	ATCGGAAA
ATCGGANA	ATCGGAAA
ATCGGCAA	ATCGGAAA
ATCGGCCA	ATCCGCCA
ATGTTGCG	AAGTTGCG
ATGTTGCT	ATGTCGCT
ATCGGCTA	ATGGGCTA
ATCGGCTT	ATCGACTT
ATCTGAAA	ATCGGAAA
ATCGGGAA	ATCGGAAA
ATCGGGCT	ATGGGCTA
ATCTGACT	ATCGACTT
ATGTTTTG	TGTTTTGC
ATCGGTAA	ATCGGAAA
ATGGACTA	ATGGGCTA
ATGGACTT	ATCGACTT
ATGGAGAC	TGGAGACT
ATCTGCCA	ATCCGCCA
ATGGAGCT	ATGGGCTA
ATCTGGAA	ATCGGAAA
ATCGGNAA	ATCGGAAA
ATCGTAAA	ATCGGAAA
ATCGTACT	ATCGACTT
ATGNTCGC	ATGTCGCT
ATGACAGC	TTGACAGC
ATCTTCTT	AGCTTCTT
ATGGCACC	GTGGCACC
ATCCAAAA	TTCCAAAA
ATCCAACC	ATTCAACC
ATCTTTAA	CTCTTTAA
ATGACCGA	AATGACCG
ATGACCGC	AATGACCG
ATGACCGG	AATGACCG
ATGACCGT	AATGACCG
ATGACCGN	AATGACCG
ATCGTCGC	ATGTCGCT
ATCGTCTG	TCGTCTGG
ATCGTCTT	ATCGACTT
ATGTNCGC	ATGTCGCT
ATGGCCTA	ATGGGCTA
ATGACGCT	ATGTCGCT
ATCCACCA	ATCCGCCA
ATCGTGAA	ATCGGAAA
ATCCACTT	ATCGACTT
ATCCAGCC	ATCCGCCA
ATGTNGCT	ATGTCGCT
ATGGCTAA	ATGGGCTA
ATGGCTAC	ATGGGCTA
ATGGCTAG	ATGGGCTA
ATGGCTAT	ATGGGCTA
ATGGCTAN	ATGGGCTA
ATGACTTA	ATCGACTT
ATGACTTC	ATCGACTT
ATGACTTG	ATCGACTT
ATGACTTT	ATCGACTT
ATGACTTN	ATCGACTT
ATGGCTTA	AGGCTTAA
ATGGGAAA	ATCGGAAA
ATGGGACT	ATGGGCTA
ATCNACTT	ATCGACTT
ATGGGATA	ATGGGCTA
ATGGGCAA	ATGGGCTA
ATGGGCAC	ATGGGCTA
ATGGGCAG	ATGGGCTA
ATGGGCAT	ATGGGCTA
ATGGGCAN	ATGGGCTA
ATGGGCCA	ATGGGCTA
ATGGGCCT	ATGGGCTA
ATGGGCGA	ATGGGCTA
ATGGGCGT	ATGGGCTA
ATCGNAAA	ATCGGAAA
ATCGNACT	ATCGACTT
ATGAGCTA	ATGGGCTA
ATGGGCTA	ATGGGCTA
ATGGGCTC	ATGGGCTA
ATGAGGCA	TGAGGCAT
ATGGGCTG	ATGGGCTA
ATGAGGCC	AGAGGCCG
ATGGGCTT	ATGGGCTA
ATGGGCTN	ATGGGCTA
ATGAGGCT	ATGGGCTA
ATGGGCNA	ATGGGCTA
ATGGGCNT	ATGGGCTA
ATGGGGCT	ATGGGCTA
ATCNCGCC	ATCCGCCA
ATGGGGTA	ATGGGCTA
ATCGNCTT	ATCGACTT
ATCGNGAA	ATCGGAAA
ATCCCCAA	ATCCGCCA
ATCCCCAC	ATCCGCCA
ATCCCCAG	ATCCGCCA
ATCCCCAT	ATCCGCCA
ATCCCCAN	ATCCGCCA
ATCCCCCA	ATCCGCCA
ATGGGTAA	ATGGGCTA
ATGGGTAC	ATGGGCTA
ATGGGTAG	ATGGGCTA
ATCCCGAA	ACCCGAAC
ATGGGTAT	ATGGGCTA
ATCCCGCC	ATCCGCCA
ATGGGTAN	ATGGGCTA
ATCCCGGC	TCCCGGCT
ATGGGTCT	ATGGGCTA
ATGGGTTA	ATGGGCTA
ATTAAACC	ATTCAACC
ATGGGNCT	ATGGGCTA
ATTAAATC	ATTATATC
ATCCCTGA	ATTCCTGA
ATCCCTGG	AACCCTGG
ATCNGAAA	ATCGGAAA
ATGGGNTA	ATGGGCTA
ATGATACG	ACGATACG
ATCNGACT	ATCGACTT
ATTAACCA	ATTCAACC
ATTAACCC	ATTCAACC
ATTAACCG	ATTCAACC
ATTAACCT	ATTCAACC
ATTAACCN	ATTCAACC
ATGATATC	ATTATATC
ATCTAAGC	ACTAAGCG
ATGGTCGC	ATGTCGCT
ATTAAGCG	ACTAAGCG
ATGGTCTA	ATGGGCTA
ATCCGAAA	ATCGGAAA
ATCCGAAC	ACCCGAAC
ATCCGACA	ATCCGCCA
ATCCGACC	ATCCGCCA
ATGATCGC	ATGTCGCT
ATCCGACT	ATCGACTT
ATCNGCCA	ATCCGCCA
ATGGTGCT	ATGGGCTA
ATCCGCAA	ATCCGCCA
ATTAATAT	ATTATATC
ATCCGCAC	ATCCGCCA
ATCCGCAG	ATCCGCCA
ATTAATCA	ATTATATC
ATGGTGGT	AGGTGGTT
ATTAATCC	ATTATATC
ATCCGCAT	ATCCGCCA
ATTAATCG	ATTATATC
ATGNCGCT	ATGTCGCT
ATCCGCAN	ATCCGCCA
ATTAATCT	ATTATATC
ATCCGCCA	ATCCGCCA
ATTAATCN	ATTATATC
ATCCGCCC	ATCCGCCA
ATCTACTT	ATCGACTT
ATCCGCCG	ATCCGCCA
ATCCGCCT	ATCCGCCA
ATCCGCCN	ATCCGCCA
ATCCGCGA	ATCCGCCA
ATCCGCGC	ATCCGCCA
ATTAATGA	CTTAATGA
ATCCGCTA	ATCCGCCA
ATCCGCTC	ATCCGCCA
ATCCGCNA	ATCCGCCA
ATCCGCNC	ATCCGCCA
ATCCGGAA	ATCGGAAA
ATCCGGCA	ATCCGCCA
ATCCGGCC	ATCCGCCA
ATCNGGAA	ATCGGAAA
ATCTATAT	ATTATATC
ATCCGTCA	ATCCGCCA
ATCCGTCC	ATCCGCCA
ATCCGNCA	ATCCGCCA
ATCCGNCC	ATCCGCCA
ATTACAAC	ATTCAACC
ATTACATC	ATTATATC
ATTACCGG	CTTACCGG
ATTACCTG	ATTCCTGA
ATGNGCTA	ATGGGCTA
ATTACTAT	ATTATATC
ATGNGGCT	ATGGGCTA
ATTACTGA	ATTCCTGA
ATTCCAAA	TTCCAAAA
ATTCCAAC	ATTCAACC
ATTCCACC	ATTCAACC
ATTCCAGA	ATTCCTGA
ATTCCATG	ATTCCTGA
ATTCCCGA	ATTCCTGA
ATTCCCTG	ATTCCTGA
ATTAGATC	ATTATATC
ATTCCGAA	ATTCCTGA
ATGGNCTA	ATGGGCTA
ATTCCGAC	ATTCCTGA
ATTCCGAG	ATTCCTGA
ATTCCGAT	ATTCCTGA
ATTCCGAN	ATTCCTGA
ATTCCGCC	ATCCGCCA
ATTAGCTT	AATAGCTT
ATTCCGGA	ATTCCTGA
ATGGNGCT	ATGGGCTA
ATTNTATC	ATTATATC
ATTAGGAC	TTAGGACG
ATTCCGTG	ATTCCTGA
ATTCCTAA	ATTCCTGA
ATTCCTAC	ATTCCTGA
ATTCCTAG	ATTCCTGA
ATTCCTAT	ATTCCTGA
ATTCCTAN	ATTCCTGA
ATTCCTCA	ATTCCTGA
ATTCCTCG	ATTCCTGA
ATTCCTGA	ATTCCTGA
ATTCCTGC	ATTCCTGA
ATTCCTGG	ATTCCTGA
ATTCCTGT	ATTCCTGA
ATTAGTAT	ATTATATC
ATTCCTGN	ATTCCTGA
ATTCCTTA	ATTCCTGA
ATTCCTTG	ATTCCTGA
ATTCCTNA	ATTCCTGA
ATTCCTNG	ATTCCTGA
ATTCCNGA	ATTCCTGA
ATTCCNTG	ATTCCTGA
ATTCGAAC	ATTCAACC
ATNCAACC	ATTCAACC
ATTCGACC	ATTCAACC
ATTCGACT	ATCGACTT
ATTATAAC	ATTATATC
ATTATAAT	ATTATATC
ATTATACA	ATTATATC
ATTATACC	ATTATATC
ATTATACG	ATTATATC
ATTATACT	ATTATATC
ATTATACN	ATTATATC
ATTATAGC	ATTATATC
ATTATAGT	ATTATATC
ATTATATA	ATTATATC
ATTATATC	ATTATATC
ATTATATG	ATTATATC
ATTATATT	ATTATATC
ATTATATN	ATTATATC
ATTCGCCA	ATCCGCCA
ATTATANC	ATTATATC
ATTATANT	ATTATATC
ATTATCAC	TTATCACT
ATTATCAT	ATTATATC
ATTCGCTA	ATGTCGCT
ATTCGCTC	ATGTCGCT
ATTCGCTT	ATGTCGCT
ATTCGCTN	ATGTCGCT
ATTATCTC	ATTATATC
ATTCGGAA	ATCGGAAA
ATTATGAT	ATTATATC
ATTTAAAG	GTTTAAAG
ATTATGTC	ATTATATC
ATTATTAT	ATTATATC
ATTATTCA	ATTATATC
ATTATTCC	ATTATATC
ATTCGTGA	ATTCCTGA
ATTATTCG	ATTATATC
ATTATTCT	ATTATATC
ATTATTCN	ATTATATC
ATTATTTC	ATTATATC
ATTTAACC	ATTCAACC
ATTATNAT	ATTATATC
ATTATNTC	ATTATATC
ATGCAAAG	AGCAAAGG
ATGCAACC	ATTCAACC
ATTTATAT	ATTATATC
ATTTATCA	ATTATATC
ATTTATCC	ATTATATC
ATTTATCG	ATTATATC
ATTTATCT	ATTATATC
ATTTATCN	ATTATATC
ATTCTAAC	ATTCAACC
ATTCTACC	ATTCAACC
ATTCTATC	ATTATATC
ATTANATC	ATTATATC
ATTCTCAG	AGTCTCAG
ATTCTCTG	ATTCCTGA
ATTCTGAA	ATTCCTGA
ATTCTGAC	ATTCCTGA
ATTCTGAG	ATTCCTGA
ATTCTGAT	ATTCCTGA
ATTCTGAN	ATTCCTGA
ATTTCAAC	ATTCAACC
ATTCTTGA	ATTCCTGA
ATTTCCCA	GATTTCCC
ATTTCCCC	GATTTCCC
ATTTCCCG	GATTTCCC
ATTTCCCT	GATTTCCC
ATTTCCCN	GATTTCCC
ATTTCCTG	ATTCCTGA
ATTANTAT	ATTATATC
ATTCNAAC	ATTCAACC
ATGCCATG	TGCCATGT
ATTCNACC	ATTCAACC
ATTTCGCT	ATGTCGCT
ATGCCGCC	ATCCGCCA
ATGCCGCT	ATGTCGCT
ATTCAAAC	ATTCAACC
ATTCNCTG	ATTCCTGA
ATNCCGCC	ATCCGCCA
ATTCAACA	ATTCAACC
ATTCAACC	ATTCAACC
ATTCAACG	ATTCAACC
ATTCAACT	ATTCAACC
ATTCAACN	ATTCAACC
ATTCAAGC	ATTCAACC
ATTCAATC	ATTCAACC
ATTCAANC	ATTCAACC
ATGCCTGA	ATTCCTGA
ANACCCTG	AACCCTGG
ATTCACAC	ATTCAACC
ATTTCTGA	ATTCCTGA
ATNCCTGA	ATTCCTGA
ATTCACCA	ATTCAACC
ATTCACCC	ATTCAACC
ATTCACCG	ATTCAACC
ATTCACCT	ATTCAACC
ATTCACCN	ATTCAACC
ATTCACTG	ATTCCTGA
ATTCNTGA	ATTCCTGA
ATTCAGAC	ATTCAACC
ATTCAGCC	ATTCAACC
ATTCATAC	ATTCAACC
ATTCATAT	ATTATATC
ATTCATCC	ATTCAACC
ATNCGACT	ATCGACTT
ATTCATGA	ATTCCTGA
ATTTGACT	GTTTGACT
ATNGTCGC	ATGTCGCT
ATTGAACC	ATTCAACC
ATTCANAC	ATTCAACC
ATNCGCCA	ATCCGCCA
ATTCANCC	ATTCAACC
ATTGACAG	TTGACAGC
ATNCGGAA	ATCGGAAA
ATTGACCG	AATGACCG
ANAGGACT	ACAGGACT
ATTGACTT	ATCGACTT
ANAGGCCG	AGAGGCCG
ATTTGTGG	TTTGTGGA
ANACGTTC	AAACGTTC
ATTGATAT	ATTATATC
ANAAACAT	AAAACATG
ANACTAAC	AAACTAAC
ANAAATCC	AAAATCCC
ATTTTATC	ATTATATC
ATTGCAAC	ATTCAACC
ANAGTTGC	AAGTTGCG
ANAACATG	AAAACATG
ANAACGTT	AAACGTTC
ATNTATAT	ATTATATC
ATTGCCTG	ATTCCTGA
ATTGCGTT	TTGCGTTC
ANAACTAA	AAACTAAC
ATNATATC	ATTATATC
ATNTCAAC	ATTCAACC
ATTGCTGA	ATTCCTGA
ATNTCCTG	ATTCCTGA
ATNTCGCT	ATGTCGCT
ATTGGAAA	ATCGGAAA
ANATAGCT	AATAGCTT
ATTGGCGA	TATTGGCG
ATTGGCGC	TATTGGCG
ATTGGCGG	TATTGGCG
ATTGGCGT	TATTGGCG
ATTGGCGN	TATTGGCG
ATTGGCTA	ATGGGCTA
ANAATCCC	AAAATCCC
ATTNAACC	ATTCAACC
ATNGACTT	ATCGACTT
ATTGGGCT	ATGGGCTA
ANAATGTA	AAATGTAG
ATTNATAT	ATTATATC
ANCGGAAA	ATCGGAAA
ATTGTATC	ATTATATC
ATTGTCCG	TTGTCCGA
ATTGTCGC	ATGTCGCT
ATTNCAAC	ATTCAACC
ANATGACC	AATGACCG
ATTGTGGA	TTTGTGGA
ATNGGAAA	ATCGGAAA
ATTNCCTG	ATTCCTGA
ANATGTAG	AAATGTAG
ATNGGCTA	ATGGGCTA
ATNGGGCT	ATGGGCTA
ANGGCTTA	AGGCTTAA
ATTNCTGA	ATTCCTGA
ANGTTGCG	AAGTTGCG
ANGGGCTA	ATGGGCTA
ANCTAAGC	ACTAAGCG
ANGAGGCC	AGAGGCCG
ANGGTGGT	AGGTGGTT
ANGATACG	ACGATACG
ANCTTCTT	AGCTTCTT
ANTAGCTT	AATAGCTT
ANCAAAGG	AGCAAAGG
ANGCAAAG	AGCAAAGG
ANCCCGAA	ACCCGAAC
ANGTCGCT	ATGTCGCT
ANCCCTGG	AACCCTGG
ANGTCTCA	AGTCTCAG
ANTATATC	ATTATATC
ANCCGAAC	ACCCGAAC
ANCCGCCA	ATCCGCCA
ANTAAGCG	ACTAAGCG
ANGTGGTT	AGGTGGTT
ANCAGGAC	ACAGGACT
CAACGGTC	CAAGGTCC
CAACGTCC	CAAGGTCC
CAACGTTC	AAACGTTC
CAACTAAC	AAACTAAC
CAACTAGT	CACTAGTT
CAAAACAT	AAAACATG
CAAAAGAG	CCAAAGAG
CAAAATCC	AAAATCCC
CAAAATGG	CAAATTGG
CAACTTCG	CACCTTCG
CAACTTGG	CAAATTGG
CAAAATTG	CAAATTGG
CAAAATTT	GAAAATTT
ANTCAACC	ATTCAACC
ANGCTTAA	AGGCTTAA
ANTGACCG	AATGACCG
ANGCTTCT	AGCTTCTT
CAAACATG	AAAACATG
CAAACGTT	AAACGTTC
CAAACTAA	AAACTAAC
ANCGACTT	ATCGACTT
CAAACTGG	CAAATTGG
CAAACTTG	CAAATTGG
ANCGATAC	ACGATACG
CAAGAGTC	CAAGGTCC
CAAGATAA	CAGATAAT
CAAGATCA	CACAGATC
CAAGATCT	CACAGATC
CAAGATCN	CACAGATC
CAAGATTG	CAAATTGG
CAAAGAGA	CCAAAGAG
CAAAGAGC	CCAAAGAG
CAAAGAGG	CCAAAGAG
CAAAGAGT	CCAAAGAG
CAAAGAGN	CCAAAGAG
CAAAGATC	CACAGATC
ANTGGGCT	ATGGGCTA
ANTCCGCC	ATCCGCCA
CAAAGGTC	CAAGGTCC
ANTCCTGA	ATTCCTGA
CAAAGTCC	CAAGGTCC
CAAAGTGG	CAAATTGG
ANTGTCGC	ATGTCGCT
ANTCGACT	ATCGACTT
CAAAGTTG	CAAATTGG
CAAATAAT	CAGATAAT
ANTCGGAA	ATCGGAAA
CAAATAGG	CAAATTGG
CAAGCGTC	CAAGGTCC
CAAGCTCC	CAAGGTCC
CAAATATG	CAAATTGG
CAAATCCC	AAAATCCC
CAAATCGG	CAAATTGG
CAAATCTG	CAAATTGG
CAAATGGA	CAAATTGG
CAAATGGC	CAAATTGG
CAAATGGG	CAAATTGG
ANTCTCAG	AGTCTCAG
CAAGGACC	CAAGGTCC
CAAATGGT	CAAATTGG
CAAATGGN	CAAATTGG
CAAATGTA	AAATGTAG
CAAATGTG	CAAATTGG
CAAGGATC	CAAGGTCC
CAAATTAG	CAAATTGG
CAAATTCG	CAAATTGG
CAAATTGA	CAAATTGG
CAAATTGC	CAAATTGG
CAAATTGG	CAAATTGG
CAAATTGT	CAAATTGG
CAAATTGN	CAAATTGG
CAAGGCCA	CAAGGTCC
CAAGGCCC	CAAGGTCC
CAAATTTG	CAAATTGG
CAAGGCCG	CAAGGTCC
CAAGGCCT	CAAGGTCC
CAAGGCCN	CAAGGTCC
CAAATTNG	CAAATTGG
CAAGGCTC	CAAGGTCC
CAAATNGG	CAAATTGG
CAAATNTG	CAAATTGG
CAAGGGCC	CAAGGTCC
CAAGGGTA	GAAGGGTA
CAAGGGTC	CAAGGTCC
CAAGGTAC	CAAGGTCC
CAAGGTCA	CAAGGTCC
CAAGGTCC	CAAGGTCC
CAAGGTCG	CAAGGTCC
CAAGGTCT	CAAGGTCC
CAAGGTCN	CAAGGTCC
CAAGGTGC	CAAGGTCC
CAAGGTTC	CAAGGTCC
CAAGGTNC	CAAGGTCC
CAAGGNCC	CAAGGTCC
CAAANTGG	CAAATTGG
CAAGGNTC	CAAGGTCC
CAAANTTG	CAAATTGG
CAAGTCCA	CAAGGTCC
CAATAATA	CAGATAAT
CAAGTCCC	CAAGGTCC
CAATAATC	CAGATAAT
CAAGTCCG	CAAGGTCC
CAATAATG	CAGATAAT
CAAGTCCT	CAAGGTCC
CAATAATT	CAGATAAT
CAAGTCCN	CAAGGTCC
CAATAATN	CAGATAAT
CAACAACA	TCAACAAC
CAACAACC	TCAACAAC
CAACAACG	TCAACAAC
CAACAACT	TCAACAAC
CAACAACN	TCAACAAC
ANTTATAT	ATTATATC
CAAGTGTC	CAAGGTCC
CAATAGCT	AATAGCTT
CAAGTTCC	CAAGGTCC
CAAGTTGC	AAGTTGCG
CAATAGTT	CACTAGTT
CAAGTTGG	CAAATTGG
CAAGTTTA	CGAGTTTA
CAACAGAG	CACCAGAG
CAATATTG	CAAATTGG
CAACAGAT	CACAGATC
ANTTCAAC	ATTCAACC
ANTTCCTG	ATTCCTGA
CAACATTG	CAAATTGG
CAAGNGTC	CAAGGTCC
CAAGNTCC	CAAGGTCC
CACTAAGC	ACTAAGCG
CACTAAGT	CACTAGTT
CACTAATT	CACTAGTT
CACTACGT	CACTAGTT
CACTACTT	CACTAGTT
CACTAGAG	CACCAGAG
CAACCAGA	CACCAGAG
CACTAGCT	CACTAGTT
CAACCAGC	TAACCAGC
CACTAGGT	CACTAGTT
CACTAGTA	CACTAGTT
CACTAGTC	CACTAGTT
CACTAGTG	CACTAGTT
CACTAGTT	CACTAGTT
CACTAGTN	CACTAGTT
CACTAGNT	CACTAGTT
CACTATGT	CACTAGTT
CAACCCTG	AACCCTGG
CACTATTA	CACTAGTT
CACTATTC	CACTAGTT
CACTATTG	CACTAGTT
CACTATTT	CACTAGTT
CACTATTN	CACTAGTT
CACTANGT	CACTAGTT
CACTANTT	CACTAGTT
CACTCAGA	CACCAGAG
CACTCAGT	CACTAGTT
CAANTTGG	CAAATTGG
CAACCTTC	CACCTTCG
CAATGACC	AATGACCG
CACTCCAT	CTCTCCAT
CAATGCAA	CTATGCAA
CAGGTAAT	CAGATAAT
CAGGTAGG	CGGGTAGG
CACTCGTT	CACTAGTT
CAGGTCCA	CAAGGTCC
CAGGTCCC	CAAGGTCC
CAGGTCCG	CAAGGTCC
CAGGTCCT	CAAGGTCC
CAGGTCCN	CAAGGTCC
CACTCTTC	CACCTTCG
CAATGGTC	CAAGGTCC
CAGGTGGT	AGGTGGTT
CAATGTAG	AAATGTAG
CAATGTCC	CAAGGTCC
CAGCAAAG	AGCAAAGG
CACTGAGT	CACTAGTT
CACTGATC	CACAGATC
CAGCAGAG	CACCAGAG
CAATTACA	TAATTACA
CAGCAGAT	CACAGATC
CACTGGTA	CCTGGTAC
CACTGGTT	CACTAGTT
CAGCATAA	CAGATAAT
CACTGTTA	CACTAGTT
CACTGTTC	CACTAGTT
CACTGTTG	CACTAGTT
CACTGTTT	CACTAGTT
CACTGTTN	CACTAGTT
CAATTCGT	GAATTCGT
CAATTGGA	CAAATTGG
CAATTGGC	CAAATTGG
CAATTGGG	CAAATTGG
CAATTGGT	CAAATTGG
CAATTGGN	CAAATTGG
CAATTGTC	CCATTGTC
CAGCCAGA	CACCAGAG
CAGNTAAT	CAGATAAT
CACTTAGT	CACTAGTT
CACAAAGA	CCAAAGAG
CACAAATC	CACAGATC
CAATTTGG	CAAATTGG
CACTTCGA	CACCTTCG
CACTTCGC	CACCTTCG
CACTTCGG	CACCTTCG
CAGCCCTA	CCGCCCTA
CACTTCGT	CACCTTCG
CACTTCGN	CACCTTCG
CACAAGAG	CACCAGAG
CACTTGTT	CACTAGTT
CACAAGAT	CACAGATC
CACNGATC	CACAGATC
CACTTTAA	CTCTTTAA
CAGCCTTC	CACCTTCG
CACTTTCG	CACCTTCG
CACAAGTT	CACTAGTT
CAGTAATA	CAGATAAT
CAGTAATC	CAGATAAT
CAGTAATG	CAGATAAT
CAGTAATT	CAGATAAT
CAGTAATN	CAGATAAT
CACAATCA	CACAGATC
CACAATCC	CACAGATC
CACAATCG	CACAGATC
CACAATCT	CACAGATC
CACAATCN	CACAGATC
CACAATTG	CAAATTGG
CACAATTT	CCCAATTT
CACCCAGA	CACCAGAG
CACTNAGT	CACTAGTT
CAGTAGTC	CTGTAGTC
CAGTAGTT	CACTAGTT
CAGTATAA	CAGATAAT
CACCCGAA	ACCCGAAC
CACCCGAG	CACCAGAG
CACCCGTC	GACCCGTC
CACACAGA	CACCAGAG
CACACATC	CACAGATC
CACCCTCG	CACCTTCG
CACCCTGG	AACCCTGG
CACCCTTC	CACCTTCG
CACTNGTT	CACTAGTT
CACNTAGT	CACTAGTT
CACACCGT	CCCACCGT
CACACGAT	CACAGATC
CACCGAGA	CACCAGAG
CAGCTAAT	CAGATAAT
CACCGAGC	CACCAGAG
CACCGAGG	CACCAGAG
CACCGAGT	CACCAGAG
CACCGAGN	CACCAGAG
CACCGATC	CACAGATC
CAGCTAGT	CACTAGTT
CACCGGAG	CACCAGAG
CACACTTC	CACCTTCG
CAGTCGGT	GAGTCGGT
CACCGTCG	CACCTTCG
CACNAGAG	CACCAGAG
CAGTCTCA	AGTCTCAG
CACCGTTC	CACCTTCG
CAGCTTCG	CACCTTCG
CACNAGAT	CACAGATC
CAGCTTCT	AGCTTCTT
CACAGAAC	CACAGATC
CACAGAAT	CACAGATC
CACAGACA	CACAGATC
CACAGACC	CACAGATC
CACAGACG	CACAGATC
CACAGACT	CACAGATC
CACAGACN	CACAGATC
CACAGAGA	CACCAGAG
CACAGAGG	CACCAGAG
CACAGAGN	CACCAGAG
CACAGATA	CACAGATC
CACAGATC	CACAGATC
CACAGATG	CACAGATC
CACAGATT	CACAGATC
CACAGATN	CACAGATC
CACAGANC	CACAGATC
CACAGANT	CACAGATC
CACCTACG	CACCTTCG
CACAGCAT	CACAGATC
CACCTAGA	CACCAGAG
CACCTAGT	CACTAGTT
CACCTATC	CACCTTCG
CACNTTCG	CACCTTCG
CACNAGTT	CACTAGTT
CACCTCCG	CACCTTCG
CACAGCTC	CACAGATC
CACCTCGA	CACCTTCG
CACCTCGC	CACCTTCG
CACCTCGG	CACCTTCG
CACCTCGT	CACCTTCG
CACCTCGN	CACCTTCG
CACCTCTC	CACCTTCG
CACAGGAC	ACAGGACT
CACAGGAT	CACAGATC
CACCTGAG	CACCAGAG
CACCTGCG	CACCTTCG
CACCTGTC	CACCTTCG
CACCTTAC	CACCTTCG
CACCTTAG	CACCTTCG
CACCTTCA	CACCTTCG
CACCTTCC	CACCTTCG
CACCTTCG	CACCTTCG
CACCTTCT	CACCTTCG
CACCTTCN	CACCTTCG
CACCTTGA	CACCTTCG
CACCTTGC	CACCTTCG
CACCTTGG	CACCTTCG
CACAGTAT	CACAGATC
CACCTTGT	CACCTTCG
CACCTTGN	CACCTTCG
CACAGTCA	CACAGATC
CACCTTTC	CACCTTCG
CACCTTTG	CACCTTCG
CACAGTCC	CACAGATC
CACAGTCG	CACAGATC
CACAGTCT	CACAGATC
CACCTTNC	CACCTTCG
CACCTTNG	CACCTTCG
CACCTNCG	CACCTTCG
CACCTNTC	CACCTTCG
CACAGTCN	CACAGATC
CACNCAGA	CACCAGAG
CAANATTG	CAAATTGG
CACCNAGA	CACCAGAG
CACAGTTA	CACTAGTT
CACAGTTG	CACTAGTT
CACAGTTT	CACTAGTT
CACAGTTN	CACTAGTT
CAGTTAAT	CAGATAAT
CACCNGAG	CACCAGAG
CACAGNAT	CACAGATC
CAGTTGAA	CCGTTGAA
CAGTTGCG	AAGTTGCG
CACCNTCG	CACCTTCG
CACCNTTC	CACCTTCG
CAGTTTAA	CGAGTTTA
CAGTTTAC	CGAGTTTA
CAGGAACC	CGGGAACC
CACAGNTC	CACAGATC
CAGTTTAG	CGAGTTTA
CAGTTTAT	CGAGTTTA
CAGTTTAN	CGAGTTTA
CACATAAT	CAGATAAT
CACATAGA	GCACATAG
CACATAGC	GCACATAG
CACATAGG	GCACATAG
CACATAGN	GCACATAG
CACATATC	CACAGATC
CAGGACTA	ACAGGACT
CAGGACTC	ACAGGACT
CAGGACTG	ACAGGACT
CAGGACTT	ACAGGACT
CAGGACTN	ACAGGACT
CAGGATAA	CAGATAAT
CACGACGG	CCGACGGA
CACATGAT	CACAGATC
CACGAGAG	CACCAGAG
CACGAGAT	CACAGATC
CACNCTTC	CACCTTCG
CACGAGTT	CACTAGTT
CATAAGGG	TATAAGGG
CACATTAT	GACATTAT
CACATTCG	CACCTTCG
CACGATAA	CAGATAAT
CACGATAC	ACGATACG
CACATTGG	CAAATTGG
CACATTGT	CCATTGTC
CACGATCA	CACAGATC
CACGATCC	CACAGATC
CACGATCG	CACAGATC
CACGATCT	CACAGATC
CACGATCN	CACAGATC
CATAATGA	CTTAATGA
CATAATTG	CAAATTGG
CANATAAT	CAGATAAT
CAGAAAAT	CAGATAAT
CAGAAATA	CAGATAAT
CAGAAATC	CAGATAAT
CAGAAATG	CAGATAAT
CAGAAATT	CAGATAAT
CAGAAATN	CAGATAAT
CACGCAGA	CACCAGAG
CATACCGG	CTTACCGG
CACANATC	CACAGATC
CACGCCCA	TACGCCCA
CACGCCCT	CCGCCCTA
CAGAATAA	CAGATAAT
CAANGGTC	CAAGGTCC
CAGAATTG	CAAATTGG
CACANGAT	CACAGATC
CAANGTCC	CAAGGTCC
CATAGAAA	GATAGAAA
CATAGATC	CACAGATC
CANATTGG	CAAATTGG
CAGACAAT	CAGATAAT
CATAGCTT	AATAGCTT
CACGCTTC	CACCTTCG
CATAGGTC	CAAGGTCC
CAGGCTTA	AGGCTTAA
CATAGTTA	CACTAGTT
CATAGTTC	CACTAGTT
CATAGTTG	CACTAGTT
CATAGTTT	CACTAGTT
CATAGTTN	CACTAGTT
CAGACGGA	CCGACGGA
CAGACTAA	CAGATAAT
CACGGATC	CACAGATC
CATATAAT	CAGATAAT
CACCAAAG	CACCAGAG
CAGGGAAC	CGGGAACC
CACCAAGA	CACCAGAG
CACCAAGC	CACCAGAG
CACCAAGG	CACCAGAG
CACCAAGT	CACCAGAG
CACCAAGN	CACCAGAG
CAGNATAA	CAGATAAT
CACCAATT	CCCAATTT
CACCACAG	CACCAGAG
CACCACCG	CCCACCGT
CACCACGA	CACCAGAG
CATATGCA	CTATGCAA
CAGAGAAT	CAGATAAT
CACGGGCG	CCGGGCGT
CAGGGCGT	CCGGGCGT
CACCAGAA	CACCAGAG
CACCAGAC	CACCAGAG
CACCAGAG	CACCAGAG
CACCAGAN	CACCAGAG
CACCAGCA	CACCAGAG
CAGAGATC	CACAGATC
CACCAGCG	CACCAGAG
CACCAGGA	CACCAGAG
CACCAGGC	CACCAGAG
CACCAGGG	CACCAGAG
CACCAGGT	CACCAGAG
CACCAGGN	CACCAGAG
CACCAGTA	CACCAGAG
CACGGTAT	TACGGTAT
CACCAGTG	CACCAGAG
CACCAGTT	CACTAGTT
CACGGTCC	CAAGGTCC
CACCAGNA	CACCAGAG
CATATTGG	CAAATTGG
CACCAGNG	CACCAGAG
CACCATAG	CACCAGAG
CACCATCG	CACCTTCG
CACCATGA	CACCAGAG
CCAAGAGA	CCAAAGAG
CCAAGAGC	CCAAAGAG
CCAAGAGG	CCAAAGAG
CCAAGAGT	CCAAAGAG
CACCATTC	CACCTTCG
CCAAGAGN	CCAAAGAG
CAGAGGCC	AGAGGCCG
CACCANAG	CACCAGAG
CACCANGA	CACCAGAG
CAGAGGTC	CAAGGTCC
CAGAGTAA	CAGATAAT
CAGGGTAG	CGGGTAGG
CCAAGGAG	CCAAAGAG
CATCAGAG	CACCAGAG
CAGGGTCC	CAAGGTCC
CATCAGAT	CACAGATC
CAGAGTTT	CGAGTTTA
CCAAGGTC	CAAGGTCC
CACGTAGT	CACTAGTT
CCAGAAGA	CCAAAGAG
CANCAGAG	CACCAGAG
CANCAGAT	CACAGATC
CAGATAAA	CAGATAAT
CAGATAAC	CAGATAAT
CAGATAAG	CAGATAAT
CAGATAAT	CAGATAAT
CAGATAAN	CAGATAAT
CAGATACA	CAGATAAT
CATGGGCT	ATGGGCTA
CAGATACT	CAGATAAT
CAGATAGA	CAGATAAT
CAGATAGT	CAGATAAT
CAGATATA	CAGATAAT
CAGATATC	CAGATAAT
CAGATATG	CAGATAAT
CCAGACGG	CCGACGGA
CAGATATT	CAGATAAT
CAGATATN	CAGATAAT
CAGATANA	CAGATAAT
CAGATANT	CAGATAAT
CATGGTAC	CCTGGTAC
CAGATCAA	CAGATAAT
CATGGTCC	CAAGGTCC
CAGATCAT	CAGATAAT
CCAGAGAG	CCAAAGAG
CCAATAGA	CCAAAGAG
CAGATGAA	CAGATAAT
CAGATGAT	CAGATAAT
CACGTTCG	CACCTTCG
CACGTTGA	CCGTTGAA
CCAGATAA	CAGATAAT
CAGATTAA	CAGATAAT
CANCCAGA	CACCAGAG
CCAGATCA	CACAGATC
CCAGATCC	CACAGATC
CAGATTAT	CAGATAAT
CCAGATCG	CACAGATC
CCAGATCT	CACAGATC
CCAGATCN	CACAGATC
CATGTAGT	CTGTAGTC
CAGATTGG	CAAATTGG
CCAATGAG	CCAAAGAG
CAGATNAA	CAGATAAT
CATGTCGC	ATGTCGCT
CAGATNAT	CAGATAAT
CCAATGTC	CCATTGTC
CAGANAAT	CAGATAAT
CCAATTGG	CAAATTGG
CCAATTGT	CCATTGTC
CCAATTTA	CCCAATTT
CCAATTTC	CCCAATTT
CATCCAGA	CACCAGAG
CCAATTTG	CCCAATTT
CCAATTTT	CCCAATTT
CCAATTTN	CCCAATTT
CATCCATA	GCATCCAT
CATCCATC	GCATCCAT
CATCCATG	GCATCCAT
CATCCATT	GCATCCAT
CATCCATN	GCATCCAT
CANCCTTC	CACCTTCG
CCAANAGA	CCAAAGAG
CCAGCCCT	CCGCCCTA
CATCCGCC	ATCCGCCA
CAGANTAA	CAGATAAT
CCAANGAG	CCAAAGAG
CATCCTTC	CACCTTCG
CATCGACT	ATCGACTT
CATTAATG	CTTAATGA
CCACAAGA	CCAAAGAG
CCACAATT	CCCAATTT
CCAGGACT	ACAGGACT
CATTACCG	CTTACCGG
CCACACCG	CCCACCGT
CATCGGAA	ATCGGAAA
CCACAGAG	CCAAAGAG
CCACAGAT	CACAGATC
CATTAGTT	CACTAGTT
CCAGGCGT	CCGGGCGT
CATTATAT	ATTATATC
CANCTAGT	CACTAGTT
CCACATAG	GCACATAG
CCAGGGCG	CCGGGCGT
CCAGGTAC	CCTGGTAC
CCAGGTCC	CAAGGTCC
CATTCAAC	ATTCAACC
CCACCAGA	CACCAGAG
CANCTTCG	CACCTTCG
CCACCCTA	CCGCCCTA
CATTCCTG	ATTCCTGA
CATCTAGT	CACTAGTT
CCACCGTA	CCCACCGT
CCACCGTC	CCCACCGT
CANGGTCC	CAAGGTCC
CCACCGTG	CCCACCGT
CCACCGTT	CCCACCGT
CCACCGTN	CCCACCGT
CATCTCCA	CTCTCCAT
CCACCTTC	CACCTTCG
CCAGTGTC	CCATTGTC
CCAGTTGA	CCGTTGAA
CCAGTTGT	CCATTGTC
CCAGTTTA	CGAGTTTA
CATTGGCG	TATTGGCG
CATCTTCG	CACCTTCG
CATCTTTA	CTCTTTAA
CCACGGAA	CCGACGGA
CCACGGAC	CCGACGGA
CCACGGAG	CCGACGGA
CCACGGAT	CCGACGGA
CCACGGAN	CCGACGGA
CATTGTCA	CCATTGTC
CATTGTCC	CCATTGTC
CATTGTCG	CCATTGTC
CATTGTCT	CCATTGTC
CATTGTCN	CCATTGTC
CATTTCCC	GATTTCCC
CCACTAGT	CACTAGTT
CANGATAA	CAGATAAT
CCACTGTC	CCATTGTC
CCACTTGT	CCATTGTC
CATGACCG	AATGACCG
CCCTGGTA	CCTGGTAC
CCATAAGA	CCAAAGAG
CANTAGTT	CACTAGTT
CCATAGAG	CCAAAGAG
CATGATAA	CAGATAAT
CCATAGTC	CCATTGTC
CCATATGT	CCATTGTC
CCCTTCGA	CACCTTCG
CCCTTCGC	CACCTTCG
CCCTTCGG	CACCTTCG
CCCTTCGT	CACCTTCG
CCCTTCGN	CACCTTCG
CCCTTGAA	CCGTTGAA
CCCACACG	CCCACCGT
CCCTTGTC	CCATTGTC
CCCACAGT	CCCACCGT
CCCTTTAA	CTCTTTAA
CCCACATT	CCCAATTT
CCCACCAG	CCCACCGT
CCCACCAT	CCCACCGT
CATGCAAA	CTATGCAA
CATGCAAC	CTATGCAA
CATGCAAG	CTATGCAA
CCCACCCG	CCCACCGT
CATGCAAT	CTATGCAA
CCCACCCT	CCCACCGT
CCATCCAT	GCATCCAT
CATGCAAN	CTATGCAA
CCCACCGA	CCCACCGT
CANAATTG	CAAATTGG
CCCACCGC	CCCACCGT
CCCACCGG	CCCACCGT
CCCACCGT	CCCACCGT
CCCACCGN	CCCACCGT
CCCACCTA	CCCACCGT
CCCACCTC	CCCACCGT
CCCACCTG	CCCACCGT
CCCACCTT	CCCACCGT
CCCACCTN	CCCACCGT
CCCACCNG	CCCACCGT
CCCACCNT	CCCACCGT
CCCACGCG	CCCACCGT
CCCACGGA	CCGACGGA
CCCACGGT	CCCACCGT
CCCACGTA	CCCACCGT
CCCACGTC	CCCACCGT
CCCACGTG	CCCACCGT
CCATCGTC	CCATTGTC
CCCACGTT	CCCACCGT
CCCACGTN	CCCACCGT
CCCACTCG	CCCACCGT
CCCACTGT	CCCACCGT
CCATCTGT	CCATTGTC
CCCACTTT	CCCAATTT
CCCACNCG	CCCACCGT
CCGTCCCT	CCGCCCTA
CCCACNGT	CCCACCGT
CCCAGAGA	CACCAGAG
CCGTCCTA	CCGCCCTA
CCCAGAGC	CACCAGAG
CCCAGAGG	CACCAGAG
CCCAGAGT	CACCAGAG
CCCAGAGN	CACCAGAG
CCCAGATC	CACAGATC
CCCAGATT	CCCAATTT
CCATGCAA	CTATGCAA
CCGTCGAA	CCGTTGAA
CCATTAGT	CCATTGTC
CCATTATC	CCATTGTC
CCCAGCCG	CCCACCGT
CCGTCGGA	CCGACGGA
CCCAGCGT	CCCACCGT
CCATTCGT	CCATTGTC
CCATTCTC	CCATTGTC
CCATGGTA	CCTGGTAC
CCATGGTC	CCATTGTC
CCATTGAA	CCGTTGAA
CCATTGAC	CCATTGTC
CCATTGAT	CCATTGTC
CCGTCTGA	CCGTTGAA
CCATTGCA	CCATTGTC
CCATTGCC	CCATTGTC
CCGTCTGG	TCGTCTGG
CCATTGCG	CCATTGTC
CCATTGCT	CCATTGTC
CCATTGCN	CCATTGTC
CCATTGGC	CCATTGTC
CCATTGGT	CCATTGTC
CCATGTCA	CCATTGTC
CCATGTCC	CCATTGTC
CCATTGTA	CCATTGTC
CCATGTCG	CCATTGTC
CCATTGTC	CCATTGTC
CCATGTCT	CCATTGTC
CCATTGTG	CCATTGTC
CCATGTCN	CCATTGTC
CCATTGTT	CCATTGTC
CCATTGTN	CCATTGTC
CCATGTGT	CCATTGTC
CCCAGTTT	CCCAATTT
CCGTGAAA	CCGTTGAA
CCATTGNC	CCATTGTC
CCGTGAAC	CCGTTGAA
CCATTGNT	CCATTGTC
CCCNAATT	CCCAATTT
CCATTTCA	CCATTGTC
CCATTTCC	CCATTGTC
CCATTTCG	CCATTGTC
CCATTTCT	CCATTGTC
CCATTTCN	CCATTGTC
CANAGATC	CACAGATC
CCATTTGT	CCATTGTC
CCGTGAAG	CCGTTGAA
CCGTGAAT	CCGTTGAA
CCGTGAAN	CCGTTGAA
CCATTTTC	CCATTGTC
CCCNACCG	CCCACCGT
CCCATATT	CCCAATTT
CCAAAAAG	CCAAAGAG
CCCATCCG	CCCACCGT
CCCATCGT	CCCACCGT
CCATTNGT	CCATTGTC
CCATTNTC	CCATTGTC
CCAAAAGA	CCAAAGAG
CCGTGCGT	CCGGGCGT
CCAAAAGC	CCAAAGAG
CCAAAAGG	CCAAAGAG
CCAAAAGT	CCAAAGAG
CCAAAAGN	CCAAAGAG
CCCATTGT	CCATTGTC
CCCATTTA	CCCAATTT
CCCATTTC	CCCAATTT
CCCATTTG	CCCAATTT
CCCATTTT	CCCAATTT
CCCATTTN	CCCAATTT
CANAGGTC	CAAGGTCC
CCAAACAG	CCAAAGAG
CCAAACGA	CCAAAGAG
CCGTGGAA	CCGTTGAA
CCCANATT	CCCAATTT
CCGTGGCG	CCGGGCGT
CCAAAGAA	CCAAAGAG
CCAAAGAC	CCAAAGAG
CCAAAGAG	CCAAAGAG
CCAAAGAT	CCAAAGAG
CCAAAGAN	CCAAAGAG
CCAAAGCA	CCAAAGAG
CCAAAGCG	CCAAAGAG
CCCANCCG	CCCACCGT
CCAAAGGA	CCAAAGAG
CCAAAGGC	CCAAAGAG
CCAAAGGG	CCAAAGAG
CCCANCGT	CCCACCGT
CCGTGGTA	CCTGGTAC
CCATNGTC	CCATTGTC
CCCNATTT	CCCAATTT
CCAAAGGT	CCAAAGAG
CCAAAGGN	CCAAAGAG
CCAAAGTA	CCAAAGAG
CCGTGTGA	CCGTTGAA
CCAAAGTG	CCAAAGAG
CCAAAGNA	CCAAAGAG
CCAAAGNG	CCAAAGAG
CCGTGTTA	GCGTGTTA
CCAAATAG	CCAAAGAG
CCATNTGT	CCATTGTC
CCAAATGA	CCAAAGAG
CCAAATTG	CAAATTGG
CCGAAAGA	CCAAAGAG
CCAAATTT	CCCAATTT
CCCANTTT	CCCAATTT
CCANAAGA	CCAAAGAG
CCGTTAAA	CCGTTGAA
CCGTTAAC	CCGTTGAA
CCAAANAG	CCAAAGAG
CCTAAAGA	CCAAAGAG
CCAAANGA	CCAAAGAG
CCGTTAAG	CCGTTGAA
CCGTTAAT	CCGTTGAA
CCGTTAAN	CCGTTGAA
CCGTTAGA	CCGTTGAA
CCGAACGG	CCGACGGA
CCAACAAC	TCAACAAC
CCGTTCAA	CCGTTGAA
CCAACAGA	CCAAAGAG
CCANAGAG	CCAAAGAG
CCGAAGAG	CCAAAGAG
CCGTTCGA	CCGTTGAA
CCAACCGT	CCCACCGT
CCGTTGAA	CCGTTGAA
CCGTTGAC	CCGTTGAA
CCGAAGGA	CCGACGGA
CCGTTGAG	CCGTTGAA
CCGTTGAT	CCGTTGAA
CCTAAGAG	CCAAAGAG
CCTAAGCG	ACTAAGCG
CCAACGAG	CCAAAGAG
CCCNCCGT	CCCACCGT
CCCCAATT	CCCAATTT
CCAACGGA	CCGACGGA
CCGTTGAN	CCGTTGAA
CCGTTGCA	CCGTTGAA
CCGTTGGA	CCGTTGAA
CCGTTGTA	CCGTTGAA
CCGTTGTC	CCATTGTC
CCCCACCG	CCCACCGT
CCGTTGNA	CCGTTGAA
CCGTTTAA	CCGTTGAA
CCTAATAA	GCCTAATA
CCTAATAC	GCCTAATA
CCTAATAG	GCCTAATA
CCTAATAT	GCCTAATA
CCTAATAN	GCCTAATA
CCTAATGA	CTTAATGA
CCGAATTT	CCCAATTT
CCCCAGAG	CACCAGAG
CCGTTTGA	CCGTTGAA
CCTAATTT	CCCAATTT
CCGTTNAA	CCGTTGAA
CCGTTNGA	CCGTTGAA
CCGACAGA	CCGACGGA
CCCCATTT	CCCAATTT
CCGACAGG	CCGACGGA
CCCGAACA	ACCCGAAC
CCCGAACC	ACCCGAAC
CCCGAACG	ACCCGAAC
CCCGAACT	ACCCGAAC
CCCGAACN	ACCCGAAC
CCCGAATT	CCCAATTT
CCGCTCCT	CCGCCCTA
CCCGACCG	CCCACCGT
CCCGACGG	CCGACGGA
CCGACCCT	CCGCCCTA
CCGACCGA	CCGACGGA
CCGCTCTA	CCGCCCTA
CCGACCGG	CCGACGGA
CCGACCGT	CCCACCGT
CCGTNGAA	CCGTTGAA
CCGACCTA	CCGCCCTA
CCGCTGAA	CCGTTGAA
CCGACGAA	CCGACGGA
CCGACGAC	CCGACGGA
CCGACGAG	CCGACGGA
CCGACGAT	CCGACGGA
CCGACGAN	CCGACGGA
CCGACGCA	CCGACGGA
CCGACGCG	CCGACGGA
CCTACCGG	CTTACCGG
CCTACCGT	CCCACCGT
CCGACGGA	CCGACGGA
CCGACGGC	CCGACGGA
CCGACGGG	CCGACGGA
CCGACGGT	CCGACGGA
CCGACGGN	CCGACGGA
CCGACGTA	CCGACGGA
CCCGATTT	CCCAATTT
CCGTNTGA	CCGTTGAA
CCTACGGA	CCGACGGA
CCGACGTG	CCGACGGA
CCGACGNA	CCGACGGA
CCGACGNG	CCGACGGA
CCGCTTGA	CCGTTGAA
CCGACTGA	CCGACGGA
CCGACTGG	CCGACGGA
CCCCCCGT	CCCACCGT
CCCCCCTA	CCGCCCTA
CCGACNGA	CCGACGGA
CCGACNGG	CCGACGGA
CCCGCCCT	CCGCCCTA
CCCGCCGT	CCCACCGT
CCTAGCGA	TCCTAGCG
CCTAGCGC	TCCTAGCG
CCTAGCGG	TCCTAGCG
CCTAGCGT	TCCTAGCG
CCTAGCGN	TCCTAGCG
CCTAGCTC	GCTAGCTC
CCCCCGTA	CCCACCGT
CCCCCGTC	CCCACCGT
CCCCCGTG	CCCACCGT
CCCCCGTT	CCCACCGT
CCCCCGTN	CCCACCGT
CCGCNCCT	CCGCCCTA
CCGCNCTA	CCGCCCTA
CCGAGCGG	CCGACGGA
CCGAGCGT	CCGGGCGT
CCTAGGTA	CCTGGTAC
CCGAGGAA	CCGACGGA
CCTAGTAC	CCTGGTAC
CCGAGGAC	CCGACGGA
CCGAGGAG	CCGACGGA
CCGAGGAT	CCGACGGA
CCCCCTAA	CCGCCCTA
CCGAGGAN	CCGACGGA
CCCCCTAC	CCGCCCTA
CCCCCTAG	CCGCCCTA
CCCCCTAT	CCGCCCTA
CCGAGGCG	CCGGGCGT
CCCCCTAN	CCGCCCTA
CCGAGGGA	CCGACGGA
CCTAGTTA	CACTAGTT
CCGNACGG	CCGACGGA
CCTAGTTC	CACTAGTT
CCTAGTTG	CACTAGTT
CCTAGTTT	CACTAGTT
CCTAGTTN	CACTAGTT
CCGAGTCC	TCGAGTCC
CCGAGTTT	CGAGTTTA
CCGATAAT	CAGATAAT
CCGGAACC	CGGGAACC
CCCCGAAC	ACCCGAAC
CCGATACG	ACGATACG
CCCGGCGT	CCGGGCGT
CCCGGCTA	TCCCGGCT
CCCGGCTC	TCCCGGCT
CCCGGCTG	TCCCGGCT
CCCGGCTT	TCCCGGCT
CCTATGCA	CTATGCAA
CCCGGCTN	TCCCGGCT
CCGGACGG	CCGACGGA
CCGGACGT	CCGGGCGT
CCGATCGG	CCGACGGA
CCCGGGCG	CCGGGCGT
CCGATGAA	CCGTTGAA
CCGGAGCG	CCGGGCGT
CCTATTGT	CCATTGTC
CCGATGGA	CCGACGGA
CCCGGTAC	CCTGGTAC
CCGATTGA	CCGTTGAA
CCGATTGT	CCATTGTC
CCCCGGCT	TCCCGGCT
CCGNCCCT	CCGCCCTA
CCANTGTC	CCATTGTC
CCGNCCTA	CCGCCCTA
CCGGCCCT	CCGCCCTA
CCGANCGG	CCGACGGA
CCGGCCGT	CCGGGCGT
CCGGCCTA	CCGCCCTA
CCGNCGGA	CCGACGGA
CCGGCGCG	CCGGGCGT
CCANTTGT	CCATTGTC
CCGGCGGA	CCGACGGA
CCGANGGA	CCGACGGA
CCNCCCTA	CCGCCCTA
CCGGCGTA	CCGGGCGT
CCGGCGTC	CCGGGCGT
CCGGCGTG	CCGGGCGT
CCGGCGTT	CCGGGCGT
CCGGCGTN	CCGGGCGT
CCCGTTGA	CCGTTGAA
CCGGGAAC	CGGGAACC
CCGGGACG	CCGGGCGT
CCGGGAGT	CCGGGCGT
CCGCAATT	CCCAATTT
CCGNGCGT	CCGGGCGT
CCGGGCAG	CCGGGCGT
CCGGGCAT	CCGGGCGT
CCGGGCCG	CCGGGCGT
CCGCACCG	CCCACCGT
CCGGGCCT	CCGGGCGT
CCGCACCT	CCGCCCTA
CCGGGCGA	CCGGGCGT
CCGGGCGC	CCGGGCGT
CCGGGCGG	CCGGGCGT
CCGCACGG	CCGACGGA
CCGGGCGT	CCGGGCGT
CCGGGCGN	CCGGGCGT
CCGGGCTA	CCGGGCGT
CCGCACTA	CCGCCCTA
CCGGGCTC	CCGGGCGT
CCGGGCTG	CCGGGCGT
CCGNGGCG	CCGGGCGT
CCGGGCTT	CCGGGCGT
CCGGGCTN	CCGGGCGT
CCGGGCNG	CCGGGCGT
CCGGGCNT	CCGGGCGT
CCGGGGCG	CCGGGCGT
CCCCTTCG	CACCTTCG
CCGGGGGT	CCGGGCGT
CCGGGGTA	CCGGGCGT
CCGGGGTC	CCGGGCGT
CCGGGGTG	CCGGGCGT
CCGGGGTT	CCGGGCGT
CCGGGGTN	CCGGGCGT
CCGGGTAC	CCTGGTAC
CCGGGTAG	CGGGTAGG
CCGGGTCG	CCGGGCGT
CCGGGTGT	CCGGGCGT
CCTCAATT	CCCAATTT
CCGGGNCG	CCGGGCGT
CCGGGNGT	CCGGGCGT
CCGGTACA	CCTGGTAC
CCGGTACC	CCTGGTAC
CCGGTACG	CCTGGTAC
CCGGTACT	CCTGGTAC
CCGGTACN	CCTGGTAC
CCGCCACT	CCGCCCTA
CCTCACCG	CCCACCGT
CCGGTAGG	CGGGTAGG
CCGCCATA	CCGCCCTA
CCTTAATG	CTTAATGA
CCGCCCAA	CCGCCCTA
CCGCCCAC	CCGCCCTA
CCGCCCAG	CCGCCCTA
CCGCCCAT	CCGCCCTA
CCGCCCAN	CCGCCCTA
CCGCCCCA	CCGCCCTA
CCGCCCCT	CCGCCCTA
CCTTACCG	CTTACCGG
CCCTAATA	GCCTAATA
CCGNTGAA	CCGTTGAA
CCGCCCGA	CCGCCCTA
CCCTAATT	CCCAATTT
CCGGTCGT	CCGGGCGT
CCGCCCGT	CCGCCCTA
CCGCCCTA	CCGCCCTA
CCGCCCTC	CCGCCCTA
CCGCCCTG	CCGCCCTA
CCGCCCTT	CCGCCCTA
CCGCCCTN	CCGCCCTA
CCGCCCNA	CCGCCCTA
CCGCCCNT	CCGCCCTA
CCGGTGAA	CCGTTGAA
CCCTACCG	CCCACCGT
CCGGTGCG	CCGGGCGT
CCGCCGCT	CCGCCCTA
CCGCCGGA	CCGACGGA
CCGCCGGG	GCGCCGGG
CCGCCGTA	CCGCCCTA
CCGNTTGA	CCGTTGAA
CCGCCTAA	CCGCCCTA
CCGCCTAC	CCGCCCTA
CCCTAGCG	TCCTAGCG
CCGCCTAG	CCGCCCTA
CCGCCTAT	CCGCCCTA
CCGCCTAN	CCGCCCTA
CCGCCTCT	CCGCCCTA
CCGGTTGA	CCGTTGAA
CCCTAGTT	CACTAGTT
CCGCCTTA	CCGCCCTA
CCGCCNCT	CCGCCCTA
CCCTATTT	CCCAATTT
CCGCCNTA	CCGCCCTA
CCCAAAGA	CCAAAGAG
CCGCGAAG	GCGCGAAG
CCCAAATT	CCCAATTT
CCTCCATA	CTCTCCAT
CCTCCATC	CTCTCCAT
CCTCCATG	CTCTCCAT
CCCAACCG	CCCACCGT
CCTCCATT	CTCTCCAT
CCTCCATN	CTCTCCAT
CCGCGCCT	CCGCCCTA
CCCAACGT	CCCACCGT
CCGCGCGT	CCGGGCGT
CCCAACTT	CCCAATTT
CCGGNCGT	CCGGGCGT
CCGCGCTA	CCGCCCTA
CCCAAGAG	CCAAAGAG
CCGCGGAA	CCGACGGA
CCGCGGAC	CCGACGGA
CCTCCCTA	CCGCCCTA
CCCTCCAT	CTCTCCAT
CCGCGGAG	CCGACGGA
CCGCGGAT	CCGACGGA
CCGCGGAN	CCGACGGA
CCGCGGCG	CCGGGCGT
CCGGNGCG	CCGGGCGT
CCCTCCGT	CCCACCGT
CCCAAGTT	CCCAATTT
CCCAATAT	CCCAATTT
CCCAATCT	CCCAATTT
CCCAATGT	CCCAATTT
CCCAATTA	CCCAATTT
CCCAATTC	CCCAATTT
CCCAATTG	CCCAATTT
CCCAATTT	CCCAATTT
CCCAATTN	CCCAATTT
CGACAGAT	CACAGATC
CCCAATNT	CCCAATTT
CCCTCTCT	TCCTCTCT
CCCAANTT	CCCAATTT
CGAGTAGG	CGGGTAGG
CCTTGAAA	CCGTTGAA
CCTTGAAC	CCGTTGAA
CGAGTATA	CGAGTTTA
CCGTACGG	CCGACGGA
CGAGTATT	CGAGTTTA
CCTTGAAG	CCGTTGAA
CCTTGAAT	CCGTTGAA
CCTTGAAN	CCGTTGAA
CCGTAGAA	CCGTTGAA
CGAGTCCA	TCGAGTCC
CGAGTCCC	TCGAGTCC
CGAGTCCG	TCGAGTCC
CGAGTCCT	TCGAGTCC
CGAGTCCN	TCGAGTCC
CGAGTCGG	GAGTCGGT
CGAGTCTA	CGAGTTTA
CCNGACGG	CCGACGGA
CGAGTCTT	CGAGTTTA
CCGTAGTC	CTGTAGTC
CCTCGGTA	CCTGGTAC
CCTCGTAC	CCTGGTAC
CCGTATGA	CCGTTGAA
CGAGTGTA	CGAGTTTA
CGAGTGTT	CGAGTTTA
CGAGTTAA	CGAGTTTA
CGAGTTAC	CGAGTTTA
CGAGTTAG	CGAGTTTA
CGAGTTAT	CGAGTTTA
CGAGTTAN	CGAGTTTA
CGAGTTCA	CGAGTTTA
CGACATTA	GACATTAT
CGAGTTCT	CGAGTTTA
CGAGTTGA	CGAGTTTA
CGAGTTGT	CGAGTTTA
CGAGTTTA	CGAGTTTA
CGAGTTTC	CGAGTTTA
CGAGTTTG	CGAGTTTA
CGAGTTTT	CGAGTTTA
CGAGTTTN	CGAGTTTA
CGAGTTNA	CGAGTTTA
CGAGTTNT	CGAGTTTA
CGAGTNTA	CGAGTTTA
CGAGTNTT	CGAGTTTA
CCTCTCCA	CTCTCCAT
CCTTGGTA	CCTGGTAC
CCTCTCTA	TCCTCTCT
CCTCTCTC	TCCTCTCT
CCTCTCTG	TCCTCTCT
CCTCTCTT	TCCTCTCT
CCTCTCTN	TCCTCTCT
CCNGCCCT	CCGCCCTA
CCTTGTAC	CCTGGTAC
CCTTGTCA	CCATTGTC
CCTTGTCC	CCATTGTC
CCTTGTCG	CCATTGTC
CCTTGTCT	CCATTGTC
CCTTGTCN	CCATTGTC
CGACCAGA	CACCAGAG
CCTCTTTA	CTCTTTAA
CCTTTAAA	CTCTTTAA
CCTTTAAC	CTCTTTAA
CCTTTAAG	CTCTTTAA
CCTTTAAT	CTCTTTAA
CCTTTAAN	CTCTTTAA
CGACCCGT	GACCCGTC
CCNAAAGA	CCAAAGAG
CGAGNTTA	CGAGTTTA
CCTTTGAA	CCGTTGAA
CGAGNTTT	CGAGTTTA
CCNGGCGT	CCGGGCGT
CGACCTTC	CACCTTCG
CCNGGGCG	CCGGGCGT
CCNAAGAG	CCAAAGAG
CCTTTGTC	CCATTGTC
CGATAATA	CAGATAAT
CGATAATC	CAGATAAT
CGATAATG	CAGATAAT
CGATAATT	CAGATAAT
CGATAATN	CAGATAAT
CGATACGA	ACGATACG
CGATACGC	ACGATACG
CCNGGTAC	CCTGGTAC
CCNAATTT	CCCAATTT
CGATACGG	ACGATACG
CGATACGT	ACGATACG
CGATACGN	ACGATACG
CGACGGAA	CCGACGGA
CGACGGAC	CCGACGGA
CGACGGAG	CCGACGGA
CGACGGAT	CCGACGGA
CGACGGAN	CCGACGGA
CCNTGGTA	CCTGGTAC
CGATAGAA	GATAGAAA
CGACGTTT	CGAGTTTA
CCNACCGT	CCCACCGT
CGACTAGT	CACTAGTT
CGAAAATT	GAAAATTT
CCNACGGA	CCGACGGA
CCNGTTGA	CCGTTGAA
CGAAAGAG	CCAAAGAG
CGAAATTG	CAAATTGG
CCNTTGAA	CCGTTGAA
CCNTTGTC	CCATTGTC
CCTGACGG	CCGACGGA
CGACTTTA	CGAGTTTA
CCTGAGTA	CCTGGTAC
CCTGATAC	CCTGGTAC
CCTNGGTA	CCTGGTAC
CGAAGGGT	GAAGGGTA
CGAAGGTC	CAAGGTCC
CCTNGTAC	CCTGGTAC
CCTGCCCT	CCGCCCTA
CGATGCAA	CTATGCAA
CCTGCGTA	CCTGGTAC
CGAAGTTT	CGAGTTTA
CCTGCTAC	CCTGGTAC
CCNATTGT	CCATTGTC
CCTGGAAC	CCTGGTAC
CCTGGACA	CCTGGTAC
CCTGGACC	CCTGGTAC
CCTGGACG	CCTGGTAC
CCTGGACT	CCTGGTAC
CGAGAACC	CGGGAACC
CCTGGACN	CCTGGTAC
CGATGTTT	CGAGTTTA
CGAATTCG	GAATTCGT
CGAATTGG	CAAATTGG
CGAATTTA	CGAGTTTA
CCTGGATA	CCTGGTAC
CCTGGCAC	CCTGGTAC
CGCCAATT	CCCAATTT
CCTGGCGT	CCGGGCGT
CCTGGCTA	CCTGGTAC
CGCCACCG	CCCACCGT
CGCCAGAG	CACCAGAG
CCNCAATT	CCCAATTT
CGATTGTC	CCATTGTC
CGCCATGT	TGCCATGT
CCNCACCG	CCCACCGT
CGAGATAA	CAGATAAT
CCTGGGAC	CCTGGTAC
CGAGATTA	CGAGTTTA
CGAGATTT	CGAGTTTA
CCTGGGCG	CCGGGCGT
CGATTTAA	CGAGTTTA
CGATTTAC	CGAGTTTA
CGGGCAAC	CGGGAACC
CGATTTAG	CGAGTTTA
CGATTTAT	CGAGTTTA
CGATTTAN	CGAGTTTA
CGATTTCC	GATTTCCC
CCTGGGTA	CCTGGTAC
CGGGCACC	CGGGAACC
CGGGCAGG	CGGGTAGG
CCTGGTAA	CCTGGTAC
CCTGGTAC	CCTGGTAC
CCTGGTAG	CCTGGTAC
CGATTTTA	CGAGTTTA
CCTGGTAT	CCTGGTAC
CCTGGTAN	CCTGGTAC
CCTGGTCA	CCTGGTAC
CCTGGTCC	CCTGGTAC
CCTGGTCG	CCTGGTAC
CCTGGTCT	CCTGGTAC
CCTGGTCN	CCTGGTAC
CCTGGTGA	CCTGGTAC
CCTGGTGC	CCTGGTAC
CCTGGTTA	CCTGGTAC
CCTGGTTC	CCTGGTAC
CGGATAAT	CAGATAAT
CCTGGTNA	CCTGGTAC
CCTGGTNC	CCTGGTAC
CGGATAGG	CGGGTAGG
CCTGGNAC	CCTGGTAC
CGGGCGTA	CCGGGCGT
CGGGCGTC	CCGGGCGT
CGGGCGTG	CCGGGCGT
CGGGCGTT	CCGGGCGT
CGGGCGTN	CCGGGCGT
CGCCCTAA	CCGCCCTA
CGCCCTAC	CCGCCCTA
CGCCCTAG	CCGCCCTA
CGCCCTAT	CCGCCCTA
CGCCCTAN	CCGCCCTA
CCTGGNTA	CCTGGTAC
CGGGCTAG	CGGGTAGG
CCTGTACA	CCTGGTAC
CCTGTACC	CCTGGTAC
CCTGTACG	CCTGGTAC
CCTGTACT	CCTGGTAC
CCTGTACN	CCTGGTAC
CCTGTAGT	CTGTAGTC
CGAGCTTA	CGAGTTTA
CGCGGAAC	CGGGAACC
CGAGCTTT	CGAGTTTA
CGGGGAAC	CGGGAACC
CGGGGACC	CGGGAACC
CGGGGAGG	CGGGTAGG
CGAGGAAC	CGGGAACC
CCTGTGTA	CCTGGTAC
CGGGGCGT	CCGGGCGT
CCTGTTAC	CCTGGTAC
CCTGTTGA	CCGTTGAA
CGCCGGGA	GCGCCGGG
CGCCGGGC	GCGCCGGG
CGCCGGGG	GCGCCGGG
CGCCGGGT	GCGCCGGG
CGCCGGGN	GCGCCGGG
CGCGGGCG	CCGGGCGT
CGGGGTAG	CGGGTAGG
CGCGGTAG	CGGGTAGG
CGAGGCAT	TGAGGCAT
CGAGGCCG	AGAGGCCG
CGCCTAAT	GCCTAATA
CGGGTAAC	CGGGAACC
CGGGTAAG	CGGGTAGG
CGAGGTAG	CGGGTAGG
CGGGTACC	CGGGAACC
CGGGTACG	CGGGTAGG
CGAGGTCC	CAAGGTCC
CCTGNGTA	CCTGGTAC
CGGGTAGA	CGGGTAGG
CGGGTAGC	CGGGTAGG
CGCGTAGG	CGGGTAGG
CGGGTAGG	CGGGTAGG
CGGGTAGT	CGGGTAGG
CGGGTAGN	CGGGTAGG
CGAGGTTA	CGAGTTTA
CGGGTATG	CGGGTAGG
CGAGGTTT	CGAGTTTA
CCTGNTAC	CCTGGTAC
CGGGTANG	CGGGTAGG
CGGGTCAG	CGGGTAGG
CGGGTCGG	CGGGTAGG
CGCGTGTT	GCGTGTTA
CGGGTGAG	CGGGTAGG
CGGCAACC	CGGGAACC
CGGGTGGA	CGGGTAGG
CGGGTGGC	CGGGTAGG
CGGGTGGG	CGGGTAGG
CGCGTTGA	CCGTTGAA
CGGGTGGT	CGGGTAGG
CGGGTGGN	CGGGTAGG
CGCCTTCG	CACCTTCG
CGCGTTTA	CGAGTTTA
CGGGTTAG	CGGGTAGG
CGGGTTGG	CGGGTAGG
CGGGTTTA	CGAGTTTA
CGGGTNAG	CGGGTAGG
CGGGTNGG	CGGGTAGG
CGGGNAAC	CGGGAACC
CGGGNACC	CGGGAACC
CGGNAACC	CGGGAACC
CGGGNAGG	CGGGTAGG
CGGAAACC	CGGGAACC
CGGCCCTA	CCGCCCTA
CGCTAAAT	TGCTAAAT
CGGAACCA	CGGGAACC
CGGAACCC	CGGGAACC
CGGAACCG	CGGGAACC
CGGAACCT	CGGGAACC
CGGAACCN	CGGGAACC
CGGGNTAG	CGGGTAGG
CGANGTTT	CGAGTTTA
CGCTAGCT	GCTAGCTC
CGCTAGTT	CACTAGTT
CGTAGTCA	CTGTAGTC
CGTAGTCC	CTGTAGTC
CGTAGTCG	CTGTAGTC
CGTAGTCT	CTGTAGTC
CGTAGTCN	CTGTAGTC
CGTAGTTT	CGAGTTTA
CGCGAACC	CGGGAACC
CGCGAAGA	GCGCGAAG
CGCGAAGC	GCGCGAAG
CGCGAAGG	GCGCGAAG
CGCGAAGT	GCGCGAAG
CGCGAAGN	GCGCGAAG
CGGTAACC	CGGGAACC
CGGCGAAC	CGGGAACC
CGCTCCAT	CTCTCCAT
CGCGACGG	CCGACGGA
CGGACGGA	CCGACGGA
CGANTTTA	CGAGTTTA
CGGTAGGA	CGGGTAGG
CGGTAGGC	CGGGTAGG
CGGTAGGG	CGGGTAGG
CGGTAGGT	CGGGTAGG
CGGTAGGN	CGGGTAGG
CGGTAGTC	CTGTAGTC
CGGCGTAG	CGGGTAGG
CGGNGAAC	CGGGAACC
CGGAGAAC	CGGGAACC
CGGAGACT	TGGAGACT
CGTATGCA	CTATGCAA
CGGCTAGG	CGGGTAGG
CGGAGTAG	CGGGTAGG
CGCTGGTA	CCTGGTAC
CGGAGTTT	CGAGTTTA
CGCGCCCT	CCGCCCTA
CGCGCCGG	GCGCCGGG
CGGCTTAA	AGGCTTAA
CGCGCGAA	GCGCGAAG
CGCAAAGA	CCAAAGAG
CGCAAAGG	AGCAAAGG
CGGNGTAG	CGGGTAGG
CGCTTCTT	AGCTTCTT
CGCTTTAA	CTCTTTAA
CGTTTAAA	GTTTAAAG
CGGNTAGG	CGGGTAGG
CGCAATTT	CCCAATTT
CGGTGAAC	CGGGAACC
CGNGAACC	CGGGAACC
CGTTTGAC	GTTTGACT
CGGGAAAC	CGGGAACC
CGCACATA	GCACATAG
CGGGAACA	CGGGAACC
CGGGAACC	CGGGAACC
CGGGAACG	CGGGAACC
CGGGAACT	CGGGAACC
CGGGAACN	CGGGAACC
CGGGAAGC	CGGGAACC
CGGGAAGG	CGGGTAGG
CGGGAATC	CGGGAACC
CGGGAANC	CGGGAACC
CGCACCGT	CCCACCGT
CGGGACAC	CGGGAACC
CGTTTTGC	TGTTTTGC
CGGGACCA	CGGGAACC
CGGGACCC	CGGGAACC
CGGGACCG	CGGGAACC
CGTCAAAT	GTCAAATG
CGGGACCT	CGGGAACC
CGGGACCN	CGGGAACC
CGGTGGTT	AGGTGGTT
CGGGAGAC	CGGGAACC
CGGGAGCC	CGGGAACC
CGGGAGGA	CGGGTAGG
CGGGAGGC	CGGGTAGG
CGGGAGGG	CGGGTAGG
CGGGAGGT	CGGGTAGG
CGGTGTAG	CGGGTAGG
CGGGAGGN	CGGGTAGG
CGGGATAC	CGGGAACC
CGGGATAG	CGGGTAGG
CGGGATCC	CGGGAACC
CGGGANAC	CGGGAACC
CGTCAGGC	GTCAGGCT
CGGGANCC	CGGGAACC
CGGTTAGG	CGGGTAGG
CGCAGATC	CACAGATC
CGGTTGAA	CCGTTGAA
CGNGGAAC	CGGGAACC
CGGTTTAA	CGAGTTTA
CGGTTTAC	CGAGTTTA
CGGTTTAG	CGAGTTTA
CGGTTTAT	CGAGTTTA
CGGTTTAN	CGAGTTTA
CGNGGTAG	CGGGTAGG
CGCAGTTT	CGAGTTTA
CGNAGTTT	CGAGTTTA
CGNGTAGG	CGGGTAGG
CGNGTTTA	CGAGTTTA
CGTAATGA	CTTAATGA
CTAAAGAG	CCAAAGAG
CGCATCCA	GCATCCAT
CTAAATGA	CTTAATGA
CTAAATTG	CAAATTGG
CGCATTGT	CCATTGTC
CGTGAACC	CGGGAACC
CGTCTCAG	AGTCTCAG
CGTCTCCA	CTCTCCAT
CGTACCGA	GTACCGAA
CGTACCGG	CTTACCGG
CGTCTGGA	TCGTCTGG
CGTCTGGC	TCGTCTGG
CGTCTGGG	TCGTCTGG
CTAACCAG	TAACCAGC
CGTCTGGT	TCGTCTGG
CGTCTGGN	TCGTCTGG
CTAACCGG	CTTACCGG
CGTCTTTA	CTCTTTAA
CTACTAGT	CACTAGTT
CTACTCCA	CTCTCCAT
CTACTGCA	CTATGCAA
CTACTTTA	CTCTTTAA
CTAAGATC	TAAGATCG
CTATCAAA	CTATGCAA
CTATCAAC	CTATGCAA
CTATCAAG	CTATGCAA
CTAAGCAA	CTATGCAA
CTATCAAT	CTATGCAA
CTATCAAN	CTATGCAA
CTATCACT	TTATCACT
CTAAGCGA	ACTAAGCG
CTAAGCGC	ACTAAGCG
CTAAGCGG	ACTAAGCG
CTAAGCGT	ACTAAGCG
CTAAGCGN	ACTAAGCG
CTATCCAA	CTATGCAA
CTATCCAT	CTCTCCAT
CTAAGGTC	CAAGGTCC
CTATCGCA	CTATGCAA
CGTGGAAC	CGGGAACC
CGTGGCAC	GTGGCACC
CTAATGAA	CTTAATGA
CTAATGAC	CTTAATGA
CTAATGAG	CTTAATGA
CTAATGAT	CTTAATGA
CTAATGAN	CTTAATGA
CTAATGCA	CTATGCAA
CTATGAAA	CTATGCAA
CTATGAAC	CTATGCAA
CTATGAAG	CTATGCAA
CTATGAAT	CTATGCAA
CTATGAAN	CTATGCAA
CTATGACA	CTATGCAA
CTAATTAC	TAATTACA
CTAATTGG	CAAATTGG
CTATGCAA	CTATGCAA
CTATGCAC	CTATGCAA
CTATGCAG	CTATGCAA
CTATGCAT	CTATGCAA
CGTGGGGT	TGTGGGGT
CTCNTCCA	CTCTCCAT
CTATGCAN	CTATGCAA
CTATGCCA	CTATGCAA
CTATGCGA	CTATGCAA
CTATGCTA	CTATGCAA
CTATGCNA	CTATGCAA
CTATGGAA	CTATGCAA
CTATGGCA	CTATGCAA
CGTGGTAC	CCTGGTAC
CGTGGTAG	CGGGTAGG
CTCNTTAA	CTCTTTAA
CTATGTAA	CTATGCAA
CTATGTCA	CTATGCAA
CTCNTTTA	CTCTTTAA
CTATGNAA	CTATGCAA
CTATGNCA	CTATGCAA
CGTGTAGG	CGGGTAGG
CGTGTAGT	CTGTAGTC
CGTGTCGA	TGTGTCGA
CTAGATAA	CAGATAAT
CGTGTTAA	GCGTGTTA
CGTGTTAC	GCGTGTTA
CGTGTTAG	GCGTGTTA
CGTGTTAT	GCGTGTTA
CGTGTTAN	GCGTGTTA
CGTGTTTA	CGAGTTTA
CTACAGAT	CACAGATC
CTATTCAA	CTATGCAA
CTAGCAAA	CTATGCAA
CTAGCAAC	CTATGCAA
CTAGCAAG	CTATGCAA
CTAGCAAT	CTATGCAA
CTAGCAAN	CTATGCAA
CTATTGCA	CTATGCAA
CTATTGGC	TATTGGCG
CTATTGTC	CCATTGTC
CTACCAGA	CACCAGAG
CTATTTAA	CTCTTTAA
CTGAAGTC	CTGTAGTC
CTGAATGA	CTTAATGA
CTCCGCCA	ATCCGCCA
CTACCGAA	GTACCGAA
CTACCGGA	CTTACCGG
CTACCGGC	CTTACCGG
CTACCGGG	CTTACCGG
CTACCGGT	CTTACCGG
CTACCGGN	CTTACCGG
CTAGCTCA	GCTAGCTC
CTAGCTCC	GCTAGCTC
CTAGCTCG	GCTAGCTC
CTAGCTCT	GCTAGCTC
CTAGCTCN	GCTAGCTC
CTACCTTC	CACCTTCG
CTGACAGC	TTGACAGC
CGTTAATG	CTTAATGA
CTATNCAA	CTATGCAA
CTGACCGG	CTTACCGG
CGTTACCG	CTTACCGG
CTCTAATG	CTTAATGA
CTAGGACG	TTAGGACG
CTGACGGA	CCGACGGA
CTCTACAT	CTCTCCAT
CTCTACCA	CTCTCCAT
CTCTACCG	CTTACCGG
CTAGGCAA	CTATGCAA
CTATNGCA	CTATGCAA
CTCTAGTC	CTGTAGTC
CTACGCAA	CTATGCAA
CTCTAGTT	CACTAGTT
CTCTATAA	CTCTTTAA
CTACGCCC	TACGCCCA
CTCTATTA	CTCTTTAA
CTAGGTCC	CAAGGTCC
CTACGGTA	TACGGTAT
CTCTCAAT	CTCTCCAT
CTCTCACA	CTCTCCAT
CTCTCATA	CTCTCCAT
CTCTCATC	CTCTCCAT
CTCTCATG	CTCTCCAT
CTCTCATT	CTCTCCAT
CTCTCATN	CTCTCCAT
CTCTCCAA	CTCTCCAT
CTCTCCAC	CTCTCCAT
CTCTCCAG	CTCTCCAT
CTCTCCAT	CTCTCCAT
CTCTCCAN	CTCTCCAT
CTCTCCCA	CTCTCCAT
CTCTCCCT	CTCTCCAT
CTCTCCGA	CTCTCCAT
CTCCTAGC	TCCTAGCG
CTCTCCGT	CTCTCCAT
CTGCCATG	TGCCATGT
CTCTCCTA	CTCTCCAT
CTCTCCTC	CTCTCCAT
CTCTCCTG	CTCTCCAT
CTCTCCTT	CTCTCCAT
CTCTCCTN	CTCTCCAT
CTCTCCNA	CTCTCCAT
CTCTCCNT	CTCTCCAT
CTCTCGAT	CTCTCCAT
CTCTCGCA	CTCTCCAT
CTCCTCCA	CTCTCCAT
CTGCCCTA	CCGCCCTA
CTGAGGCA	TGAGGCAT
CTCCTCTC	TCCTCTCT
CTCTCTAA	CTCTTTAA
CTCTCTAT	CTCTCCAT
CTCTCTCA	CTCTCCAT
CTAGTAGT	CTGTAGTC
CTGAGTCA	CTGTAGTC
CTGAGTCC	CTGTAGTC
CTGAGTCG	CTGTAGTC
CTGAGTCT	CTGTAGTC
CTCTCTTA	CTCTTTAA
CTGAGTCN	CTGTAGTC
CTGAGTTT	CGAGTTTA
CTCTCNAT	CTCTCCAT
CTCTCNCA	CTCTCCAT
CGTTGAAA	CCGTTGAA
CTCCTTAA	CTCTTTAA
CGTTGAAC	CCGTTGAA
CGTTGAAG	CCGTTGAA
CGTTGAAT	CCGTTGAA
CGTTGAAN	CCGTTGAA
CTCCTTCG	CACCTTCG
CTCCTTTA	CTCTTTAA
CTGATAAT	CAGATAAT
CTAGTGCA	CTATGCAA
CTGATAGT	CTGTAGTC
CTCTGCAA	CTATGCAA
CTCTGCAT	CTCTCCAT
CTCTGCCA	CTCTCCAT
CTAGTTTA	CGAGTTTA
CTCTGGTA	CCTGGTAC
CTGATGCA	CTATGCAA
CTCTGTAA	CTCTTTAA
CTCTGTTA	CTCTTTAA
CTCTTAAA	CTCTTTAA
CTCTTAAC	CTCTTTAA
CTCTTAAG	CTCTTTAA
CTCTTAAT	CTCTTTAA
CTCTTAAN	CTCTTTAA
CTCTTATA	CTCTTTAA
CTCTTCAA	CTCTTTAA
CTCTTCAT	CTCTCCAT
CTCTTCCA	CTCTCCAT
CTGTAAGT	CTGTAGTC
CTCTTCTA	CTCTTTAA
CTGTAATC	CTGTAGTC
CTGTAATG	CTTAATGA
CTCTTGAA	CTCTTTAA
CTGTACCG	CTTACCGG
CTGTACGT	CTGTAGTC
CTCTTGTA	CTCTTTAA
CTGTACTC	CTGTAGTC
CTGCGTTC	TTGCGTTC
CTCTTTAA	CTCTTTAA
CTCTTTAC	CTCTTTAA
CTCTTTAG	CTCTTTAA
CTGTAGAC	CTGTAGTC
CTCTTTAT	CTCTTTAA
CTCTTTAN	CTCTTTAA
CTGTAGAT	CTGTAGTC
CTCTTTCA	CTCTTTAA
CTGTAGCA	CTGTAGTC
CTGTAGCC	CTGTAGTC
CTGTAGCG	CTGTAGTC
CTGTAGCT	CTGTAGTC
CTCTTTGA	CTCTTTAA
CTGTAGCN	CTGTAGTC
CTGTAGGC	CTGTAGTC
CTGTAGGT	CTGTAGTC
CTCTTTTA	CTCTTTAA
CTGTAGTA	CTGTAGTC
CTGTAGTC	CTGTAGTC
CTGTAGTG	CTGTAGTC
CTGTAGTT	CTGTAGTC
CTCTTTNA	CTCTTTAA
CTGTAGTN	CTGTAGTC
CTGTAGNC	CTGTAGTC
CTCTTNAA	CTCTTTAA
CTGTAGNT	CTGTAGTC
CTGTATCA	CTGTAGTC
CTGCTAAA	TGCTAAAT
CTGTATCC	CTGTAGTC
CTGTATCG	CTGTAGTC
CTGTATCT	CTGTAGTC
CTGTATCN	CTGTAGTC
CTCTTNTA	CTCTTTAA
CTGTATGT	CTGTAGTC
CTGTATTC	CTGTAGTC
CTGCTAGT	CTGTAGTC
CTANGCAA	CTATGCAA
CTGCTCCA	CTCTCCAT
CTGTANGT	CTGTAGTC
CTGTANTC	CTGTAGTC
CTCAAAGA	CCAAAGAG
CTCTNCAT	CTCTCCAT
CTCTNCCA	CTCTCCAT
CTCAAATG	GTCAAATG
CTCAACAA	TCAACAAC
CTGTCAGT	CTGTAGTC
CTCGACGG	CCGACGGA
CTGTCCAT	CTCTCCAT
CTCGACTT	ATCGACTT
CTGTCCGA	TTGTCCGA
CTCTNTAA	CTCTTTAA
CTGCTTTA	CTCTTTAA
CTATAAGG	TATAAGGG
CTCTNTTA	CTCTTTAA
CTGTCGCT	ATGTCGCT
CTCGAGTC	TCGAGTCC
CTGTCGTC	CTGTAGTC
CTCAATGA	CTTAATGA
CTATAATG	CTTAATGA
CTCAATTT	CCCAATTT
CTATACAA	CTATGCAA
CTATACCG	CTTACCGG
CTATAGCA	CTATGCAA
CTATAGTC	CTGTAGTC
CTCACCAT	CTCTCCAT
CTCACCGG	CTTACCGG
CTCACCGT	CCCACCGT
CTANTGCA	CTATGCAA
CTGGAACC	CGGGAACC
CTGTGAGT	CTGTAGTC
CTGTGCAA	CTATGCAA
CTGCAGTC	CTGTAGTC
CTGGAGAC	TGGAGACT
CTTCAACC	ATTCAACC
CTGGAGTC	CTGTAGTC
CTTCAATG	CTTAATGA
CTTCACCG	CTTACCGG
CTCAGATC	CACAGATC
CTCGCCAT	CTCTCCAT
CTCGCCCT	CCGCCCTA
CTGTGGGG	TGTGGGGT
CTCNCCAT	CTCTCCAT
CTGTGGTC	CTGTAGTC
CTTCATGA	CTTAATGA
CTGGCACC	GTGGCACC
CTGNTAGT	CTGTAGTC
CTGTGTCA	CTGTAGTC
CTGTGTCC	CTGTAGTC
CTGTGTCT	CTGTAGTC
CTGTGTCN	CTGTAGTC
CTCAGGCT	GTCAGGCT
CTTCCAAA	TTCCAAAA
CTTCCATA	CTCTCCAT
CTTCCATC	CTCTCCAT
CTTCCATG	CTCTCCAT
CTTCCATT	CTCTCCAT
CTCGGAAA	ATCGGAAA
CTTCCATN	CTCTCCAT
CTTCCCGG	CTTACCGG
CTNGTAGT	CTGTAGTC
CTGTTAGT	CTGTAGTC
CTTCCGGA	CTTACCGG
CTTCCGGC	CTTACCGG
CTTCCGGG	CTTACCGG
CTTCCGGT	CTTACCGG
CTTCCGGN	CTTACCGG
CTCGGGCG	CCGGGCGT
CTGGGAAC	CGGGAACC
CTTCCTGA	ATTCCTGA
CTGTTGAA	CCGTTGAA
CTGTTGTC	CTGTAGTC
CTGTTTAA	CTCTTTAA
CTGGGCGT	CCGGGCGT
CTGGGCTA	ATGGGCTA
CTGTTTTG	TGTTTTGC
CTCATCCA	CTCTCCAT
CTCATGCA	CTATGCAA
CTGTNAGT	CTGTAGTC
CTCATTAA	CTCTTTAA
CTTAAAGA	CTTAATGA
CTCATTGT	CCATTGTC
CTCATTTA	CTCTTTAA
CTGGGTAG	CGGGTAGG
CTTAAATG	CTTAATGA
CTTAACCG	CTTACCGG
CTTAACGA	CTTAATGA
CTTAACGG	CTTACCGG
CTCGTAGT	CTGTAGTC
CTTAACTG	CTTAATGA
CTTAAGAA	CTTAATGA
CTTAAGAC	CTTAATGA
CTTAAGAG	CTTAATGA
CTTAAGAT	CTTAATGA
CTTAAGAN	CTTAATGA
CTGGTACA	CCTGGTAC
CTGGTACC	CCTGGTAC
CTGGTACG	CCTGGTAC
CTGGTACT	CCTGGTAC
CTTAAGGA	CTTAATGA
CTGGTACN	CCTGGTAC
CTGGTAGG	CGGGTAGG
CTGGTAGT	CTGTAGTC
CTGTNGTC	CTGTAGTC
CTTAAGTG	CTTAATGA
CTTAATAA	CTTAATGA
CTTAATAC	CTTAATGA
CTTAATAG	CTTAATGA
CTTAATAT	CTTAATGA
CTTAATAN	CTTAATGA
CTTAATCA	CTTAATGA
CTTCTCCA	CTCTCCAT
CTTAATCG	CTTAATGA
CTTAATGA	CTTAATGA
CTTAATGC	CTTAATGA
CTTAATGG	CTTAATGA
CTTAATGT	CTTAATGA
CTTAATGN	CTTAATGA
CTTAATTA	CTTAATGA
CTTAATTG	CTTAATGA
CTTAATNA	CTTAATGA
CTTAATNG	CTTAATGA
CTTAANGA	CTTAATGA
CTCGTCCA	CTCTCCAT
CTTAANTG	CTTAATGA
CTCGTCTG	TCGTCTGG
CTTACACG	CTTACCGG
CTCCAAAA	TTCCAAAA
CTTACAGG	CTTACCGG
CTTACATG	CTTAATGA
CTTACCAG	CTTACCGG
CTCCAATT	CCCAATTT
CTTACCCG	CTTACCGG
CTTACCGA	CTTACCGG
CTTACCGC	CTTACCGG
CTTACCGG	CTTACCGG
CTTACCGT	CTTACCGG
CTTACCGN	CTTACCGG
CTCCACCG	CCCACCGT
CTTACCTG	CTTACCGG
CTTCTTTA	CTCTTTAA
CTTACCNG	CTTACCGG
CTTACGCG	CTTACCGG
CTCCAGAG	CACCAGAG
CTTACGGA	CTTACCGG
CTTACGGC	CTTACCGG
CTTACGGG	CTTACCGG
CTTACGGT	CTTACCGG
CTTACGGN	CTTACCGG
CTCGTTAA	CTCTTTAA
CTCGTTGA	CCGTTGAA
CTTACTCG	CTTACCGG
CTTACTGA	CTTAATGA
CTCGTTTA	CTCTTTAA
CTTACTGG	CTTACCGG
CTGNAGTC	CTGTAGTC
CTTACNCG	CTTACCGG
CTNTAATG	CTTAATGA
CTTACNGG	CTTACCGG
CTNTACCG	CTTACCGG
CTCCCATA	CTCTCCAT
CTCCCATC	CTCTCCAT
CTCCCATG	CTCTCCAT
CTCCCATT	CTCTCCAT
CTCCCATN	CTCTCCAT
CTCCCCAT	CTCTCCAT
CTTAGATG	CTTAATGA
CTCCCGGC	TCCCGGCT
CTTAGCCG	CTTACCGG
CTNTAGTC	CTGTAGTC
CTTAGCGG	CTTACCGG
CTTAGGAC	TTAGGACG
CTTGAATG	CTTAATGA
CTTGACAG	TTGACAGC
CTTGTAGT	CTGTAGTC
CTTAGTCA	CTGTAGTC
CTTAGTCC	CTGTAGTC
CTTAGTCG	CTGTAGTC
CTTAGTCT	CTGTAGTC
CTTAGTCN	CTGTAGTC
CTTAGTGA	CTTAATGA
CTTGACCG	CTTACCGG
CTTGTCCG	TTGTCCGA
CTTGATGA	CTTAATGA
CTNTCCAT	CTCTCCAT
CTTGTGGA	TTTGTGGA
CNAATTGG	CAAATTGG
CTTGCAAA	CTATGCAA
CTTGCAAC	CTATGCAA
CTTGCAAG	CTATGCAA
CTTGCAAT	CTATGCAA
CTTGCAAN	CTATGCAA
CTTATATC	ATTATATC
CTTATATG	CTTAATGA
CTTATCAC	TTATCACT
CTTATCCG	CTTACCGG
CTTATCGG	CTTACCGG
CTTGCCGG	CTTACCGG
CTTATGAA	CTTAATGA
CTTATGAC	CTTAATGA
CTTATGAG	CTTAATGA
CTTATGAT	CTTAATGA
CTTATGAN	CTTAATGA
CTTATGCA	CTATGCAA
CTTNCCGG	CTTACCGG
CTTATTGA	CTTAATGA
CTTGCGTT	TTGCGTTC
CTTANATG	CTTAATGA
CTTANCCG	CTTACCGG
CTTANCGG	CTTACCGG
CTNTGCAA	CTATGCAA
CNACAGAT	CACAGATC
CTTANTGA	CTTAATGA
CTTGGTAC	CCTGGTAC
CNAAAGAG	CCAAAGAG
CNACCAGA	CACCAGAG
CNAAATTG	CAAATTGG
CTNCTCCA	CTCTCCAT
CTTTAAAG	GTTTAAAG
CTTTAATG	CTTAATGA
CTTTACCG	CTTACCGG
CNACCTTC	CACCTTCG
CTTTAGTC	CTGTAGTC
CNAGGTCC	CAAGGTCC
CTTTATGA	CTTAATGA
CTNTTTAA	CTCTTTAA
CTNCTTTA	CTCTTTAA
CTTTCCAT	CTCTCCAT
CTTTCCGG	CTTACCGG
CNAAGGTC	CAAGGTCC
CNAGTTTA	CGAGTTTA
CTTTGACT	GTTTGACT
CTTTGCAA	CTATGCAA
CNACTAGT	CACTAGTT
CNGACGGA	CCGACGGA
CNGGAACC	CGGGAACC
CTTTGTGG	TTTGTGGA
CTTTTAAA	CTCTTTAA
CTTTTAAC	CTCTTTAA
CTTTTAAG	CTCTTTAA
CTTTTAAT	CTCTTTAA
CTTTTAAN	CTCTTTAA
CNGAGTTT	CGAGTTTA
CNGATAAT	CAGATAAT
CTTTTTAA	CTCTTTAA
CTNAATGA	CTTAATGA
CNCTTTAA	CTCTTTAA
CNATGCAA	CTATGCAA
CNGGGAAC	CGGGAACC
CNGGGCGT	CCGGGCGT
CNAGATAA	CAGATAAT
CTNACCGG	CTTACCGG
CNGGGTAG	CGGGTAGG
CTTNAATG	CTTAATGA
CTTNACCG	CTTACCGG
CTTNATGA	CTTAATGA
CNGGTAGG	CGGGTAGG
CNCAGATC	CACAGATC
CNGTTGAA	CCGTTGAA
CNATTGTC	CCATTGTC
CTNATGCA	CTATGCAA
CNCATTGT	CCATTGTC
CNTAATGA	CTTAATGA
CNGCCCTA	CCGCCCTA
CNCGACGG	CCGACGGA
CNGTAGTC	CTGTAGTC
CNTACCGG	CTTACCGG
CNCAAAGA	CCAAAGAG
CNCGCCCT	CCGCCCTA
CNCCAATT	CCCAATTT
CNCCACCG	CCCACCGT
CNCAATTT	CCCAATTT
CNCCAGAG	CACCAGAG
CNCGGGCG	CCGGGCGT
CNCACCGT	CCCACCGT
CNTATGCA	CTATGCAA
CNCGTTGA	CCGTTGAA
CNTCTCCA	CTCTCCAT
GAAAAATT	GAAAATTT
CNCCTTCG	CACCTTCG
GAAAACAT	AAAACATG
CNTCTTTA	CTCTTTAA
GAAAACTT	GAAAATTT
GAAAAGTT	GAAAATTT
GAAAATAT	GAAAATTT
GAAAATCC	AAAATCCC
GAAAATCT	GAAAATTT
GAAAATGT	GAAAATTT
GAAAATTA	GAAAATTT
GAAAATTC	GAAAATTT
GAAAATTG	GAAAATTT
GAAAATTT	GAAAATTT
GAAAATTN	GAAAATTT
GAAAATNT	GAAAATTT
GAACCAGC	TAACCAGC
GAAAANTT	GAAAATTT
GAACCCGT	GACCCGTC
GAACCCTG	AACCCTGG
GAAACATG	AAAACATG
GAAACATT	GAAAATTT
GAACCGAA	GTACCGAA
GAACCGTC	GACCCGTC
CNCTAGTT	CACTAGTT
GAAACGTT	AAACGTTC
GAAACTAA	AAACTAAC
GAAACTTT	GAAAATTT
GAAAGAAA	GATAGAAA
CNCTCCAT	CTCTCCAT
GAAAGATT	GAAAATTT
GAAAGGGT	GAAGGGTA
GAAAGGTA	GAAGGGTA
GAACGGGT	GAAGGGTA
GAACGGTA	GAAGGGTA
GAAAGTTT	GAAAATTT
GAACGTTC	AAACGTTC
CNCTGGTA	CCTGGTAC
GAACTAAC	AAACTAAC
GAAATATT	GAAAATTT
GAACTCGT	GAATTCGT
GAAATCCC	AAAATCCC
GAAATCGT	GAATTCGT
GAACTTCG	GAATTCGT
GAAATGTA	AAATGTAG
CNTGGTAC	CCTGGTAC
GAAATTAT	GACATTAT
GAAATTCG	GAATTCGT
GAAATTGG	CAAATTGG
GAAATTTA	GAAAATTT
GAAATTTC	GAAAATTT
GAAATTTG	GAAAATTT
GAAATTTT	GAAAATTT
GAAATTTN	GAAAATTT
GAAGNGGT	GAAGGGTA
GAAGNGTA	GAAGGGTA
GAAANATT	GAAAATTT
CNTGTAGT	CTGTAGTC
GAATAATT	GAAAATTT
GAATACGT	GAATTCGT
GAATAGAA	GATAGAAA
GAATAGCT	AATAGCTT
GAAANTTT	GAAAATTT
GAATATCG	GAATTCGT
GAATATTT	GAAAATTT
GAAGAAAA	GATAGAAA
GAAGAAAC	GATAGAAA
GAAGAAAG	GATAGAAA
GAAGAAAT	GATAGAAA
GAAGAAAN	GATAGAAA
GAAGAATT	GAAAATTT
GAATCCAT	GCATCCAT
GAACAATT	GAAAATTT
GAATCCGT	GAATTCGT
GAAGAGGT	GAAGGGTA
GAAGAGTA	GAAGGGTA
GAATCGGT	GAGTCGGT
GAATCGTA	GAATTCGT
GAATCGTC	GAATTCGT
GAATCGTG	GAATTCGT
GAATCGTT	GAATTCGT
GAATCGTN	GAATTCGT
GAAGATCG	TAAGATCG
GAATCTCG	GAATTCGT
GAAGATTT	GAAAATTT
GAACATAG	GCACATAG
GAACATTA	GACATTAT
GAACATTT	GAAAATTT
CNTTAATG	CTTAATGA
GAATGACC	AATGACCG
CNTTACCG	CTTACCGG
GAATGCGT	GAATTCGT
GAAGCGGT	GAAGGGTA
GAAGCGTA	GAAGGGTA
GAGGGGTA	GAAGGGTA
GAGGGTAA	GAAGGGTA
GAGGGTAC	GAAGGGTA
GAGGGTAG	GAAGGGTA
GAGGGTAT	GAAGGGTA
GAGGGTAN	GAAGGGTA
GAATGGGT	GAAGGGTA
GAATGGTA	GAAGGGTA
GAATGTAG	AAATGTAG
GAATGTCG	GAATTCGT
GAAGGAGT	GAAGGGTA
GAAGGATA	GAAGGGTA
GAGCAAAG	AGCAAAGG
GAGGTCGG	GAGTCGGT
GAAGGCGT	GAAGGGTA
GAAGGCTA	GAAGGGTA
GAAGGGAA	GAAGGGTA
GAAGGGAC	GAAGGGTA
GAAGGGAG	GAAGGGTA
GAAGGGAT	GAAGGGTA
GAAGGGAN	GAAGGGTA
GAAGGGCA	GAAGGGTA
GAAGGGCT	GAAGGGTA
GAGGTGGT	AGGTGGTT
GAAGGGGA	GAAGGGTA
GAANGGGT	GAAGGGTA
GAANGGTA	GAAGGGTA
GAAGGGGT	GAAGGGTA
GAAGGGTA	GAAGGGTA
GAAGGGTC	GAAGGGTA
GAAGGGTG	GAAGGGTA
GAAGGGTT	GAAGGGTA
GAAGGGTN	GAAGGGTA
GAATTACA	TAATTACA
GAAGGGNA	GAAGGGTA
GAATTACG	GAATTCGT
GAAGGGNT	GAAGGGTA
GAAGGTAA	GAAGGGTA
GAAGGTAC	GAAGGGTA
GAAGGTAG	GAAGGGTA
GAATTAGT	GAATTCGT
GAAGGTAT	GAAGGGTA
GAAGGTAN	GAAGGGTA
GAATTATA	GACATTAT
GAATTATC	GACATTAT
GAAGGTCC	CAAGGTCC
GAATTATG	GACATTAT
GAATTATT	GACATTAT
GAATTATN	GACATTAT
GAAGGTGT	GAAGGGTA
GAAGGTTA	GAAGGGTA
GAATTCAG	GAATTCGT
GAATTCAT	GAATTCGT
GAATTCCC	GATTTCCC
GAATTCCG	GAATTCGT
GAATTCCT	GAATTCGT
GAATTCGA	GAATTCGT
GAATTCGC	GAATTCGT
GAATTCGG	GAATTCGT
GAATTCGT	GAATTCGT
GAATTCGN	GAATTCGT
GAATTCTA	GAATTCGT
GAATTCTC	GAATTCGT
GAAGGNGT	GAAGGGTA
GAGCATTA	GACATTAT
GAATTCTG	GAATTCGT
GAATTCTT	GAATTCGT
GAAGGNTA	GAAGGGTA
GAATTCTN	GAATTCGT
GAATTCNG	GAATTCGT
GAATTCNT	GAATTCGT
GAATTGCG	GAATTCGT
GAANTCGT	GAATTCGT
GAAGTCGG	GAGTCGGT
GAAGTCGT	GAATTCGT
GAATTGGT	GAATTCGT
GAGCCCGT	GACCCGTC
GAAGTGGT	GAAGGGTA
GAAGTGTA	GAAGGGTA
GAATTGTA	GAATTCGT
GAATTGTC	GAATTCGT
GAATTGTG	GAATTCGT
GAATTGTT	GAATTCGT
GAATTGTN	GAATTCGT
GAANTTCG	GAATTCGT
GAAGTTCG	GAATTCGT
GAGCCGGG	GCGCCGGG
GAATTTCC	GATTTCCC
GAGCCGGT	GAGTCGGT
GAGCCGTC	GACCCGTC
GAATTTCG	GAATTCGT
GAATTTGT	GAATTCGT
GAAGTTGC	AAGTTGCG
GAATTNCG	GAATTCGT
GAATTNGT	GAATTCGT
GACCACGT	GACCCGTC
GACCAGAG	CACCAGAG
GACCAGTC	GACCCGTC
GAGCGAAG	GCGCGAAG
GAATNCGT	GAATTCGT
GACCATTA	GACATTAT
GAATNTCG	GAATTCGT
GAGCGGTA	GAGTCGGT
GAGCGGTC	GAGTCGGT
GAGCGGTG	GAGTCGGT
GAGCGGTT	GAGTCGGT
GAGCGGTN	GAGTCGGT
GACCCAGT	GACCCGTC
GACCCATC	GACCCGTC
GACAAATG	GTCAAATG
GACAAATT	GAAAATTT
GAANAATT	GAAAATTT
GACCCCGT	GACCCGTC
GACCCCTC	GACCCGTC
GACCCGAA	ACCCGAAC
GACCCGAC	GACCCGTC
GACCCGAT	GACCCGTC
GACCCGCA	GACCCGTC
GACCCGCC	GACCCGTC
GACCCGCG	GACCCGTC
GACCCGCT	GACCCGTC
GACCCGCN	GACCCGTC
GACCCGGC	GACCCGTC
GACCCGGT	GACCCGTC
GACCCGTA	GACCCGTC
GACCCGTC	GACCCGTC
GACCCGTG	GACCCGTC
GACCCGTT	GACCCGTC
GACCCGTN	GACCCGTC
GACCCGNC	GACCCGTC
GAGTACGG	GAGTCGGT
GACCCGNT	GACCCGTC
GACAATAT	GACATTAT
GACCCTCA	GACCCGTC
GACCCTCC	GACCCGTC
GACCCTCG	GACCCGTC
GACCCTCT	GACCCGTC
GACCCTCN	GACCCGTC
GACCCTGG	AACCCTGG
GACCCTGT	GACCCGTC
GACAATTA	GACATTAT
GACAATTT	GAAAATTT
GACCCTTC	GACCCGTC
GAGTAGAA	GATAGAAA
GAANATTT	GAAAATTT
GAGCTCGG	GAGTCGGT
GACCCNGT	GACCCGTC
GAGTAGGT	GAGTCGGT
GACCCNTC	GACCCGTC
GACCGAAA	GTACCGAA
GACCGAAC	GTACCGAA
GACCGAAG	GTACCGAA
GACCGAAT	GTACCGAA
GACCGAAN	GTACCGAA
GAGNCGGT	GAGTCGGT
GACACATA	GCACATAG
GACACCGT	GACCCGTC
GACCGCGT	GACCCGTC
GACACGTC	GACCCGTC
GACCGGTC	GACCCGTC
GACACTAT	GACATTAT
GACCGTCA	GACCCGTC
GACCGTCC	GACCCGTC
GACCGTCG	GACCCGTC
GACCGTCT	GACCCGTC
GACCGTCN	GACCCGTC
GAGCTTCT	AGCTTCTT
GACNCCGT	GACCCGTC
GACACTTA	GACATTAT
GACCTAAT	GCCTAATA
GAGTCAGG	GAGTCGGT
GAGTCAGT	GAGTCGGT
GACNCGTC	GACCCGTC
GACAGAAA	GATAGAAA
GACAGATC	CACAGATC
GACCTCGT	GACCCGTC
GATATAAA	GATAGAAA
GAGTCCGG	GAGTCGGT
GAGTCCGT	GAGTCGGT
GACCTGTC	GACCCGTC
GACAGGAC	ACAGGACT
GACAGGCT	GTCAGGCT
GACCTTAT	GACATTAT
GACAGGGT	GAAGGGTA
GACCTTCG	CACCTTCG
GATATCCC	GATTTCCC
GACAGTAT	GACATTAT
GAGNTCGG	GAGTCGGT
GATATGAA	GATAGAAA
GACAGTTA	GACATTAT
GAGTCGAG	GAGTCGGT
GAGTCGAT	GAGTCGGT
GATATTAT	GACATTAT
GATATTCC	GATTTCCC
GAGTCGCG	GAGTCGGT
GATATTCG	GAATTCGT
GAGTCGCT	GAGTCGGT
GAGTCGGA	GAGTCGGT
GACATAAT	GACATTAT
GACATAGA	GCACATAG
GACATAGC	GCACATAG
GACATAGG	GCACATAG
GACATAGT	GCACATAG
GAGTCGGC	GAGTCGGT
GACATAGN	GCACATAG
GAGTCGGG	GAGTCGGT
GACATATA	GACATTAT
GACATATC	GACATTAT
GACATATG	GACATTAT
GACATATT	GACATTAT
GACATATN	GACATTAT
GACCNCGT	GACCCGTC
GACATCAT	GACATTAT
GAGTCGGT	GAGTCGGT
GACATCCA	GCATCCAT
GATANAAA	GATAGAAA
GAGTCGGN	GAGTCGGT
GAGTCGTA	GAGTCGGT
GAGTCGTC	GAGTCGGT
GAGTCGTG	GAGTCGGT
GACATCTA	GACATTAT
GAGTCGTT	GAGTCGGT
GAGTCGTN	GAGTCGGT
GAGTCGNG	GAGTCGGT
GAGTCGNT	GAGTCGGT
GAGTCTCA	AGTCTCAG
GACGTCGG	GAGTCGGT
GACATGAT	GACATTAT
GACCNGTC	GACCCGTC
GAGTCTGG	GAGTCGGT
GAGTCTGT	GAGTCGGT
GACATGTA	GACATTAT
GACATTAA	GACATTAT
GACATTAC	GACATTAT
GACATTAG	GACATTAT
GACATTAT	GACATTAT
GACATTAN	GACATTAT
GACATTCA	GACATTAT
GACATTCG	GAATTCGT
GAGTCNGG	GAGTCGGT
GACATTCT	GACATTAT
GAGTCNGT	GAGTCGGT
GACATTGA	GACATTAT
GACATTGT	GACATTAT
GATANGAA	GATAGAAA
GACATTTA	GACATTAT
GACATTTC	GACATTAT
GACATTTG	GACATTAT
GACATTTT	GACATTAT
GACATTTN	GACATTAT
GACATTNA	GACATTAT
GACATTNT	GACATTAT
GACATNAT	GACATTAT
GACGTGTT	GCGTGTTA
GACATNTA	GACATTAT
GACGTTAT	GACATTAT
GAGTGCGG	GAGTCGGT
GAGGCACC	GTGGCACC
GAGTGGGT	GAGTCGGT
GAGTGGTA	GAGTCGGT
GAGTGGTC	GAGTCGGT
GATAAAAA	GATAGAAA
GAGTGGTG	GAGTCGGT
GATAAAAC	GATAGAAA
GAGGCATA	TGAGGCAT
GAGTGGTT	GAGTCGGT
GAGTGGTN	GAGTCGGT
GATAAAAG	GATAGAAA
GAGGCATC	TGAGGCAT
GAGGCATG	TGAGGCAT
GATAAAAT	GATAGAAA
GAGGCATT	TGAGGCAT
GATAAAAN	GATAGAAA
GAGGCATN	TGAGGCAT
GAGTGTTA	GCGTGTTA
GAGGCCGA	AGAGGCCG
GAGGCCGC	AGAGGCCG
GATAAATT	GAAAATTT
GAGGCCGG	AGAGGCCG
GAGGCCGT	AGAGGCCG
GAGGCCGN	AGAGGCCG
GACANTAT	GACATTAT
GACANTTA	GACATTAT
GAGGCGGT	GAGTCGGT
GATCAAAT	GTCAAATG
GAGGCTTA	AGGCTTAA
GATAAGAA	GATAGAAA
GACNTTAT	GACATTAT
GACGATAC	ACGATACG
GATAAGGG	TATAAGGG
GACGATTA	GACATTAT
GATCAGAA	GATAGAAA
GAGTTCCC	GATTTCCC
GAGTTCGG	GAGTCGGT
GAGTTCGT	GAATTCGT
GATCAGGC	GTCAGGCT
GATAATTT	GAAAATTT
GANTTCCC	GATTTCCC
GANTTCGT	GAATTCGT
GATCATTA	GACATTAT
GATACAAA	GATAGAAA
GAGTTGCG	AAGTTGCG
GACGCCCA	TACGCCCA
GACTAAGC	ACTAAGCG
GACTAATA	GCCTAATA
GAGTTGGT	GAGTCGGT
GACGCCGG	GCGCCGGG
GACGCCGT	GACCCGTC
GAGTTTAA	CGAGTTTA
GAGTTTAC	CGAGTTTA
GACGCGAA	GCGCGAAG
GAGTTTAG	CGAGTTTA
GAGTTTAT	CGAGTTTA
GAGTTTAN	CGAGTTTA
GAGTTTCC	GATTTCCC
GANTTTCC	GATTTCCC
GATCCATA	GCATCCAT
GACGCGTC	GACCCGTC
GATCCATC	GCATCCAT
GATCCATG	GCATCCAT
GATCCATT	GCATCCAT
GATCCATN	GCATCCAT
GACTAGAA	GATAGAAA
GATACCGA	GTACCGAA
GATGGAAA	GATAGAAA
GACTAGCT	GCTAGCTC
GATCCCGT	GACCCGTC
GACTAGTT	CACTAGTT
GATACGAA	GATAGAAA
GATGGCAC	GTGGCACC
GATCCGCC	ATCCGCCA
GACTATTA	GACATTAT
GATCCGTC	GACCCGTC
GATGGGCT	ATGGGCTA
GATGGGTA	GAAGGGTA
GATCGAAA	GATAGAAA
GATCGACT	ATCGACTT
GATAGAAA	GATAGAAA
GATAGAAC	GATAGAAA
GATAGAAG	GATAGAAA
GAGTNCGG	GAGTCGGT
GATAGAAT	GATAGAAA
GATAGAAN	GATAGAAA
GATAGACA	GATAGAAA
GACGGGTA	GAAGGGTA
GAGTNGGT	GAGTCGGT
GACTCCGT	GACCCGTC
GATAGAGA	GATAGAAA
GATAGATA	GATAGAAA
GATAGANA	GATAGAAA
GATAGCAA	GATAGAAA
GATGTCCC	GATTTCCC
GATGTCGC	ATGTCGCT
GATGTCGG	GAGTCGGT
GAGAAATT	GAAAATTT
GATAGCTC	GCTAGCTC
GACGGTAT	TACGGTAT
GATAGCTT	AATAGCTT
GATAGGAA	GATAGAAA
GATCGGAA	ATCGGAAA
GACTCGGT	GAGTCGGT
GACTCGTC	GACCCGTC
GATAGGGT	GAAGGGTA
GATCGGTA	GAGTCGGT
GATAGTAA	GATAGAAA
GATGTTCC	GATTTCCC
GATCGGTC	GAGTCGGT
GATCGGTG	GAGTCGGT
GATCGGTT	GAGTCGGT
GATCGGTN	GAGTCGGT
GCAACAAC	TCAACAAC
GATAGNAA	GATAGAAA
GCAACATA	GCACATAG
GCAACCAT	GCATCCAT
GATTNCCC	GATTTCCC
GCACNATA	GCACATAG
GAGAATTT	GAAAATTT
GATCTCCC	GATTTCCC
GCAAGCTC	GCTAGCTC
GATCTTCC	GATTTCCC
GATTNTCC	GATTTCCC
GCAAGGGT	GAAGGGTA
GCACNTAG	GCACATAG
GCAAGGTC	CAAGGTCC
GATTAAAG	GTTTAAAG
GACTTATA	GACATTAT
GACTTATC	GACATTAT
GACTTATG	GACATTAT
GACTTATT	GACATTAT
GACTTATN	GACATTAT
GACTTCCC	GATTTCCC
GAGACGGT	GAGTCGGT
GACTTCGT	GAATTCGT
GATNAGAA	GATAGAAA
GATTACCC	GATTTCCC
GCAATAGA	GCACATAG
GCAATAGC	GCACATAG
GCAATAGG	GCACATAG
GCAATAGT	GCACATAG
GCAATAGN	GCACATAG
GCAATCCA	GCATCCAT
GACTTTAT	GACATTAT
GATGAAAA	GATAGAAA
GATGAAAC	GATAGAAA
GACTTTCC	GATTTCCC
GATGAAAG	GATAGAAA
GATGAAAT	GATAGAAA
GATGAAAN	GATAGAAA
GATTAGAA	GATAGAAA
GATTATAT	ATTATATC
GATTATCC	GATTTCCC
GCAATTCG	GAATTCGT
GATGACCG	AATGACCG
GATGAGAA	GATAGAAA
GCAGATAA	CAGATAAT
GCAGATAG	GCACATAG
GATTCAAC	ATTCAACC
GATNGAAA	GATAGAAA
GATTCCCA	GATTTCCC
GAGAGAAA	GATAGAAA
GATTCCCC	GATTTCCC
GATTCCCG	GATTTCCC
GATTCCCT	GATTTCCC
GATTCCCN	GATTTCCC
GATTCCTG	ATTCCTGA
GATTCGGT	GAGTCGGT
GATTCGTA	GAATTCGT
GCATGCAT	GCATCCAT
GATTCGTC	GAATTCGT
GATTCGTG	GAATTCGT
GCATGCCA	GCATCCAT
GATTCGTT	GAATTCGT
GATTCGTN	GAATTCGT
GATTCTCC	GATTTCCC
GCAGCATA	GCACATAG
GCAGCCAT	GCATCCAT
GCAGCCGG	GCGCCGGG
GAGAGGCC	AGAGGCCG
GCAGCGAA	GCGCGAAG
GATTGAAA	GATAGAAA
GAGAGGGT	GAAGGGTA
GATTGACT	GTTTGACT
GCATGTTA	GCGTGTTA
GATNTCCC	GATTTCCC
GCAGCTCA	GCTAGCTC
GCAGCTCC	GCTAGCTC
GCAGCTCG	GCTAGCTC
GATTGCCC	GATTTCCC
GCAGCTCT	GCTAGCTC
GCAGCTCN	GCTAGCTC
GATTGGCG	TATTGGCG
GCATTATA	GACATTAT
GCATTATC	GACATTAT
GCATTATG	GACATTAT
GCATTATT	GACATTAT
GCATTATN	GACATTAT
GCATTCAT	GCATCCAT
GATNTTCC	GATTTCCC
GCATTCCA	GCATCCAT
GATTGTCC	GATTTCCC
GACNATTA	GACATTAT
GCATTCGT	GAATTCGT
GCAGGACT	ACAGGACT
GCACAAAG	GCACATAG
GCACAAGA	GCACATAG
GCACAAGC	GCACATAG
GCACAAGG	GCACATAG
GCACAAGT	GCACATAG
GCACAAGN	GCACATAG
GCACAATA	GCACATAG
GCATTGTC	CCATTGTC
GAGATAAT	CAGATAAT
GCACACAG	GCACATAG
GCAGGCTA	GTCAGGCT
GANAGAAA	GATAGAAA
GCAGGCTC	GTCAGGCT
GCAGGCTG	GTCAGGCT
GCAGGCTT	GTCAGGCT
GCAGGCTN	GTCAGGCT
GCATTTCC	GATTTCCC
GATTTAAA	GTTTAAAG
GCACACTA	GCACATAG
GATTTACC	GATTTCCC
GCACAGAG	GCACATAG
GCACAGAT	CACAGATC
GCAGGGTA	GAAGGGTA
GATTTCAC	GATTTCCC
GCACAGTA	GCACATAG
GATTTCCA	GATTTCCC
GATTTCCC	GATTTCCC
GAGATCGG	GAGTCGGT
GATTTCCG	GATTTCCC
GATTTCCT	GATTTCCC
GATTTCCN	GATTTCCC
GATTTCGC	GATTTCCC
GCACATAA	GCACATAG
GATTTCGT	GAATTCGT
GCACATAC	GCACATAG
GCACATAG	GCACATAG
GCACATAT	GCACATAG
GATTTCTC	GATTTCCC
GCACATAN	GCACATAG
GCACATCA	GCACATAG
GCACATCG	GCACATAG
GATTTCNC	GATTTCCC
GCACATGA	GCACATAG
GCACATGC	GCACATAG
GCACATGG	GCACATAG
GCACATGT	GCACATAG
GCACATGN	GCACATAG
GATTTGAC	GTTTGACT
GCACATTG	GCACATAG
GATTTGCC	GATTTCCC
GCACATNA	GCACATAG
GCACATNG	GCACATAG
GCACANAG	GCACATAG
GCATNCAT	GCATCCAT
GAGATTAT	GACATTAT
GANAGGGT	GAAGGGTA
GCATNCCA	GCATCCAT
GAGATTCG	GAATTCGT
GCACANTA	GCACATAG
GATTTTCC	GATTTCCC
GCACCAGA	CACCAGAG
GATTTNCC	GATTTCCC
GCACCATC	GCATCCAT
GCAAAATT	GAAAATTT
GCACCATG	GCATCCAT
GCACCATT	GCATCCAT
GCACCATN	GCATCCAT
GCACCCAT	GCATCCAT
GCCAAAGA	CCAAAGAG
GCCAAATA	GCCTAATA
GCCAAATG	GTCAAATG
GCACCCGT	GACCCGTC
GCACCGAA	GTACCGAA
GCACCGGG	GCGCCGGG
GCAAAGAG	CCAAAGAG
GCCAATAA	GCCTAATA
GCCAATAC	GCCTAATA
GCACCTAG	GCACATAG
GCCAATAG	GCCTAATA
GCCAATAT	GCCTAATA
GCCAATAN	GCCTAATA
GCAAAGGA	AGCAAAGG
GCAAAGGC	AGCAAAGG
GCAGTCCA	GCATCCAT
GCACCTTC	CACCTTCG
GCCAATTT	CCCAATTT
GCAGTCGG	GAGTCGGT
GANAAATT	GAAAATTT
GCAAAGGG	AGCAAAGG
GCAAAGGT	AGCAAAGG
GCAAAGGN	AGCAAAGG
GCACGAAG	GCGCGAAG
GANATTAT	GACATTAT
GCAGTGTT	GCGTGTTA
GANATTCG	GAATTCGT
GCACGATA	GCACATAG
GCCACATA	GCACATAG
GCAAATAG	GCACATAG
GCANATAG	GCACATAG
GCCACCGT	CCCACCGT
GCAAATGA	GTCAAATG
GCAAATGC	GTCAAATG
GCAAATGG	GTCAAATG
GCAAATGT	GTCAAATG
GCAAATGN	GTCAAATG
GCAAATTG	CAAATTGG
GCAAATTT	GAAAATTT
GCACGTAG	GCACATAG
GANAATTT	GAAAATTT
GCANCATA	GCACATAG
GCGCGAAA	GCGCGAAG
GCGCGAAC	GCGCGAAG
GCGCGAAG	GCGCGAAG
GCGCGAAT	GCGCGAAG
GCGCGAAN	GCGCGAAG
GCGCGACA	GCGCGAAG
GCGCGACG	GCGCGAAG
GCANCCAT	GCATCCAT
GCGCGAGA	GCGCGAAG
GCGCGAGC	GCGCGAAG
GCGCGAGG	GCGCGAAG
GCGCGAGT	GCGCGAAG
GCGCGAGN	GCGCGAAG
GCGCGATA	GCGCGAAG
GANGGGTA	GAAGGGTA
GCGCGATG	GCGCGAAG
GCGCGANA	GCGCGAAG
GCGCGANG	GCGCGAAG
GCGCGCAA	GCGCGAAG
GCGCGCAG	GCGCGAAG
GCGCGCGG	GCGCCGGG
GCACTAAT	GCCTAATA
GCATAATA	GCCTAATA
GCGCGGAA	GCGCGAAG
GCATACAT	GCATCCAT
GCGCGGAG	GCGCGAAG
GCATACCA	GCATCCAT
GCGCGGGA	GCGCCGGG
GCGCGGGC	GCGCCGGG
GCACTAGA	GCACATAG
GCGCGGGG	GCGCCGGG
GCACTAGC	GCACATAG
GCGCGGGT	GCGCCGGG
GCACTAGG	GCACATAG
GCGCGGGN	GCGCCGGG
GCACTAGN	GCACATAG
GCACTATA	GCACATAG
GCATAGAA	GATAGAAA
GCGCGTAA	GCGCGAAG
GCGCGTAG	GCGCGAAG
GCATAGCT	GCTAGCTC
GCCAGCTC	GCTAGCTC
GCATATAG	GCACATAG
GCACTCCA	GCATCCAT
GCGCGTTA	GCGTGTTA
GCCAGGCT	GTCAGGCT
GANGTCGG	GAGTCGGT
GCGCGNAA	GCGCGAAG
GCGCGNAG	GCGCGAAG
GCCCTAAT	GCCTAATA
GCACTTAG	GCACATAG
GANCATTA	GACATTAT
GCGCTAAG	GCGCGAAG
GCGCTAAT	GCCTAATA
GCATCAAT	GCATCCAT
GCATCACA	GCATCCAT
GCATCATC	GCATCCAT
GCATCATG	GCATCCAT
GCATCATT	GCATCCAT
GCATCATN	GCATCCAT
GCGTAATA	GCCTAATA
GCATCCAA	GCATCCAT
GCATCCAC	GCATCCAT
GCATCCAG	GCATCCAT
GCATCCAT	GCATCCAT
GCATCCAN	GCATCCAT
GCATCCCA	GCATCCAT
GCATCCCT	GCATCCAT
GCATCCGA	GCATCCAT
GCATCCGT	GCATCCAT
GCATCCTA	GCATCCAT
GCGCTCGG	GCGCCGGG
GCATCCTC	GCATCCAT
GCATCCTG	GCATCCAT
GCATCCTT	GCATCCAT
GCATCCTN	GCATCCAT
GCCATAAT	GCCTAATA
GCATCCNA	GCATCCAT
GCATCCNT	GCATCCAT
GCATCGAT	GCATCCAT
GCATCGCA	GCATCCAT
GCCATAGA	GCACATAG
GCCATAGC	GCACATAG
GCCATAGG	GCACATAG
GCCATAGT	GCACATAG
GCGCTGAA	GCGCGAAG
GCCATAGN	GCACATAG
GCGCTGGG	GCGCCGGG
GCANTCCA	GCATCCAT
GCATCTAT	GCATCCAT
GCATCTCA	GCATCCAT
GCGCTGTT	GCGTGTTA
GCCATCCA	GCATCCAT
GCATCNAT	GCATCCAT
GANCCCGT	GACCCGTC
GCATCNCA	GCATCCAT
GCGTAGCT	GCTAGCTC
GCCATGTA	TGCCATGT
GCCATGTC	TGCCATGT
GCCATGTG	TGCCATGT
GCCATGTT	TGCCATGT
GCCATGTN	TGCCATGT
GCGTAGTT	GCGTGTTA
GCCATTAT	GACATTAT
GCCATTGT	CCATTGTC
GCGTATTA	GCGTGTTA
GANCCGTC	GACCCGTC
GCGNTGTT	GCGTGTTA
GCGCNAAG	GCGCGAAG
GCCGAAGA	GCGCGAAG
GCCGAAGC	GCGCGAAG
GCCGAAGG	GCGCGAAG
GCCGAAGT	GCGCGAAG
GCCGAAGN	GCGCGAAG
GCCGAATA	GCCTAATA
GCGCNCGG	GCGCCGGG
GCCGACGG	CCGACGGA
GCGTCCAT	GCATCCAT
GCGCNGAA	GCGCGAAG
GCGTCCGG	GCGCCGGG
GCGCNGGG	GCGCCGGG
GCGTCGAA	GCGCGAAG
GANTAGAA	GATAGAAA
GCGTCGGG	GCGCCGGG
GCGTCGGT	GAGTCGGT
GCGTCGTT	GCGTGTTA
GCCCAATA	GCCTAATA
GCCCAATT	CCCAATTT
GCGTCTGG	TCGTCTGG
GCGTCTTA	GCGTGTTA
GCCCACCG	CCCACCGT
GCGGAAGA	GCGCGAAG
GCGGAAGC	GCGCGAAG
GCGGAAGG	GCGCGAAG
GCGGAAGT	GCGCGAAG
GCGGAAGN	GCGCGAAG
GCCGCCCT	CCGCCCTA
GCCGCCGG	GCGCCGGG
GCGTGAAG	GCGCGAAG
GCCGCGAA	GCGCGAAG
GCCCATAG	GCACATAG
GCGTGATA	GCGTGTTA
GCGTGATT	GCGTGTTA
GCTCCATA	GCATCCAT
GCTCCATC	GCATCCAT
GCTCCATG	GCATCCAT
GCTCCATT	GCATCCAT
GCTCCATN	GCATCCAT
GCGTGCTA	GCGTGTTA
GCGTGCTT	GCGTGTTA
GCTCCGGG	GCGCCGGG
GCTAAATA	TGCTAAAT
GCTAAATC	TGCTAAAT
GCTAAATG	TGCTAAAT
GCTAAATT	TGCTAAAT
GCTAAATN	TGCTAAAT
GCGTGGTA	GCGTGTTA
GCTAACTC	GCTAGCTC
GCGGCACC	GTGGCACC
GANTCGGT	GAGTCGGT
GCTAAGCG	ACTAAGCG
GCTAAGCT	GCTAGCTC
GCGTGGTT	GCGTGTTA
GCGTGTAA	GCGTGTTA
GCTAATAA	GCCTAATA
GCGTGTAC	GCGTGTTA
GCTAATAC	GCCTAATA
GCGTGTAG	GCGTGTTA
GCTAATAG	GCCTAATA
GCGTGTAT	GCGTGTTA
GCTAATAT	GCCTAATA
GCTAATAN	GCCTAATA
GCGGCCGG	GCGCCGGG
GCTCGAAG	GCGCGAAG
GCGGCGAA	GCGCGAAG
GCGTGTAN	GCGTGTTA
GCGTGTCA	GCGTGTTA
GCGTGTCT	GCGTGTTA
GCGTGTGA	GCGTGTTA
GCGTGTGT	GCGTGTTA
GCGTGTTA	GCGTGTTA
GCGTGTTC	GCGTGTTA
GCGTGTTG	GCGTGTTA
GCGTGTTT	GCGTGTTA
GCTCGCTC	GCTAGCTC
GCGTGTTN	GCGTGTTA
GCGTGTNA	GCGTGTTA
GCTACATA	GCACATAG
GCGTGTNT	GCGTGTTA
GCGGCGGG	GCGCCGGG
GCTACCGA	GTACCGAA
GCGTGNTA	GCGTGTTA
GCTACCTC	GCTAGCTC
GCGTGNTT	GCGTGTTA
GCTACGCT	GCTAGCTC
GCCCCGGG	GCGCCGGG
GCCGGGCG	CCGGGCGT
GCCCCGTC	GACCCGTC
GCTACTCA	GCTAGCTC
GCTACTCC	GCTAGCTC
GCTACTCG	GCTAGCTC
GCTACTCT	GCTAGCTC
GCTACTCN	GCTAGCTC
GCTAGAAA	GATAGAAA
GCTAGACT	GCTAGCTC
GCGTTGAA	CCGTTGAA
GCTAGATC	GCTAGCTC
GCTAGCAC	GCTAGCTC
GCCGTAAT	GCCTAATA
GCGGGAAC	CGGGAACC
GCGTTGTT	GCGTGTTA
GCTAGCAT	GCTAGCTC
GCGGGAAG	GCGCGAAG
GCGTTTAA	GCGTGTTA
GCTAGCCA	GCTAGCTC
GCTAGCCC	GCTAGCTC
GCGTTTAC	GCGTGTTA
GCTAGCCG	GCTAGCTC
GCGTTTAG	GCGTGTTA
GCTAGCCT	GCTAGCTC
GCGTTTAT	GCGTGTTA
GCTAGCCN	GCTAGCTC
GCGTTTAN	GCGTGTTA
GCTAGCGC	GCTAGCTC
GCTAGCGT	GCTAGCTC
GCTAGCTA	GCTAGCTC
GCTAGCTC	GCTAGCTC
GCTAGCTG	GCTAGCTC
GCTAGCTT	GCTAGCTC
GCTAGCTN	GCTAGCTC
GCTAGCNC	GCTAGCTC
GCTAGCNT	GCTAGCTC
GCGTTTTA	GCGTGTTA
GCTAGGCT	GCTAGCTC
GCTCTAAT	GCCTAATA
GCTAGGTC	GCTAGCTC
GCCCGAAC	ACCCGAAC
GCCCGAAG	GCGCGAAG
GCGGGCGT	CCGGGCGT
GCTAGTCA	GCTAGCTC
GCTAGTCC	GCTAGCTC
GCTAGTCG	GCTAGCTC
GCCGTGTT	GCGTGTTA
GCTAGTCT	GCTAGCTC
GCTAGTCN	GCTAGCTC
GCTAGTTC	GCTAGCTC
GCTCTCCA	CTCTCCAT
GCCGTTGA	CCGTTGAA
GCCCGGCT	TCCCGGCT
GCGTNGTT	GCGTGTTA
GCCCGGGA	GCGCCGGG
GCCCGGGC	GCGCCGGG
GCCCGGGG	GCGCCGGG
GCCCGGGT	GCGCCGGG
GCCCGGGN	GCGCCGGG
GCTAGNCT	GCTAGCTC
GCTAGNTC	GCTAGCTC
GCCCGTCA	GACCCGTC
GCCCGTCC	GACCCGTC
GCCCGTCG	GACCCGTC
GCCCGTCT	GACCCGTC
GCGTNTTA	GCGTGTTA
GCCCGTCN	GACCCGTC
GCGGGTAG	CGGGTAGG
GCGGGTTA	GCGTGTTA
GCTCTTTA	CTCTTTAA
GCTATCCA	GCATCCAT
GCTATCTC	GCTAGCTC
GCTATGCA	CTATGCAA
GCTATGCT	GCTAGCTC
GCGGTGTT	GCGTGTTA
GCCTAAAA	GCCTAATA
GCGGTTAA	GCGTGTTA
GCCTAAAC	GCCTAATA
GCGGTTAC	GCGTGTTA
GCCTAAAG	GCCTAATA
GCGGTTAG	GCGTGTTA
GCCTAAAT	GCCTAATA
GCGGTTAT	GCGTGTTA
GCCTAAAN	GCCTAATA
GCGGTTAN	GCGTGTTA
GCCTAACA	GCCTAATA
GCCTAACT	GCCTAATA
GCCTAAGA	GCCTAATA
GCCTAAGT	GCCTAATA
GCCTAATA	GCCTAATA
GCCTAATC	GCCTAATA
GCCTAATG	GCCTAATA
GCCTAATT	GCCTAATA
GCCTAATN	GCCTAATA
GCCTAANA	GCCTAATA
GCCTAANT	GCCTAATA
GCCTACAT	GCCTAATA
GCCTCAAT	GCCTAATA
GCTTAAAG	GTTTAAAG
GCCTCATA	GCCTAATA
GCGACATA	GCACATAG
GCTTAATA	GCCTAATA
GCTTAATG	CTTAATGA
GCCTCCAT	GCATCCAT
GCCTACTA	GCCTAATA
GCGACCGG	GCGCCGGG
GCTTACCG	CTTACCGG
GCCTAGAT	GCCTAATA
GCGACGAA	GCGCGAAG
GCTANCTC	GCTAGCTC
GCCTAGCG	TCCTAGCG
GCCTAGCT	GCTAGCTC
GCGACGGA	CCGACGGA
GCGNCCGG	GCGCCGGG
GCGACGGG	GCGCCGGG
GCCTAGTA	GCCTAATA
GCTTAGCT	GCTAGCTC
GCTANGCT	GCTAGCTC
GCGNCGAA	GCGCGAAG
GCCTCTCT	TCCTCTCT
GCGNCGGG	GCGCCGGG
GCCTATAA	GCCTAATA
GCCTATAC	GCCTAATA
GCCTATAG	GCCTAATA
GCCTATAT	GCCTAATA
GCCTATAN	GCCTAATA
GCCTATTA	GCCTAATA
GCGAGAAG	GCGCGAAG
GCCTGAAT	GCCTAATA
GCTCAAAT	GTCAAATG
GCCTGATA	GCCTAATA
GCGNGAAG	GCGCGAAG
GCCTANAT	GCCTAATA
GCGAGCTC	GCTAGCTC
GCCTANTA	GCCTAATA
GCTCAGCT	GCTAGCTC
GCCTGGTA	CCTGGTAC
GCTTCCAT	GCATCCAT
GCTCAGGC	GTCAGGCT
GCGAGTCC	TCGAGTCC
GCGAGTTA	GCGTGTTA
GCTCATAG	GCACATAG
GCCTGTTA	GCGTGTTA
GCGAGTTT	CGAGTTTA
GCGNGTTA	GCGTGTTA
GCTNGCTC	GCTAGCTC
GCCTTAAT	GCCTAATA
GCTTCTTA	AGCTTCTT
GCTTCTTC	AGCTTCTT
GCTTCTTG	AGCTTCTT
GCTTCTTT	AGCTTCTT
GCTTCTTN	AGCTTCTT
GCCTTATA	GCCTAATA
GCGATACG	ACGATACG
GGAGGCAT	TGAGGCAT
GCTTGACT	GTTTGACT
GGAGGCCG	AGAGGCCG
GCGATCCA	GCATCCAT
GGAGGGTA	GAAGGGTA
GCTTGCTC	GCTAGCTC
GCTGAGCT	GCTAGCTC
GCCTNAAT	GCCTAATA
GCGATGTT	GCGTGTTA
GCCTNATA	GCCTAATA
GCTTGTTA	GCGTGTTA
GGAGTCGG	GAGTCGGT
GGAGTTTA	CGAGTTTA
GGACATAG	GCACATAG
GGACATTA	GACATTAT
GCTTTAAA	GTTTAAAG
GCCNAATA	GCCTAATA
GCTGCCGG	GCGCCGGG
GCTGCGAA	GCGCGAAG
GGACCCGT	GACCCGTC
GGACCGAA	GTACCGAA
GCTTTCCC	GATTTCCC
GCTTTGAC	GTTTGACT
GCTGCTCA	GCTAGCTC
GCTGCTCC	GCTAGCTC
GCTGCTCG	GCTAGCTC
GCTGCTCT	GCTAGCTC
GCTGCTCN	GCTAGCTC
GGATAGAA	GATAGAAA
GCNACATA	GCACATAG
GCGCAAAG	GCGCGAAG
GCGCAAGA	GCGCGAAG
GCGCAAGC	GCGCGAAG
GCGCAAGG	GCGCGAAG
GCGCAAGT	GCGCGAAG
GCGCAAGN	GCGCGAAG
GCTGGCAC	GTGGCACC
GCGCACGG	GCGCCGGG
GCTGGCTC	GCTAGCTC
GCGCAGAA	GCGCGAAG
GGATCCAT	GCATCCAT
GCGCAGGG	GCGCCGGG
GCGCATAG	GCACATAG
GCTGGTAC	CCTGGTAC
GCCNTAAT	GCCTAATA
GCGCCAAG	GCGCGAAG
GCGCCAGG	GCGCCGGG
GCTNAGCT	GCTAGCTC
GCNAGCTC	GCTAGCTC
GCTGTAGT	CTGTAGTC
GCGCCCGG	GCGCCGGG
GCGCCCTA	CCGCCCTA
GCGCCGAA	GCGCGAAG
GCGCCGAG	GCGCCGGG
GCGCCGCG	GCGCCGGG
GCGCCGGA	GCGCCGGG
GGAAAATT	GAAAATTT
GCTGTGTT	GCGTGTTA
GCTGTTAA	GCGTGTTA
GCTGTTAC	GCGTGTTA
GCTGTTAG	GCGTGTTA
GCTGTTAT	GCGTGTTA
GCGCCGGC	GCGCCGGG
GCGCCGGG	GCGCCGGG
GCGCCGGT	GCGCCGGG
GCGCCGGN	GCGCCGGG
GCGCCGTG	GCGCCGGG
GCGCCGNG	GCGCCGGG
GCTGTTAN	GCGTGTTA
GCNATCCA	GCATCCAT
GCGCCTGG	GCGCCGGG
GGATTCGT	GAATTCGT
GGAAATTT	GAAAATTT
GGATTTCC	GATTTCCC
GCGCCNGG	GCGCCGGG
GGCATCCA	GCATCCAT
GCNCATAG	GCACATAG
GGCATTAT	GACATTAT
GCNGTGTT	GCGTGTTA
GGTACCGA	GTACCGAA
GCNCCGGG	GCGCCGGG
GGAAGGGT	GAAGGGTA
GGAGACTA	TGGAGACT
GGAGACTC	TGGAGACT
GGAGACTG	TGGAGACT
GGAGACTT	TGGAGACT
GGAGACTN	TGGAGACT
GCNCGAAG	GCGCGAAG
GGCGCCGG	GCGCCGGG
GGCGCGAA	GCGCGAAG
GGTAGAAA	GATAGAAA
GGTAGCTC	GCTAGCTC
GGCCATGT	TGCCATGT
GCNTAATA	GCCTAATA
GCNCTAAT	GCCTAATA
GCNTAGCT	GCTAGCTC
GGCGTGTT	GCGTGTTA
GGAATTCG	GAATTCGT
GGCCCGTC	GACCCGTC
GCNTCCAT	GCATCCAT
GGGGAACC	CGGGAACC
GGCTAAAT	TGCTAAAT
GGCCGGGA	GCGCCGGG
GGCCGGGC	GCGCCGGG
GGCCGGGG	GCGCCGGG
GGCCGGGT	GCGCCGGG
GGCCGGGN	GCGCCGGG
GGCTAATA	GCCTAATA
GCNTGTTA	GCGTGTTA
GGTCAAAT	GTCAAATG
GGCTAGCT	GCTAGCTC
GGTCAGGC	GTCAGGCT
GGGGCACC	GTGGCACC
GGCCTAAT	GCCTAATA
GGCAAAGG	AGCAAAGG
GGCAAATG	GTCAAATG
GCNGCCGG	GCGCCGGG
GGCACATA	GCACATAG
GCNGCGAA	GCGCGAAG
GGGGTAGG	CGGGTAGG
GGTCGGTA	GAGTCGGT
GGTCGGTC	GAGTCGGT
GGTCGGTG	GAGTCGGT
GGTCGGTT	GAGTCGGT
GGTCGGTN	GAGTCGGT
GGCAGGCT	GTCAGGCT
GGGAGACT	TGGAGACT
GGCGAAGA	GCGCGAAG
GGCGAAGC	GCGCGAAG
GGCGAAGG	GCGCGAAG
GGCGAAGT	GCGCGAAG
GGCGAAGN	GCGCGAAG
GGCTTAAA	AGGCTTAA
GGCTTAAC	AGGCTTAA
GGCTTAAG	AGGCTTAA
GGCTTAAT	AGGCTTAA
GGCTTAAN	AGGCTTAA
GGTCTCAG	AGTCTCAG
GGCTTCTT	AGCTTCTT
GGTTGACT	GTTTGACT
GGGTAGGA	CGGGTAGG
GGGTAGGC	CGGGTAGG
GGGTAGGG	CGGGTAGG
GGGTAGGT	CGGGTAGG
GGGTAGGN	CGGGTAGG
GTATAAAG	GTTTAAAG
GTATAAGG	TATAAGGG
GTATAGAA	GATAGAAA
GGTTTAAA	GTTTAAAG
GGTTTCCC	GATTTCCC
GGGTCGGT	GAGTCGGT
GGTTTGAC	GTTTGACT
GGTTTTGC	TGTTTTGC
GTATCACT	TTATCACT
GTATCCAT	GCATCCAT
GGGCACCA	GTGGCACC
GGGCACCC	GTGGCACC
GGGCACCG	GTGGCACC
GTATCCGA	GTACCGAA
GGGCACCT	GTGGCACC
GGGCACCN	GTGGCACC
GGTGGCAC	GTGGCACC
GGGTGGTT	AGGTGGTT
GTATCGAA	GTACCGAA
GGTGGGGT	TGTGGGGT
GGGTGTTA	GCGTGTTA
GGTGGTTA	AGGTGGTT
GGTGGTTC	AGGTGGTT
GGTGGTTG	AGGTGGTT
GGTGGTTT	AGGTGGTT
GGTGGTTN	AGGTGGTT
GTATGACT	GTTTGACT
GTATGCAA	CTATGCAA
GTACGAAA	GTACCGAA
GTACGAAC	GTACCGAA
GTACGAAG	GTACCGAA
GTACGAAT	GTACCGAA
GTACGAAN	GTACCGAA
GTACGCCC	TACGCCCA
GGGCCGGG	GCGCCGGG
GTACGCGA	GTACCGAA
GTACGGAA	GTACCGAA
GGTGTCGA	TGTGTCGA
GTACGGTA	TACGGTAT
GTAAAATG	GTCAAATG
GTAAAATT	GAAAATTT
GGTGTTAA	GCGTGTTA
GGTGTTAC	GCGTGTTA
GGTGTTAG	GCGTGTTA
GGTGTTAT	GCGTGTTA
GGTGTTAN	GCGTGTTA
GTATTAAA	GTTTAAAG
GGGCGAAG	GCGCGAAG
GTACTCGA	GTACCGAA
GTAAATGA	GTCAAATG
GTAAATGC	GTCAAATG
GTAAATGG	GTCAAATG
GTAAATGT	GTCAAATG
GTAAATGN	GTCAAATG
GTAAATTT	GAAAATTT
GTATTCGT	GAATTCGT
GTACTGAA	GTACCGAA
GTATTGAC	GTTTGACT
GTATTGGC	TATTGGCG
GTATTTCC	GATTTCCC
GTAACCAG	TAACCAGC
GTAACCGA	GTACCGAA
GTAACGAA	GTACCGAA
GGGAACCA	CGGGAACC
GGGAACCC	CGGGAACC
GGGAACCG	CGGGAACC
GGGAACCT	CGGGAACC
GGGAACCN	CGGGAACC
GTACNCGA	GTACCGAA
GTACNGAA	GTACCGAA
GGTTAAAG	GTTTAAAG
GTAAGATC	TAAGATCG
GGGCTTAA	AGGCTTAA
GTAGAAAA	GATAGAAA
GTAGAAAC	GATAGAAA
GTAGAAAG	GATAGAAA
GTAGAAAT	GATAGAAA
GTAGAAAN	GATAGAAA
GTAAGGCT	GTCAGGCT
GTAAGGGT	GAAGGGTA
GTAGCACC	GTGGCACC
GTAGCCGA	GTACCGAA
GTAGCGAA	GTACCGAA
GTANCCGA	GTACCGAA
GTAGCTCA	GCTAGCTC
GTAGCTCC	GCTAGCTC
GTAGCTCG	GCTAGCTC
GTANCGAA	GTACCGAA
GTAGCTCT	GCTAGCTC
GTAGCTCN	GCTAGCTC
GTAATTAC	TAATTACA
GTAATTCG	GAATTCGT
GTAGGACG	TTAGGACG
GTAGGCAC	GTGGCACC
GTAGGCTA	GTCAGGCT
GTAGGCTC	GTCAGGCT
GTAGGCTG	GTCAGGCT
GTAGGCTT	GTCAGGCT
GTAGGCTN	GTCAGGCT
GTCCCGAA	GTACCGAA
GTCCCGGC	TCCCGGCT
GTCCCGTC	GACCCGTC
GTAGGGTA	GAAGGGTA
GTCCGAAA	GTACCGAA
GTCCGAAC	GTACCGAA
GTCCGAAG	GTACCGAA
GTCCGAAT	GTACCGAA
GTCCGAAN	GTACCGAA
GTCCGCCA	ATCCGCCA
GTCCGGCT	GTCAGGCT
GTACAAAT	GTCAAATG
GTACACGA	GTACCGAA
GTCCTAAT	GCCTAATA
GTCCTAGC	TCCTAGCG
GTTCAAAG	GTTTAAAG
GTTCAAAT	GTCAAATG
GTTCAACC	ATTCAACC
GTCCTCTC	TCCTCTCT
GTACAGAA	GTACCGAA
GTAGTCGG	GAGTCGGT
GTACAGGC	GTCAGGCT
GTACATAG	GCACATAG
GTTCAGGC	GTCAGGCT
GTACATTA	GACATTAT
GTCTAAAG	GTTTAAAG
GTCTAAAT	GTCAAATG
GTCAAAAG	GTCAAATG
GTCAAAAT	GTCAAATG
GTCAAACG	GTCAAATG
GTCAAACT	GTCAAATG
GTCAAAGA	GTCAAATG
GTCAAAGC	GTCAAATG
GTCAAAGG	GTCAAATG
GTCAAAGT	GTCAAATG
GTCAAAGN	GTCAAATG
GTCAAATA	GTCAAATG
GTCAAATC	GTCAAATG
GTCAAATG	GTCAAATG
GTCAAATT	GTCAAATG
GTCAAATN	GTCAAATG
GTCAAANG	GTCAAATG
GTCAAANT	GTCAAATG
GTCTAATA	GCCTAATA
GTCAACAA	TCAACAAC
GTCTAATG	GTCAAATG
GTCAACAT	GTCAAATG
GTACCAAA	GTACCGAA
GTCAACTG	GTCAAATG
GTCAAGAT	GTCAAATG
GTACCAAC	GTACCGAA
GTACCAAG	GTACCGAA
GTACCAAT	GTACCGAA
GTACCAAN	GTACCGAA
GTCAAGCT	GTCAGGCT
GTCAAGGC	GTCAGGCT
GTACCAGA	GTACCGAA
GTCAAGTG	GTCAAATG
GTTCCAAA	TTCCAAAA
GTCTAGCT	GCTAGCTC
GTCAATAT	GTCAAATG
GTCTAGGC	GTCAGGCT
GTCAATGA	GTCAAATG
GTCAATGC	GTCAAATG
GTCAATGG	GTCAAATG
GTCAATGT	GTCAAATG
GTCAATGN	GTCAAATG
GTCAATTG	GTCAAATG
GTACCCAA	GTACCGAA
GTCAANAT	GTCAAATG
GTACCCGA	GTACCGAA
GTACCCGT	GACCCGTC
GTTCCGAA	GTACCGAA
GTCAANTG	GTCAAATG
GTACCGAA	GTACCGAA
GTACCGAC	GTACCGAA
GTACCGAG	GTACCGAA
GTCACAAT	GTCAAATG
GTACCGAT	GTACCGAA
GTACCGAN	GTACCGAA
GTCACATA	GCACATAG
GTCACATG	GTCAAATG
GTACCGCA	GTACCGAA
GTACCGGA	GTACCGAA
GTCGAAAT	GTCAAATG
GTACCGTA	GTACCGAA
GTACCGNA	GTACCGAA
GTCGAATG	GTCAAATG
GTACCTAA	GTACCGAA
GTGNCACC	GTGGCACC
GTACCTGA	GTACCGAA
GTCTCAGA	AGTCTCAG
GTTCCTGA	ATTCCTGA
GTCTCAGC	AGTCTCAG
GTCTCAGG	AGTCTCAG
GTCTCAGT	AGTCTCAG
GTCTCAGN	AGTCTCAG
GTACCNAA	GTACCGAA
GTCACCGA	GTACCGAA
GTCGACTT	ATCGACTT
GTCTCCAT	CTCTCCAT
GTCGAGGC	GTCAGGCT
GTACCNGA	GTACCGAA
GTCGAGTC	TCGAGTCC
GTCACGCT	GTCAGGCT
GTCACGGC	GTCAGGCT
GTTCGACT	GTTTGACT
GTGGTACC	GTGGCACC
GTGGTCAC	GTGGCACC
GTCGCACC	GTGGCACC
GTCGCCGG	GCGCCGGG
GTCAGAAT	GTCAAATG
GTGNGCAC	GTGGCACC
GTCAGACT	GTCAGGCT
GTCGCGAA	GCGCGAAG
GTCAGAGC	GTCAGGCT
GTCTGACT	GTTTGACT
GTTCTAAA	GTTTAAAG
GTGGNACC	GTGGCACC
GTGGNCAC	GTGGCACC
GTCAGATG	GTCAAATG
GTTCTGAC	GTTTGACT
GTCGGAAA	ATCGGAAA
GTCAGCCT	GTCAGGCT
GTCAGCGC	GTCAGGCT
GTCAGCTA	GTCAGGCT
GTCAGCTC	GTCAGGCT
GTCAGCTG	GTCAGGCT
GTCAGCTT	GTCAGGCT
GTCAGCTN	GTCAGGCT
GTCTGGCT	GTCAGGCT
GTCAGGAC	GTCAGGCT
GTCAGGAT	GTCAGGCT
GTCAGGCA	GTCAGGCT
GTCAGGCC	GTCAGGCT
GTCAGGCG	GTCAGGCT
GTCAGGCT	GTCAGGCT
GTCAGGCN	GTCAGGCT
GTGTAAAG	GTTTAAAG
GTCAGGGC	GTCAGGCT
GTCAGGGT	GTCAGGCT
GTCAGGTA	GTCAGGCT
GTCAGGTC	GTCAGGCT
GTCGGCAC	GTGGCACC
GTCGGCTA	GTCAGGCT
GTCGGCTC	GTCAGGCT
GTCGGCTG	GTCAGGCT
GTCGGCTT	GTCAGGCT
GTCGGCTN	GTCAGGCT
GTCTTAAA	GTTTAAAG
GTCAGGTG	GTCAGGCT
GTCAGGTT	GTCAGGCT
GTCAGGTN	GTCAGGCT
GTCAGGNC	GTCAGGCT
GTCAGGNT	GTCAGGCT
GTCAGTCT	GTCAGGCT
GTCAGTGC	GTCAGGCT
GTCGGGCT	GTCAGGCT
GTGTAGTC	CTGTAGTC
GTCAGNCT	GTCAGGCT
GTCAGNGC	GTCAGGCT
GTCATAAT	GTCAAATG
GTCTTGAC	GTTTGACT
GTCATATG	GTCAAATG
GTGTCACC	GTGGCACC
GTCTTTAA	CTCTTTAA
GTTGAAAG	GTTTAAAG
GTCGTCTG	TCGTCTGG
GTCATCCA	GCATCCAT
GTCATGCT	GTCAGGCT
GTCGTGTT	GCGTGTTA
GTCATGGC	GTCAGGCT
GTTGACAG	TTGACAGC
GTTGACTA	GTTTGACT
GTTGACTC	GTTTGACT
GTTGACTG	GTTTGACT
GTTGACTT	GTTTGACT
GTTGACTN	GTTTGACT
GTCATTAT	GACATTAT
GTCNGGCT	GTCAGGCT
GTGTCCGA	TTGTCCGA
GTGTCGAA	TGTGTCGA
GTGTCGAC	TGTGTCGA
GTGTCGAG	TGTGTCGA
GTGTCGAT	TGTGTCGA
GTGTCGAN	TGTGTCGA
GTGTCGCT	ATGTCGCT
GTGTCGGT	GAGTCGGT
GTGCAAAT	GTCAAATG
GTTAAAAG	GTTTAAAG
GTCANAAT	GTCAAATG
GTGCACCA	GTGGCACC
GTGCACCC	GTGGCACC
GTGCACCG	GTGGCACC
GTGCACCT	GTGGCACC
GTCANATG	GTCAAATG
GTGCACCN	GTGGCACC
GTTNAAAG	GTTTAAAG
GTTAAAGA	GTTTAAAG
GTTAAAGC	GTTTAAAG
GTTAAAGG	GTTTAAAG
GTTAAAGT	GTTTAAAG
GTTAAAGN	GTTTAAAG
GTTAAATG	GTCAAATG
GTGCAGGC	GTCAGGCT
GTTGCACC	GTGGCACC
GTGTGACT	GTTTGACT
GTCANGCT	GTCAGGCT
GTCANGGC	GTCAGGCT
GTGCCACC	GTGGCACC
GTGCCATG	TGCCATGT
GTGTGCAC	GTGGCACC
GTTGCGTT	TTGCGTTC
GTTAATGA	CTTAATGA
GTGCCGAA	GTACCGAA
GTCNAAAT	GTCAAATG
GTGCCGGG	GCGCCGGG
GTCNAATG	GTCAAATG
GTCCAAAA	TTCCAAAA
GTCCAAAT	GTCAAATG
GTCCAATG	GTCAAATG
GTGCGAAG	GCGCGAAG
GTGTGGGG	TGTGGGGT
GTCCAGGC	GTCAGGCT
GTGCGCAC	GTGGCACC
GTGTGTCG	TGTGTCGA
GTCNAGGC	GTCAGGCT
GTGTGTTA	GCGTGTTA
GTTACCGA	GTACCGAA
GTTACCGG	CTTACCGG
GNATTCGT	GAATTCGT
GTGCGTTC	TTGCGTTC
GTGTTAAA	GTTTAAAG
GTTGGACT	GTTTGACT
GTTGGCAC	GTGGCACC
GTGCTAAA	TGCTAAAT
GTTNGACT	GTTTGACT
GTGTTGAC	GTTTGACT
GNATTTCC	GATTTCCC
GTTAGAAA	GATAGAAA
GTGTTTTG	TGTTTTGC
GTTAGACT	GTTTGACT
GTTAGCTC	GCTAGCTC
GTTAGGAC	TTAGGACG
GTTGTAAA	GTTTAAAG
GTTAGGCT	GTCAGGCT
GTTGTCCG	TTGTCCGA
GTTATAAA	GTTTAAAG
GTTATATC	ATTATATC
GTTATCAC	TTATCACT
GTTATGAC	GTTTGACT
GTTGTGAC	GTTTGACT
GTTGTGGA	TTTGTGGA
GTTNTAAA	GTTTAAAG
GTGAAATG	GTCAAATG
GTGGAACC	GTGGCACC
GTGGACAC	GTGGCACC
GTGGACCA	GTGGCACC
GTGGACCC	GTGGCACC
GTGGACCG	GTGGCACC
GTGGACCT	GTGGCACC
GTGGACCN	GTGGCACC
GTGGAGAC	TGGAGACT
GTTNTGAC	GTTTGACT
GTTTAAAA	GTTTAAAG
GTTTAAAC	GTTTAAAG
GTTTAAAG	GTTTAAAG
GTTTAAAT	GTTTAAAG
GTTTAAAN	GTTTAAAG
GTTTAACA	GTTTAAAG
GTTTAACG	GTTTAAAG
GTTTAACT	GTTTGACT
GTTTAAGA	GTTTAAAG
GTTTAAGC	GTTTAAAG
GTTTAAGG	GTTTAAAG
GTTTAAGT	GTTTAAAG
GTTTAAGN	GTTTAAAG
GTTTAATA	GTTTAAAG
GTTTAATG	GTTTAAAG
GTTTAANA	GTTTAAAG
GTTTAANG	GTTTAAAG
GTTTACAA	GTTTAAAG
GTTTACAG	GTTTAAAG
GTTTACTA	GTTTGACT
GTTTACTC	GTTTGACT
GTTTACTG	GTTTGACT
GTTTACTT	GTTTGACT
GTTTACTN	GTTTGACT
GTTTAGAA	GTTTAAAG
GTTTAGAC	GTTTGACT
GTTTAGAG	GTTTAAAG
GTGGCAAC	GTGGCACC
GTGGCACA	GTGGCACC
GTGGCACC	GTGGCACC
GTGGCACG	GTGGCACC
GTGGCACT	GTGGCACC
GTGGCACN	GTGGCACC
GTGGCAGC	GTGGCACC
GTGGCATC	GTGGCACC
GTTTATAA	GTTTAAAG
GTTTATAG	GTTTAAAG
GTGGCANC	GTGGCACC
GTGGCCAC	GTGGCACC
GTGGCCCA	GTGGCACC
GTGGCCCC	GTGGCACC
GTGGCCCG	GTGGCACC
GTGGCCCT	GTGGCACC
GTGGCCCN	GTGGCACC
GTNCAAAT	GTCAAATG
GTGACACC	GTGGCACC
GTGACAGC	TTGACAGC
GTGGCGAC	GTGGCACC
GTTTANAA	GTTTAAAG
GTGGCGCC	GTGGCACC
GTTTANAG	GTTTAAAG
GTGACCGA	GTACCGAA
GTGGCTAC	GTGGCACC
GTGGCTCC	GTGGCACC
GTTTCAAA	GTTTAAAG
GTTTCAAG	GTTTAAAG
GTTTCACT	GTTTGACT
GNAAGGGT	GAAGGGTA
GTGGCNAC	GTGGCACC
GTGGCNCC	GTGGCACC
GTGGGACC	GTGGCACC
GTTTCCCA	GATTTCCC
GTTTCCCC	GATTTCCC
GTTTCCCG	GATTTCCC
GTTTCCCT	GATTTCCC
GTTTCCCN	GATTTCCC
GTTTCGAC	GTTTGACT
GTGGGCAC	GTGGCACC
GNAGGGTA	GAAGGGTA
GTGGGCTA	ATGGGCTA
GTGGGGTA	TGTGGGGT
GTGGGGTC	TGTGGGGT
GTGGGGTG	TGTGGGGT
GTGGGGTT	TGTGGGGT
GTNAAATG	GTCAAATG
GTGGGGTN	TGTGGGGT
GTNCAGGC	GTCAGGCT
GTTTGAAA	GTTTAAAG
GTTTGAAC	GTTTGACT
GTTTGAAG	GTTTAAAG
GTTTGAAT	GTTTGACT
GTTTGACA	GTTTGACT
GTTTGACC	GTTTGACT
GTTTGACG	GTTTGACT
GTTTGACT	GTTTGACT
GTTTGACN	GTTTGACT
GTGAGCAC	GTGGCACC
GTTTGAGC	GTTTGACT
GTTTGAGT	GTTTGACT
GTTTGATA	GTTTGACT
GTTTGATC	GTTTGACT
GTTTGATG	GTTTGACT
GTTTGATT	GTTTGACT
GTTTGATN	GTTTGACT
GTTTGANC	GTTTGACT
GNAGTCGG	GAGTCGGT
GTGAGGCA	TGAGGCAT
GTTTGANT	GTTTGACT
GTGAGGCT	GTCAGGCT
GTTTGCAC	GTTTGACT
GTTTGCCT	GTTTGACT
GNAATTCG	GAATTCGT
GTTTGCTA	GTTTGACT
GTTTGCTC	GTTTGACT
GTTTGCTG	GTTTGACT
GTTTGCTT	GTTTGACT
GTTTGCTN	GTTTGACT
GTTTGGAC	GTTTGACT
GTTTGGCT	GTTTGACT
GTNACCGA	GTACCGAA
GTNCCGAA	GTACCGAA
GTTTGTAC	GTTTGACT
GTTTGTCT	GTTTGACT
GTTTGTGG	TTTGTGGA
GTTTGNAC	GTTTGACT
GTTTGNCT	GTTTGACT
GTTTTAAA	GTTTAAAG
GTTTTAAG	GTTTAAAG
GTTTTACT	GTTTGACT
GNCAAATG	GTCAAATG
GTTTTCCC	GATTTCCC
GTNAGGCT	GTCAGGCT
GTTTTGAC	GTTTGACT
GTTTTGCA	TGTTTTGC
GTTTTGCC	TGTTTTGC
GTTTTGCG	TGTTTTGC
GTTTTGCT	TGTTTTGC
GTTTTGCN	TGTTTTGC
GNACATAG	GCACATAG
GNACATTA	GACATTAT
GTTTNAAA	GTTTAAAG
GTTTNAAG	GTTTAAAG
GTTTNACT	GTTTGACT
GNATAGAA	GATAGAAA
GNACCCGT	GACCCGTC
GNACCGAA	GTACCGAA
GTTTNGAC	GTTTGACT
GTNGCACC	GTGGCACC
GNATCCAT	GCATCCAT
GNCACATA	GCACATAG
GNCGCCGG	GCGCCGGG
GNCGCGAA	GCGCGAAG
GTNGGCAC	GTGGCACC
GNAAAATT	GAAAATTT
GNCAGGCT	GTCAGGCT
GNAAATTT	GAAAATTT
GTNTAAAG	GTTTAAAG
GNCGTGTT	GCGTGTTA
GNCATCCA	GCATCCAT
GNGTCGGT	GAGTCGGT
GNCATTAT	GACATTAT
GNTACCGA	GTACCGAA
GNCTAATA	GCCTAATA
GNGTGTTA	GCGTGTTA
GNTAGAAA	GATAGAAA
GNTAGCTC	GCTAGCTC
GNCTAGCT	GCTAGCTC
GTNTGACT	GTTTGACT
GNTGGCAC	GTGGCACC
GTNTTAAA	GTTTAAAG
GTNTTGAC	GTTTGACT
GNGGCACC	GTGGCACC
GNCCCGTC	GACCCGTC
GNTCAAAT	GTCAAATG
GNCCTAAT	GCCTAATA
GNTCAGGC	GTCAGGCT
TAANCAGC	TAACCAGC
TAANCCAG	TAACCAGC
GNTTAAAG	GTTTAAAG
TAANGATC	TAAGATCG
TAAGTACA	TAATTACA
TAAGTATC	TAAGATCG
TAAGTCGA	TAAGATCG
TAAGTCGC	TAAGATCG
TAAGTCGG	TAAGATCG
TAAGTCGT	TAAGATCG
TAAGTCGN	TAAGATCG
TAANTACA	TAATTACA
TAAGTTAC	TAATTACA
TAAGTTCG	TAAGATCG
TAAGTTGC	AAGTTGCG
TAACAACA	TCAACAAC
TAACAACC	TCAACAAC
TAACAACG	TCAACAAC
TAACAACT	TCAACAAC
TAACAACN	TCAACAAC
TAACAAGC	TAACCAGC
TAANTTAC	TAATTACA
TAACACAG	TAACCAGC
GNTTGACT	GTTTGACT
TAACAGCA	TAACCAGC
TAACAGCC	TAACCAGC
TAACAGCG	TAACCAGC
TAACAGCT	TAACCAGC
TAACAGCN	TAACCAGC
TAAGNATC	TAAGATCG
TAAAACAT	AAAACATG
TAAAAGGG	TATAAGGG
TAACATCG	TAAGATCG
TAAGNTCG	TAAGATCG
TAAAATCC	AAAATCCC
TAAAATCG	TAAGATCG
TAAAATTT	GAAAATTT
GNTTTAAA	GTTTAAAG
TAAACAAC	TCAACAAC
TAAACAGC	TAACCAGC
TAAACATG	AAAACATG
TAATAACA	TAATTACA
TAAACCAG	TAACCAGC
GNTTTCCC	GATTTCCC
GNGCCGGG	GCGCCGGG
TAATAAGG	TATAAGGG
TACAACAA	TCAACAAC
TAAACGTT	AAACGTTC
GNTTTGAC	GTTTGACT
TAATACAA	TAATTACA
TAATACAC	TAATTACA
TAATACAG	TAATTACA
TAATACAT	TAATTACA
TAATACAN	TAATTACA
TAAACTAA	AAACTAAC
GNGCGAAG	GCGCGAAG
TAACCAAC	TAACCAGC
TAACCAAG	TAACCAGC
TAACCACA	TAACCAGC
TAACCACC	TAACCAGC
TAACCACG	TAACCAGC
TAACCACT	TAACCAGC
TAACCACN	TAACCAGC
TAACCAGA	TAACCAGC
TAATAGCT	AATAGCTT
TACAAGGG	TATAAGGG
TAACCAGC	TAACCAGC
TAACCAGG	TAACCAGC
TAACCAGT	TAACCAGC
TAACCAGN	TAACCAGC
TAACCATC	TAACCAGC
TAACCATG	TAACCAGC
TAATATAC	TAATTACA
TAATATCG	TAAGATCG
TAACCANC	TAACCAGC
TAACCANG	TAACCAGC
TAACCCAG	TAACCAGC
TAACCCGC	TAACCAGC
TAACCCTG	AACCCTGG
TAACCGAG	TAACCAGC
TAACCGCA	TAACCAGC
TAACCGCC	TAACCAGC
TAACCGCG	TAACCAGC
TAACCGCT	TAACCAGC
TAACCGCN	TAACCAGC
TAAAGATC	TAAGATCG
TAACCGGC	TAACCAGC
TAATCACA	TAATTACA
TAATCACT	TTATCACT
TAACCTAG	TAACCAGC
TAATCAGC	TAACCAGC
TAACCTGC	TAACCAGC
TACACCAG	TAACCAGC
TACACCCA	TACGCCCA
TACGGAAT	TACGGTAT
TAATCCAG	TAACCAGC
TACGGATA	TACGGTAT
TACGGATC	TACGGTAT
TAACCNAG	TAACCAGC
TAACCNGC	TAACCAGC
TAAAGGGA	TATAAGGG
TAACGAGC	TAACCAGC
TAAAGGGC	TATAAGGG
TACGGATG	TACGGTAT
TAAAGGGG	TATAAGGG
TACGGATT	TACGGTAT
TACGGATN	TACGGTAT
TAAAGGGT	TATAAGGG
TAAAGGGN	TATAAGGG
TAACGATC	TAAGATCG
TAACGCAG	TAACCAGC
TAACGCCC	TACGCCCA
TACGGCAT	TACGGTAT
TACGGCCA	TACGCCCA
TACGGCCC	TACGCCCA
TACGGCTA	TACGGTAT
TAATCTAC	TAATTACA
TAACGGTA	TACGGTAT
TACGGGAT	TACGGTAT
TACGGGTA	TACGGTAT
TAACGTTC	AAACGTTC
TACGGTAA	TACGGTAT
TACGGTAC	TACGGTAT
TACGGTAG	TACGGTAT
TACGGTAT	TACGGTAT
TACGGTAN	TACGGTAT
TACGGTCA	TACGGTAT
TACGGTCT	TACGGTAT
TACGGTGA	TACGGTAT
TAATGACA	TAATTACA
TAATGACC	AATGACCG
TACGGTGT	TACGGTAT
TACGGTTA	TACGGTAT
TACGGTTC	TACGGTAT
TACGGTTG	TACGGTAT
TAATGATC	TAAGATCG
TACGGTTT	TACGGTAT
TACGGTTN	TACGGTAT
TACGGTNA	TACGGTAT
TAACTAAC	AAACTAAC
TACGGTNT	TACGGTAT
TAACTACA	TAATTACA
TACGGNAT	TACGGTAT
TAACTAGC	TAACCAGC
TAATGGCG	TATTGGCG
TAACTCAG	TAACCAGC
TACAGCCC	TACGCCCA
TACGGNTA	TACGGTAT
TAAATACA	TAATTACA
TAATGTAC	TAATTACA
TAATGTAG	AAATGTAG
TACAGGAC	ACAGGACT
TAAATCCC	AAAATCCC
TACAGGTA	TACGGTAT
TAAATCGA	TAAGATCG
TAAATCGC	TAAGATCG
TAAATCGG	TAAGATCG
TAAATCGT	TAAGATCG
TAAATCGN	TAAGATCG
TACAGTAT	TACGGTAT
TACGTATA	TACGGTAT
TACGTATC	TACGGTAT
TACGTATG	TACGGTAT
TACGTATT	TACGGTAT
TACGTATN	TACGGTAT
TAATTAAA	TAATTACA
TAATTAAC	TAATTACA
TAATTAAG	TAATTACA
TAACTTAC	TAATTACA
TAATTAAT	TAATTACA
TAATTAAN	TAATTACA
TAATTACA	TAATTACA
TAATTACC	TAATTACA
TAATTACG	TAATTACA
TAATTACT	TAATTACA
TAATTACN	TAATTACA
TAAATGTA	AAATGTAG
TACGTCCA	TACGCCCA
TACGTCCC	TACGCCCA
TAATTAGA	TAATTACA
TAATTAGC	TAATTACA
TAATTATA	TAATTACA
TAATTATC	TAATTACA
TAATTANA	TAATTACA
TAATTANC	TAATTACA
TACGTCTG	TCGTCTGG
TAAATTAC	TAATTACA
TAATTCAA	TAATTACA
TAATTCAC	TAATTACA
TAATTCAG	TAATTACA
TAATTCAT	TAATTACA
TAATTCAN	TAATTACA
TAATTCCA	TAATTACA
TAAATTGG	CAAATTGG
TAATTCGT	GAATTCGT
TACGTGTA	TACGGTAT
TAATTGAC	TAATTACA
TAATTGCA	TAATTACA
TACGTTAT	TACGGTAT
TAATTGGC	TATTGGCG
TAACNAGC	TAACCAGC
TACATTAC	TAATTACA
TACATTAT	GACATTAT
TAACNCAG	TAACCAGC
TAATTTAC	TAATTACA
TAATTTCA	TAATTACA
TAATTNAC	TAATTACA
TAATTNCA	TAATTACA
TAATNACA	TAATTACA
TATGAAGG	TATAAGGG
TATGACAG	TTGACAGC
TATGACCG	AATGACCG
TAGGCATA	TGAGGCAT
TAGGCATC	TGAGGCAT
TAGGCATG	TGAGGCAT
TAGGCATT	TGAGGCAT
TAGGCATN	TGAGGCAT
TAGGCCCA	TACGCCCA
TACGNCCA	TACGCCCA
TACGNCCC	TACGCCCA
TAGGCTTA	AGGCTTAA
TATGAGGG	TATAAGGG
TAAGAACG	TAAGATCG
TAATNTAC	TAATTACA
TAAGAATC	TAAGATCG
TACGNGTA	TACGGTAT
TATGATCG	TAAGATCG
TAAGACCG	TAAGATCG
TAAGACGA	TAAGATCG
TAAGACGC	TAAGATCG
TACGNTAT	TACGGTAT
TAAGACGG	TAAGATCG
TAAGACGT	TAAGATCG
TAAGACGN	TAAGATCG
TAAGACTC	TAAGATCG
TATGCAAA	CTATGCAA
TATGCAAC	CTATGCAA
TATGCAAG	CTATGCAA
TATGCAAT	CTATGCAA
TATGCAAN	CTATGCAA
TAAGAGCG	TAAGATCG
TAAGAGTC	TAAGATCG
TATGCCCA	TACGCCCA
TAAGATAC	TAAGATCG
TAAGATAG	TAAGATCG
TAAGATCA	TAAGATCG
TAAGATCC	TAAGATCG
TACTAAAT	TGCTAAAT
TAAGATCG	TAAGATCG
TAAGATCT	TAAGATCG
TACTAAGC	ACTAAGCG
TAAGATCN	TAAGATCG
TACTAAGG	TATAAGGG
TAAGATGA	TAAGATCG
TAAGATGC	TAAGATCG
TAAGATGG	TAAGATCG
TAAGATGT	TAAGATCG
TAAGATGN	TAAGATCG
TAAGATTC	TAAGATCG
TAAGATTG	TAAGATCG
TAGGGTAT	TACGGTAT
TAAGATNC	TAAGATCG
TAAGATNG	TAAGATCG
TATGCGTT	TTGCGTTC
TAANATCG	TAAGATCG
TAAGANCG	TAAGATCG
TAAGANTC	TAAGATCG
TAAGCAGC	TAACCAGC
TAAGCATC	TAAGATCG
TACTAGCG	TCCTAGCG
TACTAGTT	CACTAGTT
TATAGAAA	GATAGAAA
TAAGCCAG	TAACCAGC
TAAGCCCA	TACGCCCA
TATGGCGA	TATTGGCG
TAGGTATA	TACGGTAT
TAGGTATC	TACGGTAT
TATGGCGC	TATTGGCG
TAGGTATG	TACGGTAT
TATGGCGG	TATTGGCG
TAGGTATT	TACGGTAT
TATGGCGT	TATTGGCG
TAGGTATN	TACGGTAT
TATGGCGN	TATTGGCG
TATAGAGG	TATAAGGG
TATGGGCG	TATTGGCG
TATGGGCT	ATGGGCTA
TATAGATC	TAAGATCG
TATGGGGT	TGTGGGGT
TATGGTAT	TACGGTAT
TATAGCTT	AATAGCTT
TATAGGAC	TTAGGACG
TATAGGCG	TATTGGCG
TATAGGGA	TATAAGGG
TATAGGGC	TATAAGGG
TATAGGGG	TATAAGGG
TATAGGGT	TATAAGGG
TATAGGGN	TATAAGGG
TAGGTGGT	AGGTGGTT
TACTCCCA	TACGCCCA
TAAGCTCG	TAAGATCG
TATGTCCG	TTGTCCGA
TATGTCGA	TGTGTCGA
TATGTCGC	ATGTCGCT
TATGTGGA	TTTGTGGA
TATGTGGC	TATTGGCG
TACTCTCT	TCCTCTCT
TATATAGG	TATAAGGG
TAAGGACG	TTAGGACG
TAAGGATC	TAAGATCG
TATATCAC	TTATCACT
TAAGGCAT	TGAGGCAT
TACNCCCA	TACGCCCA
TATATGGC	TATTGGCG
TATATGGG	TATAAGGG
TAAGGGTA	GAAGGGTA
TATATTAC	TAATTACA
TAAGGTAT	TACGGTAT
TACTGCCC	TACGCCCA
TAAGGTCC	CAAGGTCC
TAAGGTCG	TAAGATCG
TAGTAAGG	TATAAGGG
TATANAGG	TATAAGGG
TACTGGCG	TATTGGCG
TATANGGG	TATAAGGG
TACNGCCC	TACGCCCA
TACCAAAA	TTCCAAAA
TACTGGTA	TACGGTAT
TACNGGTA	TACGGTAT
TATTAAGG	TATAAGGG
TATCAAGG	TATAAGGG
TACTGTAT	TACGGTAT
TACCAGAG	CACCAGAG
TATTACAA	TAATTACA
TACCAGCA	TAACCAGC
TACNGTAT	TACGGTAT
TATTACAC	TAATTACA
TACCAGCC	TAACCAGC
TATTACAG	TAATTACA
TATTACAT	TAATTACA
TACCAGCG	TAACCAGC
TATTACAN	TAATTACA
TACCAGCT	TAACCAGC
TACCAGCN	TAACCAGC
TATCACTA	TTATCACT
TACCATGT	TGCCATGT
TATCACTC	TTATCACT
TATCACTG	TTATCACT
TATCACTT	TTATCACT
TATCACTN	TTATCACT
TAGTCCGA	TTGTCCGA
TATCAGGG	TATAAGGG
TATTAGCG	TATTGGCG
TATTAGGC	TATTGGCG
TATTAGGG	TATAAGGG
TACTTACA	TAATTACA
TATTATAT	ATTATATC
TAGTCGGT	GAGTCGGT
TACCCAGC	TAACCAGC
TAGTCTCA	AGTCTCAG
TAGTCTGG	TCGTCTGG
TACTTGGC	TATTGGCG
TATCCAAA	TTCCAAAA
TATTCAAC	ATTCAACC
TATCCAGC	TAACCAGC
TACCCCAA	TACGCCCA
TACCCCAC	TACGCCCA
TACCCCAG	TACGCCCA
TACCCCAT	TACGCCCA
TACCCCAN	TACGCCCA
TATTCCTG	ATTCCTGA
TATCCGCC	ATCCGCCA
TACCCCCA	TACGCCCA
TATTCGCG	TATTGGCG
TATTCGGC	TATTGGCG
TAGATAAT	CAGATAAT
TACCCGAA	ACCCGAAC
TAGATCGA	TAAGATCG
TAGATCGC	TAAGATCG
TAGATCGG	TAAGATCG
TAGATCGT	TAAGATCG
TAGATCGN	TAAGATCG
TACCCGGC	TCCCGGCT
TATCGACT	ATCGACTT
TAGATTAC	TAATTACA
TACCCGTC	GACCCGTC
TATTGACG	TATTGGCG
TATTGAGC	TATTGGCG
TATCGCCC	TACGCCCA
TATTGCCG	TATTGGCG
TATTGCGA	TATTGGCG
TATTGCGC	TATTGGCG
TATTGCGG	TATTGGCG
TATTGCGT	TATTGGCG
TATTGCGN	TATTGGCG
TACCCTGG	AACCCTGG
TATCGGAA	ATCGGAAA
TATCGGCG	TATTGGCG
TATTGGAC	TATTGGCG
TATTGGAG	TATTGGCG
TATTGGCA	TATTGGCG
TATTGGCC	TATTGGCG
TATTGGCG	TATTGGCG
TATTGGCT	TATTGGCG
TATCGGTA	TACGGTAT
TAGTGGCG	TATTGGCG
TATTGGCN	TATTGGCG
TAGTGGGG	TGTGGGGT
TATTGGGA	TATTGGCG
TATTGGGC	TATTGGCG
TATTGGGG	TATTGGCG
TATTGGGT	TATTGGCG
TATTGGGN	TATTGGCG
TATTGGTC	TATTGGCG
TATTGGTG	TATTGGCG
TATTGGNC	TATTGGCG
TATTGGNG	TATTGGCG
TACCGAAA	GTACCGAA
TACCGAAC	GTACCGAA
TACCGAAG	GTACCGAA
TACCGAAT	GTACCGAA
TACCGAAN	GTACCGAA
TATTGTCG	TATTGGCG
TATTGTGC	TATTGGCG
TATTGTGG	TTTGTGGA
TAGTGTCG	TGTGTCGA
TACCGCCC	TACGCCCA
TATTGNCG	TATTGGCG
TATTGNGC	TATTGGCG
TATCTGGC	TATTGGCG
TANACCAG	TAACCAGC
TAGCAAAG	AGCAAAGG
TAGTTACA	TAATTACA
TACCGGCT	TCCCGGCT
TACCGGTA	TACGGTAT
TACCGTAT	TACGGTAT
TAGTTGCG	AAGTTGCG
TAGCCAGC	TAACCAGC
TAGTTGGC	TATTGGCG
TAGCCATG	TGCCATGT
TAGCCCAA	TACGCCCA
TAGCCCAC	TACGCCCA
TAGCCCAG	TACGCCCA
TAGCCCAT	TACGCCCA
TAGCCCAN	TACGCCCA
TCCAAAAA	TTCCAAAA
TCCAAAAC	TTCCAAAA
TCCAAAAG	TTCCAAAA
TCCAAAAT	TTCCAAAA
TCCAAAAN	TTCCAAAA
TACCTAGC	TCCTAGCG
TCCAAAGA	CCAAAGAG
TCCAACAA	TCAACAAC
TAGTTTTG	TGTTTTGC
TAGAAGGG	TATAAGGG
TACCTCTC	TCCTCTCT
TCCAAGCG	TCCTAGCG
TANAGATC	TAAGATCG
TCATCAAC	TCAACAAC
TCATCACT	TTATCACT
TCCAATTT	CCCAATTT
TCATCCAT	GCATCCAT
TAGACAGC	TTGACAGC
TACCTTCG	CACCTTCG
TAGACCAG	TAACCAGC
TCAAAAAC	TCAACAAC
TCAAAACA	TCAACAAC
TCAAAACC	TCAACAAC
TCAAAACG	TCAACAAC
TCAAAACT	TCAACAAC
TCAAAACN	TCAACAAC
TCCACAAC	TCAACAAC
TCATCTCT	TCCTCTCT
TCATCTGG	TCGTCTGG
TCAAACAA	TCAACAAC
TAGCGCCC	TACGCCCA
TCCACCGT	CCCACCGT
TCAAAGAG	CCAAAGAG
TAGCGGTA	TACGGTAT
TCCACGGC	TCCCGGCT
TCAAATGA	GTCAAATG
TCAAATGC	GTCAAATG
TCAAATGG	GTCAAATG
TAGCGTTC	TTGCGTTC
TAGAGACT	TGGAGACT
TCAAATGT	GTCAAATG
TCAAATGN	GTCAAATG
TAGAGATC	TAAGATCG
TCAAATTG	CAAATTGG
TCCACTCT	TCCTCTCT
TANATTAC	TAATTACA
TAGCTAAA	TGCTAAAT
TAGAGGCA	TGAGGCAT
TAGAGGCC	AGAGGCCG
TCATTACA	TAATTACA
TCAACAAA	TCAACAAC
TCAACAAC	TCAACAAC
TCAACAAG	TCAACAAC
TCAACAAT	TCAACAAC
TCAACAAN	TCAACAAC
TCAACACA	TCAACAAC
TCAACACC	TCAACAAC
TCAACACG	TCAACAAC
TCCAGCGA	TCCTAGCG
TCAACACT	TCAACAAC
TCCAGCGC	TCCTAGCG
TCAACACN	TCAACAAC
TCCAGCGG	TCCTAGCG
TCAACAGA	TCAACAAC
TCAACAGC	TCAACAAC
TCCAGCGT	TCCTAGCG
TCCAGCGN	TCCTAGCG
TCAACATA	TCAACAAC
TCAACATC	TCAACAAC
TAGAGTCC	TCGAGTCC
TCAACANA	TCAACAAC
TCAACANC	TCAACAAC
TCCAGGCT	TCCCGGCT
TAGCTTCT	AGCTTCTT
TCATTGGC	TATTGGCG
TCATTGTC	CCATTGTC
TCCAGTCC	TCGAGTCC
TATAAAGG	TATAAGGG
TCAACCAA	TCAACAAC
TCAACCAC	TCAACAAC
TCAACCAG	TAACCAGC
TATAACGG	TATAAGGG
TACGACCA	TACGCCCA
TACGACCC	TACGCCCA
TATAAGAG	TATAAGGG
TCAACGAA	TCAACAAC
TCAACGAC	TCAACAAC
TATAAGCG	TATAAGGG
TATAAGGA	TATAAGGG
TATAAGGC	TATAAGGG
TATAAGGG	TATAAGGG
TCCATAGC	TCCTAGCG
TATAAGGT	TATAAGGG
TATAAGGN	TATAAGGG
TATAAGTG	TATAAGGG
TATAAGNG	TATAAGGG
TCAACTAA	TCAACAAC
TCAACTAC	TCAACAAC
TACGAGTA	TACGGTAT
TACGAGTC	TCGAGTCC
TATAATGG	TATAAGGG
TCCATCTC	TCCTCTCT
TATAANGG	TATAAGGG
TCAACNAA	TCAACAAC
TCAACNAC	TCAACAAC
TACGATAC	ACGATACG
TACGATAT	TACGGTAT
TCCATGTA	TGCCATGT
TACGATCG	TAAGATCG
TCCATGTC	TGCCATGT
TATACAGG	TATAAGGG
TCCATGTG	TGCCATGT
TCCATGTT	TGCCATGT
TCCATGTN	TGCCATGT
TAGGACGA	TTAGGACG
TAGGACGC	TTAGGACG
TAGGACGG	TTAGGACG
TATACCAG	TAACCAGC
TAGGACGT	TTAGGACG
TAGGACGN	TTAGGACG
TCANACAA	TCAACAAC
TCCATTGT	CCATTGTC
TAGGAGAC	TGGAGACT
TCAAGAAC	TCAACAAC
TCAAGATC	TAAGATCG
TAGGATCG	TAAGATCG
TATACGGG	TATAAGGG
TACGCACA	TACGCCCA
TACGCACC	TACGCCCA
TCAAGCAA	TCAACAAC
TACGCCAA	TACGCCCA
TACGCCAC	TACGCCCA
TACGCCAG	TACGCCCA
TACGCCAT	TACGCCCA
TACGCCAN	TACGCCCA
TACGCCCA	TACGCCCA
TACGCCCC	TACGCCCA
TACGCCCG	TACGCCCA
TACGCCCT	TACGCCCA
TACGCCCN	TACGCCCA
TACGCCGA	TACGCCCA
TACGCCGC	TACGCCCA
TACGCCTA	TACGCCCA
TACGCCTC	TACGCCCA
TANTGGCG	TATTGGCG
TACGCCNA	TACGCCCA
TACGCCNC	TACGCCCA
TCANCAAC	TCAACAAC
TACGCGCA	TACGCCCA
TACGCGCC	TACGCCCA
TACGCGTA	TACGGTAT
TCACTAGC	TCCTAGCG
TCACTAGT	CACTAGTT
TCAAGGTC	CAAGGTCC
TACGCTAT	TACGGTAT
TACGCTCA	TACGCCCA
TACGCTCC	TACGCCCA
TCAAGTCC	TCGAGTCC
TCACTCTC	TCCTCTCT
TACGCNCA	TACGCCCA
TACGCNCC	TACGCCCA
TANCCAGC	TAACCAGC
TANGATCG	TAAGATCG
TCAATAAC	TCAACAAC
TATTTACA	TAATTACA
TCAATCAA	TCAACAAC
TATTTCCC	GATTTCCC
TCAATTAC	TAATTACA
TCCCAAAA	TTCCAAAA
TATTTGCG	TATTGGCG
TATTTGGC	TATTGGCG
TANGCCCA	TACGCCCA
TANTTACA	TAATTACA
TCCCAATT	CCCAATTT
TATTTTGC	TGTTTTGC
TCAANAAC	TCAACAAC
TCCCACCG	CCCACCGT
TANTTGGC	TATTGGCG
TCCCAGCG	TCCTAGCG
TCCCAGCT	TCCCGGCT
TCCCAGGC	TCCCGGCT
TCAANCAA	TCAACAAC
TCCCATGT	TGCCATGT
TCAGACAA	TCAACAAC
TANCGCCC	TACGCCCA
TANCGGTA	TACGGTAT
TCAGAGTC	TCGAGTCC
TCAGATAA	CAGATAAT
TATTNGCG	TATTGGCG
TCAGATCG	TAAGATCG
TATTNGGC	TATTGGCG
TCCCCGCT	TCCCGGCT
TCCCCGGC	TCCCGGCT
TCAGCAAC	TCAACAAC
TCCCCTCT	TCCTCTCT
TATNAAGG	TATAAGGG
TCACAACA	TCAACAAC
TCACAACC	TCAACAAC
TCACAACG	TCAACAAC
TCACAACT	TCAACAAC
TCACAACN	TCAACAAC
TCACACAA	TCAACAAC
TCTGTAGT	CTGTAGTC
TCACAGAT	CACAGATC
TATNAGGG	TATAAGGG
TCTGTCCG	TTGTCCGA
TCTGTCGA	TGTGTCGA
TCTGTCTG	TCGTCTGG
TCTGTGGA	TTTGTGGA
TCACATAG	GCACATAG
TCCTAAAT	TGCTAAAT
TCCTAACG	TCCTAGCG
TANGGTAT	TACGGTAT
TCCTAAGC	TCCTAGCG
TCCTAATA	GCCTAATA
TCCTACCG	TCCTAGCG
TCCTACGA	TCCTAGCG
TCCTACGC	TCCTAGCG
TCCTACGG	TCCTAGCG
TCCTACGT	TCCTAGCG
TCCTACGN	TCCTAGCG
TCCTACTC	TCCTCTCT
TCCTAGAC	TCCTAGCG
TCCTAGAG	TCCTAGCG
TCCTAGCA	TCCTAGCG
TCCTAGCC	TCCTAGCG
TCCTAGCG	TCCTAGCG
TCCTAGCT	TCCTAGCG
TCCTAGCN	TCCTAGCG
TCCTAGGA	TCCTAGCG
TCCTAGGC	TCCTAGCG
TCCTAGGG	TCCTAGCG
TCCTAGGT	TCCTAGCG
TCCTAGGN	TCCTAGCG
TCCTAGTC	TCCTAGCG
TCCTAGTG	TCCTAGCG
TCCTAGNC	TCCTAGCG
TCCTAGNG	TCCTAGCG
TCACCAAC	TCAACAAC
TCAGGACG	TTAGGACG
TCCTATCG	TCCTAGCG
TCAGGACT	ACAGGACT
TCCTATCT	TCCTCTCT
TCCTATGC	TCCTAGCG
TCACCAGA	CACCAGAG
TCCTANCG	TCCTAGCG
TCCTANGC	TCCTAGCG
TCACCAGC	TAACCAGC
TCAGGCAT	TGAGGCAT
TCAGGCTA	GTCAGGCT
TCAGGCTC	GTCAGGCT
TCAGGCTG	GTCAGGCT
TCAGGCTT	GTCAGGCT
TCAGGCTN	GTCAGGCT
TCCTCACT	TCCTCTCT
TCCTCAGC	TCCTAGCG
TCCTCATC	TCCTCTCT
TCCTCCCT	TCCTCTCT
TCCTCCTA	TCCTCTCT
TCCTCCTC	TCCTCTCT
TCCTCCTG	TCCTCTCT
TCCTCCTT	TCCTCTCT
TCCTCCTN	TCCTCTCT
TCCTCGCG	TCCTAGCG
TCCTCGCT	TCCTCTCT
TCCTCGGC	TCCCGGCT
TCACCGGC	TCCCGGCT
TCCTCGTC	TCCTCTCT
TCTCCAAA	TTCCAAAA
TCTTAATG	CTTAATGA
TCCTCTAC	TCCTCTCT
TCCTCTAT	TCCTCTCT
TCCTCTCA	TCCTCTCT
TCTCCATA	CTCTCCAT
TCTCCATC	CTCTCCAT
TCTCCATG	CTCTCCAT
TCTCCATT	CTCTCCAT
TCCTCTCC	TCCTCTCT
TCTCCATN	CTCTCCAT
TCCTCTCG	TCCTCTCT
TCCTCTCT	TCCTCTCT
TCCTCTCN	TCCTCTCT
TCTTACCG	CTTACCGG
TCTTAGCG	TCCTAGCG
TCCTCTGC	TCCTCTCT
TATNGGCG	TATTGGCG
TCCTCTGG	TCGTCTGG
TCCTCTGT	TCCTCTCT
TCACCTTC	CACCTTCG
TCCTCTTA	TCCTCTCT
TCCTCTTC	TCCTCTCT
TCCTCTTG	TCCTCTCT
TCCTCTTT	TCCTCTCT
TCCTCTTN	TCCTCTCT
TCCTCTNC	TCCTCTCT
TCCTCTNT	TCCTCTCT
TCTCCGGC	TCCCGGCT
TCCTCNCT	TCCTCTCT
TCAGTCCA	TCGAGTCC
TCAGTCCC	TCGAGTCC
TCAGTCCG	TCGAGTCC
TCAGTCCT	TCGAGTCC
TCAGTCCN	TCGAGTCC
TCCTCNTC	TCCTCTCT
TCAGTCTG	TCGTCTGG
TCACGCCC	TACGCCCA
TCCTGAGC	TCCTAGCG
TCACGGCT	TCCCGGCT
TCACGGTA	TACGGTAT
TCTCGGCT	TCCCGGCT
TCTTCTCT	TCCTCTCT
TCTTCTGG	TCGTCTGG
TANTAAGG	TATAAGGG
TCCTGCGA	TCCTAGCG
TCCTGCGC	TCCTAGCG
TCCTGCGG	TCCTAGCG
TCCTGCGT	TCCTAGCG
TCCTGCGN	TCCTAGCG
TCCTGCTC	TCCTCTCT
TATNTGGC	TATTGGCG
TCCTGGCG	TCCTAGCG
TCCTGGCT	TCCCGGCT
TCTCTAGC	TCCTAGCG
TCCTGGTA	CCTGGTAC
TCCTGTCT	TCCTCTCT
TCTCTCCA	CTCTCCAT
TCTCTCTA	TCCTCTCT
TCTCTCTC	TCCTCTCT
TCTCTCTG	TCCTCTCT
TCTCTCTT	TCCTCTCT
TCTCTCTN	TCCTCTCT
TCTTGGCG	TATTGGCG
TCTCTGGA	TCGTCTGG
TCTCTGGC	TCGTCTGG
TCTCTGGG	TCGTCTGG
TCTTGTGG	TTTGTGGA
TCTCTGGT	TCGTCTGG
TCTCTGGN	TCGTCTGG
TCTTTAAA	CTCTTTAA
TCTTTAAC	CTCTTTAA
TCTTTAAG	CTCTTTAA
TCTTTAAT	CTCTTTAA
TCTTTAAN	CTCTTTAA
TCATAAGG	TATAAGGG
TCCTTAGC	TCCTAGCG
TCTCTTTA	CTCTTTAA
TCATACAA	TCAACAAC
TCGTACTG	TCGTCTGG
TCCTTCTA	TCCTCTCT
TCCTTCTC	TCCTCTCT
TCCTTCTG	TCCTCTCT
TCCTTCTT	TCCTCTCT
TCCTTCTN	TCCTCTCT
TCATAGCG	TCCTAGCG
TCGTAGCG	TCCTAGCG
TCCTTGCG	TCCTAGCG
TCGTAGTC	TCGAGTCC
TCCTTTCT	TCCTCTCT
TCGTATGG	TCGTCTGG
TCTTTTGC	TGTTTTGC
TCGCCATG	TGCCATGT
TCCTNAGC	TCCTAGCG
TCGCCCAA	TACGCCCA
TCGCCCAC	TACGCCCA
TCGCCCAG	TACGCCCA
TCGCCCAT	TACGCCCA
TCGCCCAN	TACGCCCA
TCGCCCTA	CCGCCCTA
TCCTNCTC	TCCTCTCT
TCGTCAGG	TCGTCTGG
TCCTNGCG	TCCTAGCG
TCGCCGGC	TCCCGGCT
TCGCCGGG	GCGCCGGG
TCGTCATG	TCGTCTGG
TCGTCCGA	TTGTCCGA
TCGTCCGG	TCGTCTGG
TCCTNTCT	TCCTCTCT
TCCNTAGC	TCCTAGCG
TCGCCTGG	TCGTCTGG
TANAAGGG	TATAAGGG
TCGTCCTG	TCGTCTGG
TCGTCGGA	TCGTCTGG
TCGTCGGC	TCGTCTGG
TCGTCGGG	TCGTCTGG
TCGTCGGT	TCGTCTGG
TCGTCGGN	TCGTCTGG
TCGTCGTG	TCGTCTGG
TCGNGTCC	TCGAGTCC
TCGCGAAG	GCGCGAAG
TCGTCTAG	TCGTCTGG
TCGTCTCG	TCGTCTGG
TCGTCTCT	TCCTCTCT
TCCNTCTC	TCCTCTCT
TCGTCTGA	TCGTCTGG
TCGTCTGC	TCGTCTGG
TCGTCTGG	TCGTCTGG
TCGTCTGT	TCGTCTGG
TCGTCTGN	TCGTCTGG
TCGTCTTG	TCGTCTGG
TCGTCTNG	TCGTCTGG
TCGTCNGG	TCGTCTGG
TCTGACAG	TTGACAGC
TCGTCNTG	TCGTCTGG
TCCCGAAC	ACCCGAAC
TCCCGACT	TCCCGGCT
TCCCGAGC	TCCCGGCT
TCCNAGCG	TCCTAGCG
TCGNTCTG	TCGTCTGG
TCCCGCCT	TCCCGGCT
TCCCGCGC	TCCCGGCT
TCTGAGTC	TCGAGTCC
TCCCGCTA	TCCCGGCT
TCCCGCTC	TCCCGGCT
TCCCGCTG	TCCCGGCT
TCCCGCTT	TCCCGGCT
TCCCGCTN	TCCCGGCT
TCGTGCTG	TCGTCTGG
TCCCGGAC	TCCCGGCT
TCCCGGAT	TCCCGGCT
TCCCGGCA	TCCCGGCT
TCGCGGCT	TCCCGGCT
TCCCGGCC	TCCCGGCT
TCCCGGCG	TCCCGGCT
TCGTGGGG	TGTGGGGT
TCCCGGCT	TCCCGGCT
TCCCGGCN	TCCCGGCT
TCCCGGGC	TCCCGGCT
TCCCGGGT	TCCCGGCT
TCGTGTCC	TCGAGTCC
TCGTGTCG	TGTGTCGA
TCGCGTCC	TCGAGTCC
TCCCGGTA	TCCCGGCT
TCCCGGTC	TCCCGGCT
TCCCGGTG	TCCCGGCT
TCGTGTGG	TCGTCTGG
TCCCGGTT	TCCCGGCT
TCCCGGTN	TCCCGGCT
TCGTGTTA	GCGTGTTA
TCCCGGNC	TCCCGGCT
TCGCGTTC	TTGCGTTC
TCCCGGNT	TCCCGGCT
TCCCGTCT	TCCCGGCT
TCCCGTGC	TCCCGGCT
TCGCTAAA	TGCTAAAT
TCCCGNCT	TCCCGGCT
TCGCTAGC	TCCTAGCG
TCCCGNGC	TCCCGGCT
TCCCTAGC	TCCTAGCG
TCGCTCTC	TCCTCTCT
TCGCTCTG	TCGTCTGG
TCTGCGTT	TTGCGTTC
TCCCTCTA	TCCTCTCT
TCGTTCTG	TCGTCTGG
TCGCTGGA	TCGTCTGG
TCCCTCTC	TCCTCTCT
TCGCTGGC	TCGTCTGG
TCGCTGGG	TCGTCTGG
TCCCTCTG	TCCTCTCT
TCGCTGGT	TCGTCTGG
TCGCTGGN	TCGTCTGG
TCCCTCTT	TCCTCTCT
TCCCTCTN	TCCTCTCT
TCGTTGAA	CCGTTGAA
TCCCTGCT	TCCCGGCT
TCGTTGGA	TCGTCTGG
TCGTTGGC	TCGTCTGG
TCCCTGGC	TCCCGGCT
TCGTTGGG	TCGTCTGG
TCGTTGGT	TCGTCTGG
TCGTTGGN	TCGTCTGG
TCGAACAA	TCAACAAC
TCGTTTGG	TCGTCTGG
TCGTTTTG	TGTTTTGC
TCCNCGGC	TCCCGGCT
TCGAAGTC	TCGAGTCC
TCCNCTCT	TCCTCTCT
TGCAGACT	TGGAGACT
TCGAATCC	TCGAGTCC
TCTAAATA	TGCTAAAT
TCTAAATC	TGCTAAAT
TCTAAATG	TGCTAAAT
TCTAAATT	TGCTAAAT
TCTGGGGT	TGTGGGGT
TCTAAATN	TGCTAAAT
TCTAACAA	TCAACAAC
TCTGGTAC	CCTGGTAC
TCGACAAC	TCAACAAC
TCCCNGCT	TCCCGGCT
TCCCNGGC	TCCCGGCT
TCGACAGC	TTGACAGC
TCTAAGCG	ACTAAGCG
TCTAAGGG	TATAAGGG
TCGTNCTG	TCGTCTGG
TGCAGGCA	TGAGGCAT
TCCNGGCT	TCCCGGCT
TCGGAAAA	ATCGGAAA
TCGGAAAC	ATCGGAAA
TCGGAAAG	ATCGGAAA
TCGGAAAT	ATCGGAAA
TCGGAAAN	ATCGGAAA
TCGACGGA	CCGACGGA
TCGACGTC	TCGAGTCC
TCTACAAC	TCAACAAC
TCGTNTGG	TCGTCTGG
TCGGAGAC	TGGAGACT
TCCGACGG	CCGACGGA
TCGGAGTC	TCGAGTCC
TGCATAAA	TGCTAAAT
TCGACTCC	TCGAGTCC
TCCGAGCG	TCCTAGCG
TCCGAGTC	TCGAGTCC
TGCATCCA	GCATCCAT
TCGACTGG	TCGTCTGG
TCGACTTA	ATCGACTT
TCGACTTC	ATCGACTT
TCGACTTG	ATCGACTT
TCGACTTT	ATCGACTT
TCGACTTN	ATCGACTT
TGCATGTA	TGCCATGT
TGCATGTC	TGCCATGT
TGCATGTG	TGCCATGT
TGCATGTT	TGCCATGT
TGCATGTN	TGCCATGT
TCGAGACC	TCGAGTCC
TCGAGACT	TGGAGACT
TCGAGATC	TCGAGTCC
TCGAGCCA	TCGAGTCC
TCGAGCCC	TCGAGTCC
TCGAGCCG	TCGAGTCC
TCGAGCCT	TCGAGTCC
TCGAGCCN	TCGAGTCC
TCGGCTGG	TCGTCTGG
TCGAGCTC	TCGAGTCC
TCGAGGCA	TGAGGCAT
TCGAGGCC	TCGAGTCC
TCCGCCAA	ATCCGCCA
TCGNAGTC	TCGAGTCC
TCCGCCAC	ATCCGCCA
TCCGCCAG	ATCCGCCA
TCCGCCAT	ATCCGCCA
TCCGCCAN	ATCCGCCA
TCCGCCCA	TACGCCCA
TCGAGGTC	TCGAGTCC
TCGGGAAC	CGGGAACC
TCCGCCCT	CCGCCCTA
TCGAGTAC	TCGAGTCC
TCGAGTCA	TCGAGTCC
TCGAGTCC	TCGAGTCC
TCGAGTCG	TCGAGTCC
TCGAGTCT	TCGAGTCC
TCGAGTCN	TCGAGTCC
TCGAGTGC	TCGAGTCC
TCTAGCGA	TCCTAGCG
TCTAGCGC	TCCTAGCG
TCTAGCGG	TCCTAGCG
TCTAGCGT	TCCTAGCG
TCTAGCGN	TCCTAGCG
TCGAGTTC	TCGAGTCC
TCTAGCTC	GCTAGCTC
TCGAGTTT	CGAGTTTA
TCGGGCGT	CCGGGCGT
TCTAGGAC	TTAGGACG
TCGAGTNC	TCGAGTCC
TCCGCGGC	TCCCGGCT
TCGAGNCC	TCGAGTCC
TCCGCTCT	TCCTCTCT
TCGAGNTC	TCGAGTCC
TCGGGTAG	CGGGTAGG
TCGATACG	ACGATACG
TCTAGTCC	TCGAGTCC
TCGGGTCC	TCGAGTCC
TCGATCCA	TCGAGTCC
TCGATCCC	TCGAGTCC
TCGATCCG	TCGAGTCC
TCGATCCT	TCGAGTCC
TCGATCCN	TCGAGTCC
TCGATCTG	TCGTCTGG
TCGATGTC	TCGAGTCC
TCCGGCTA	TCCCGGCT
TCCGGCTC	TCCCGGCT
TCCGGCTG	TCCCGGCT
TCCGGCTT	TCCCGGCT
TCCGGCTN	TCCCGGCT
TCGATTCC	TCGAGTCC
TGCCAAAA	TTCCAAAA
TCTATCAC	TTATCACT
TGCCAAAT	TGCTAAAT
TGCCAAGT	TGCCATGT
TCCGGGCG	CCGGGCGT
TCCGGGCT	TCCCGGCT
TGCCAATG	TGCCATGT
TCGGTATA	TACGGTAT
TCGGTATC	TACGGTAT
TCGGTATG	TACGGTAT
TCGGTATT	TACGGTAT
TCGNCTGG	TCGTCTGG
TCGGTATN	TACGGTAT
TGCCACGT	TGCCATGT
TCNCCGGC	TCCCGGCT
TGCCACTG	TGCCATGT
TCGGTCCA	TCGAGTCC
TCCGGTAT	TACGGTAT
TCTATGCA	CTATGCAA
TCGGTCCC	TCGAGTCC
TCGGTCCG	TCGAGTCC
TCGGTCCT	TCGAGTCC
TCGGTCCN	TCGAGTCC
TGCCAGGT	TGCCATGT
TGCCAGTA	TGCCATGT
TGCCAGTC	TGCCATGT
TGCCAGTG	TGCCATGT
TGCCAGTT	TGCCATGT
TGCCAGTN	TGCCATGT
TGCCATAG	TGCCATGT
TCGGTCTG	TCGTCTGG
TGCCATAT	TGCCATGT
TGCCATCG	TGCCATGT
TGCCATCT	TGCCATGT
TGCCATGA	TGCCATGT
TCCGTAGC	TCCTAGCG
TGCCATGC	TGCCATGT
TGCCATGG	TGCCATGT
TGCCATGT	TGCCATGT
TGCCATGN	TGCCATGT
TGCCATTA	TGCCATGT
TGCCATTC	TGCCATGT
TGCCATTG	TGCCATGT
TGCCATTT	TGCCATGT
TGCCATTN	TGCCATGT
TGCCATNG	TGCCATGT
TGCCATNT	TGCCATGT
TCGANGTC	TCGAGTCC
TCCGTCTC	TCCTCTCT
TCGANTCC	TCGAGTCC
TCCGTCTG	TCGTCTGG
TGANGCAT	TGAGGCAT
TGAATTAC	TAATTACA
TGAATTCG	GAATTCGT
TGCCANGT	TGCCATGT
TGCCANTG	TGCCATGT
TGANGGCA	TGAGGCAT
TCNCGGCT	TCCCGGCT
TCCGTTGA	CCGTTGAA
TGCCCATG	TGCCATGT
TCNCTAGC	TCCTAGCG
TCNCTCTC	TCCTCTCT
TCGCAGTC	TCGAGTCC
TGCCCGGC	TCCCGGCT
TGAGCATA	TGAGGCAT
TGAGCATC	TGAGGCAT
TGAGCATG	TGAGGCAT
TGAGCATT	TGAGGCAT
TGAGCATN	TGAGGCAT
TGCCCTGT	TGCCATGT
TGAGCCAT	TGAGGCAT
TGAGCGCA	TGAGGCAT
TGCCGATG	TGCCATGT
TGAGGAAT	TGAGGCAT
TGAGGACA	TGAGGCAT
TGAGGACG	TTAGGACG
TGACAGCA	TTGACAGC
TGACAGCC	TTGACAGC
TGACAGCG	TTGACAGC
TGACAGCT	TTGACAGC
TGACAGCN	TTGACAGC
TGAGGATA	TGAGGCAT
TGAGGATC	TGAGGCAT
TGAGGATG	TGAGGCAT
TGAGGATT	TGAGGCAT
TGAGGATN	TGAGGCAT
TGAGGCAA	TGAGGCAT
TGAGGCAC	TGAGGCAT
TGAGGCAG	TGAGGCAT
TGAGGCAT	TGAGGCAT
TGAGGCAN	TGAGGCAT
TGAGGCCA	TGAGGCAT
TGAGGCCG	AGAGGCCG
TGAGGCCT	TGAGGCAT
TGCCGGCT	TCCCGGCT
TGAGGCGA	TGAGGCAT
TGAGGCGT	TGAGGCAT
TGAGGCTA	TGAGGCAT
TGAGGCTC	TGAGGCAT
TGACATGT	TGCCATGT
TGAGGCTG	TGAGGCAT
TGAGGCTT	TGAGGCAT
TGACATTA	GACATTAT
TGAGGCTN	TGAGGCAT
TGAGGCNA	TGAGGCAT
TGCAAAAT	TGCTAAAT
TGCCGTGT	TGCCATGT
TGAGGCNT	TGAGGCAT
TGCAAAGG	AGCAAAGG
TGAGGGAT	TGAGGCAT
TGAGGGCA	TGAGGCAT
TGCAAATA	TGCTAAAT
TGCAAATC	TGCTAAAT
TGCAAATG	TGCTAAAT
TGCAAATT	TGCTAAAT
TGCAAATN	TGCTAAAT
TGAGGGGT	TGTGGGGT
TGCAACAA	TCAACAAC
TGAGGTAT	TGAGGCAT
TGAGGTCA	TGAGGCAT
TGAGGNAT	TGAGGCAT
TGAGGNCA	TGAGGCAT
TGACCAGC	TAACCAGC
TGCCTAAA	TGCTAAAT
TGCAATGT	TGCCATGT
TGACCATG	TGCCATGT
TGCCTAAT	GCCTAATA
TGCCTAGC	TCCTAGCG
TGAGTCAT	TGAGGCAT
TGAGTCCA	TCGAGTCC
TGAGTCCC	TCGAGTCC
TGAGTCCG	TCGAGTCC
TGAGTCCT	TCGAGTCC
TGAGTCCN	TCGAGTCC
TGCCTATG	TGCCATGT
TGAGTCGA	TGTGTCGA
TGAGTCGG	GAGTCGGT
TGACCCGT	GACCCGTC
TGCACATA	GCACATAG
TGCACATG	TGCCATGT
TGAGTGCA	TGAGGCAT
TCNGAGTC	TCGAGTCC
TCNGTCTG	TCGTCTGG
TGCCTCTC	TCCTCTCT
TGAGTTTA	CGAGTTTA
TGCCTGTA	TGCCATGT
TGCCTGTC	TGCCATGT
TGCCTGTG	TGCCATGT
TGCCTGTT	TGCCATGT
TGCCTGTN	TGCCATGT
TGTCTAAA	TGCTAAAT
TGCCTTGT	TGCCATGT
TGAGNCAT	TGAGGCAT
TGTCTCAG	AGTCTCAG
TGTCTCGA	TGTGTCGA
TGAGNGCA	TGAGGCAT
TGTCTGGA	TCGTCTGG
TGTCTGGC	TCGTCTGG
TGTCTGGG	TCGTCTGG
TGTCTGGT	TCGTCTGG
TGTCTGGN	TCGTCTGG
TGCCNATG	TGCCATGT
TGTCTTGC	TGTTTTGC
TGTCTTTG	TGTTTTGC
TGACGCAT	TGAGGCAT
TGACGCCC	TACGCCCA
TGAAAATT	GAAAATTT
TGATAAAT	TGCTAAAT
TGACGGCA	TGAGGCAT
TGCCNTGT	TGCCATGT
TGCTTAAA	TGCTAAAT
TGACGGTA	TACGGTAT
TGCTTAAT	TGCTAAAT
TGATAAGG	TATAAGGG
TGATAGAA	GATAGAAA
TGACTAAA	TGCTAAAT
TGTTCGAA	TGTGTCGA
TGTTCGAC	TGTGTCGA
TGTTCGAG	TGTGTCGA
TGTTCGAT	TGTGTCGA
TGTTCGAN	TGTGTCGA
TGCTTCTT	AGCTTCTT
TGTGACAG	TTGACAGC
TGTTCTGC	TGTTTTGC
TGAACAAC	TCAACAAC
TGTTCTTG	TGTTTTGC
TGTGACGA	TGTGTCGA
TGTGAGAC	TGGAGACT
TGAACCAG	TAACCAGC
TCNTAGCG	TCCTAGCG
TGTGAGGG	TGTGGGGT
TGTGAGGT	TGTGGGGT
TGATCACT	TTATCACT
TGTGATCG	TGTGTCGA
TGCTTTGC	TGTTTTGC
TGCTTTTG	TGTTTTGC
TGTTGGCG	TATTGGCG
TGTTGGGG	TGTGGGGT
TGTTGGGT	TGTGGGGT
TCNAACAA	TCAACAAC
TGTTGTCG	TGTGTCGA
TGTTGTGC	TGTTTTGC
TGTTGTGG	TTTGTGGA
TGTTGTTG	TGTTTTGC
TGCTNAAA	TGCTAAAT
TGCTNAAT	TGCTAAAT
TGTGCCGA	TGTGTCGA
TGTTTAAA	GTTTAAAG
TGAAGACT	TGGAGACT
TGTGCGAA	TGTGTCGA
TGTGCGAC	TGTGTCGA
TGTGCGAG	TGTGTCGA
TGTGCGAT	TGTGTCGA
TGTTTAGC	TGTTTTGC
TGTGCGAN	TGTGTCGA
TGTTTATG	TGTTTTGC
TGTGCGGG	TGTGGGGT
TGTGCGGT	TGTGGGGT
TGTGCGTT	TTGCGTTC
TCNTCTCT	TCCTCTCT
TGAAGATC	TAAGATCG
TCNTCTGG	TCGTCTGG
TGTTTCGA	TGTGTCGA
TGTTTCGC	TGTTTTGC
TGTGCTCG	TGTGTCGA
TGTTTCTG	TGTTTTGC
TGATGCAT	TGAGGCAT
TGTTTGAC	GTTTGACT
TGTTTGCA	TGTTTTGC
TGTTTGCC	TGTTTTGC
TGTTTGCG	TGTTTTGC
TGTTTGCT	TGTTTTGC
TGTTTGCN	TGTTTTGC
TGTTTGGC	TGTTTTGC
TGTTTGTG	TGTTTTGC
TGAGACAT	TGAGGCAT
TGAAGCAT	TGAGGCAT
TGTTTTAC	TGTTTTGC
TGTTTTAG	TGTTTTGC
TGTTTTCA	TGTTTTGC
TCNACAAC	TCAACAAC
TGTTTTCC	TGTTTTGC
TGTTTTCG	TGTTTTGC
TGTTTTCT	TGTTTTGC
TGTTTTCN	TGTTTTGC
TGTTTTGA	TGTTTTGC
TGTTTTGC	TGTTTTGC
TGTTTTGG	TGTTTTGC
TGTTTTGT	TGTTTTGC
TGTTTTGN	TGTTTTGC
TGTTTTTC	TGTTTTGC
TGTTTTTG	TGTTTTGC
TGTTTTNC	TGTTTTGC
TGTTTTNG	TGTTTTGC
TGAGACTA	TGGAGACT
TGAGACTC	TGGAGACT
TGAGACTG	TGGAGACT
TGCNAAAT	TGCTAAAT
TGAGACTT	TGGAGACT
TGAGACTN	TGGAGACT
TGATGGCA	TGAGGCAT
TGTTTNGC	TGTTTTGC
TGATGGGG	TGTGGGGT
TGTTTNTG	TGTTTTGC
TGAAGGCA	TGAGGCAT
TGAGAGAC	TGGAGACT
TGAGAGCA	TGAGGCAT
TGTGGAGG	TGTGGGGT
TGTGGAGT	TGTGGGGT
TGAAGGGT	GAAGGGTA
TGATGTCG	TGTGTCGA
TGAGATCG	TAAGATCG
TGTGGCAC	GTGGCACC
TGTGGCAT	TGAGGCAT
TGTGGCGA	TGTGTCGA
TGTGGCGG	TGTGGGGT
TGTGGCGT	TGTGGGGT
TGTGGGAG	TGTGGGGT
TGTGGGAT	TGTGGGGT
TGTGGGCG	TGTGGGGT
TGTGGGCT	TGTGGGGT
TGTGGGGA	TGTGGGGT
TGTGGGGC	TGTGGGGT
TGTGGGGG	TGTGGGGT
TGTGGGGT	TGTGGGGT
TGTGGGGN	TGTGGGGT
TGTTNTGC	TGTTTTGC
TGTGGGTA	TGTGGGGT
TGTGGGTC	TGTGGGGT
TGTGGGTG	TGTGGGGT
TGCNATGT	TGCCATGT
TGTGGGTT	TGTGGGGT
TGTTNTTG	TGTTTTGC
TGTGGGTN	TGTGGGGT
TGTGGGNG	TGTGGGGT
TGTGGGNT	TGTGGGGT
TGGTGACT	TGGAGACT
TGATTACA	TAATTACA
TGTGGTCG	TGTGTCGA
TGTGGTGG	TGTGGGGT
TGTGGTGT	TGTGGGGT
TGGTGGGG	TGTGGGGT
TGGTGGTT	AGGTGGTT
TGATTGGC	TATTGGCG
TGTGGNGG	TGTGGGGT
TGTGGNGT	TGTGGGGT
TGGTGTCG	TGTGTCGA
TGCNCATG	TGCCATGT
TGATTTCC	GATTTCCC
TGATTTGC	TGTTTTGC
TGATTTTG	TGTTTTGC
TGTGTACG	TGTGTCGA
TGTGTAGA	TGTGTCGA
TGTGTCAA	TGTGTCGA
TGTGTCAC	TGTGTCGA
TGTGTCAG	TGTGTCGA
TGTGTCAT	TGTGTCGA
TGTGTCAN	TGTGTCGA
TGTGTCCA	TGTGTCGA
TGTGTCGA	TGTGTCGA
TGTGTCGC	TGTGTCGA
TGTGTCGG	TGTGTCGA
TGTGTCGT	TGTGTCGA
TGTGTCGN	TGTGTCGA
TGTGTCTA	TGTGTCGA
TGTGTCTG	TGTGTCGA
TCNAGTCC	TCGAGTCC
TGTGTCNA	TGTGTCGA
TGTGTCNG	TGTGTCGA
TGTGTGAA	TGTGTCGA
TGTGTGAC	TGTGTCGA
TGTAAATA	TGCTAAAT
TGTAAATC	TGCTAAAT
TGTAAATG	TGCTAAAT
TGTAAATT	TGCTAAAT
TGTAAATN	TGCTAAAT
TGTGTGAG	TGTGTCGA
TGTGTGAT	TGTGTCGA
TGTGTGAN	TGTGTCGA
TGTGTGCG	TGTGTCGA
TGGTTTGC	TGTTTTGC
TGTGTGGG	TGTGGGGT
TGTGTGGT	TGTGGGGT
TGGTTTTG	TGTTTTGC
TGTAAGGG	TATAAGGG
TGTGTTCG	TGTGTCGA
TGTGTTGA	TGTGTCGA
TGTGTTGC	TGTTTTGC
TGTGTTTG	TGTTTTGC
TGTGTNCG	TGTGTCGA
TGTGTNGA	TGTGTCGA
TGGGAACC	CGGGAACC
TGTGNCGA	TGTGTCGA
TGTNGGGG	TGTGGGGT
TGTNGGGT	TGTGGGGT
TGTGNGGG	TGTGGGGT
TGTGNGGT	TGTGGGGT
TGGGACTA	TGGAGACT
TGTGNTCG	TGTGTCGA
TGTNGTCG	TGTGTCGA
TGGGACTC	TGGAGACT
TGGGACTG	TGGAGACT
TGGGACTT	TGGAGACT
TGGGACTN	TGGAGACT
TGGGAGAC	TGGAGACT
TGTACCGA	GTACCGAA
TGTTAAAT	TGCTAAAT
TGGNAGAC	TGGAGACT
TGCGAAAT	TGCTAAAT
TGGACACT	TGGAGACT
TGGACAGC	TTGACAGC
TGTNTCGA	TGTGTCGA
TGTTATGC	TGTTTTGC
TGTTATTG	TGTTTTGC
TGGACGAC	TGGAGACT
TGGGCATA	TGAGGCAT
TGGGCATC	TGAGGCAT
TGTNTTGC	TGTTTTGC
TGGGCATG	TGAGGCAT
TGTNTTTG	TGTTTTGC
TGGGCATT	TGAGGCAT
TGGGCATN	TGAGGCAT
TTANGACG	TTAGGACG
TGCGAGAC	TGGAGACT
TGTAGACT	TGGAGACT
TGCGAGTC	TCGAGTCC
TGCGATGT	TGCCATGT
TTANGGAC	TTAGGACG
TGCNTAAA	TGCTAAAT
TTCCAAAA	TTCCAAAA
TGGGCTAA	ATGGGCTA
TGGGCTAC	ATGGGCTA
TGGGCTAG	ATGGGCTA
TGGGCTAT	ATGGGCTA
TGGGCTAN	ATGGGCTA
TGTAGGAC	TTAGGACG
TGTAGGCA	TGAGGCAT
TGTAGGGG	TGTGGGGT
TGTAGGGT	TGTGGGGT
TTCCAAAC	TTCCAAAA
TTCCAAAG	TTCCAAAA
TTCCAAAT	TTCCAAAA
TTCCAAAN	TTCCAAAA
TTCCAACA	TTCCAAAA
TGTAGTCA	CTGTAGTC
TGTAGTCC	CTGTAGTC
TGCGCATG	TGCCATGT
TGTAGTCT	CTGTAGTC
TGTAGTCN	CTGTAGTC
TTCCAAGA	TTCCAAAA
TGGAGAAC	TGGAGACT
TGGAGAAT	TGGAGACT
TGGGGACT	TGGAGACT
TGGAGACA	TGGAGACT
TGGAGACC	TGGAGACT
TGGAGACG	TGGAGACT
TGGNGACT	TGGAGACT
TGGAGACT	TGGAGACT
TTANTCAC	TTATCACT
TGGAGACN	TGGAGACT
TGGAGAGC	TGGAGACT
TGGAGAGT	TGGAGACT
TGGAGATA	TGGAGACT
TGGAGATC	TGGAGACT
TGGAGATG	TGGAGACT
TGGAGATT	TGGAGACT
TGGAGATN	TGGAGACT
TGCGCCCA	TACGCCCA
TGGGGCAT	TGAGGCAT
TGCGCCGG	GCGCCGGG
TTCCAATA	TTCCAAAA
TTCCAANA	TTCCAAAA
TGCGCGAA	GCGCGAAG
TTCCACAA	TTCCAAAA
TGGAGANC	TGGAGACT
TGGAGANT	TGGAGACT
TGGAGCAC	TGGAGACT
TGGAGCCT	TGGAGACT
TGGAGCTA	TGGAGACT
TGGAGCTC	TGGAGACT
TGGAGCTG	TGGAGACT
TGTATCAC	TTATCACT
TGGAGCTT	TGGAGACT
TGGAGCTN	TGGAGACT
TGGAGGAC	TGGAGACT
TGGAGGCA	TGAGGCAT
TGGAGGCT	TGGAGACT
TGGGGGGT	TGTGGGGT
TGGGGGTA	TGTGGGGT
TGGGGGTC	TGTGGGGT
TTCCAGAA	TTCCAAAA
TGGGGGTG	TGTGGGGT
TGTATCGA	TGTGTCGA
TGGGGGTT	TGTGGGGT
TGGGGGTN	TGTGGGGT
TGGAGTAC	TGGAGACT
TTCCATAA	TTCCAAAA
TGGAGTCC	TCGAGTCC
TGGAGTCT	TGGAGACT
TGGAGNAC	TGGAGACT
TGGGTAGG	CGGGTAGG
TTCCATGT	TGCCATGT
TGTATTGC	TGTTTTGC
TGGAGNCT	TGGAGACT
TTCCANAA	TTCCAAAA
TGGGTCGA	TGTGTCGA
TGTATTTG	TGTTTTGC
TTCCCAAA	TTCCAAAA
TGGATACT	TGGAGACT
TGCGGCAT	TGAGGCAT
TTCAAAAA	TTCCAAAA
TTCAAAAC	TTCCAAAA
TTCAAAAG	TTCCAAAA
TTCAAAAT	TTCCAAAA
TTCAAAAN	TTCCAAAA
TTCAAATG	GTCAAATG
TTCAACAA	TCAACAAC
TGCGGGGT	TGTGGGGT
TTCAACCA	ATTCAACC
TGGATGAC	TGGAGACT
TTCAACCC	ATTCAACC
TTCAACCG	ATTCAACC
TTCAACCT	ATTCAACC
TTCAACCN	ATTCAACC
TGCGGTAT	TACGGTAT
TTCCCGGC	TCCCGGCT
TGGAAACT	TGGAGACT
TGCGTAAA	TGCTAAAT
TTCACAAA	TTCCAAAA
TTCACAGC	TTGACAGC
TGGAACTA	TGGAGACT
TGGAACTC	TGGAGACT
TGGAACTG	TGGAGACT
TGGAACTT	TGGAGACT
TGGAACTN	TGGAGACT
TTCCGAAA	TTCCAAAA
TGGAAGAC	TGGAGACT
TGTCAAAT	GTCAAATG
TGGTAAAT	TGCTAAAT
TGCGTCGA	TGTGTCGA
TGCGTCTG	TCGTCTGG
TTACCAAA	TTCCAAAA
TGGANACT	TGGAGACT
TTACCACT	TTATCACT
TTACCAGC	TAACCAGC
TGCGTGTT	GCGTGTTA
TTCCGCCA	ATCCGCCA
TGTCAGGC	GTCAGGCT
TGCGTTCA	TTGCGTTC
TGCGTTCC	TTGCGTTC
TGCGTTCG	TTGCGTTC
TGCGTTCT	TTGCGTTC
TGCGTTCN	TTGCGTTC
TTACCGAA	GTACCGAA
TGGTAGAC	TGGAGACT
TTACCGGA	CTTACCGG
TTACCGGC	CTTACCGG
TTACCGGG	CTTACCGG
TTACCGGT	CTTACCGG
TTACCGGN	CTTACCGG
TGGANGAC	TGGAGACT
TGTCATGT	TGCCATGT
TTCCGGCT	TCCCGGCT
TTCCGTTC	TTGCGTTC
TGTCCAAA	TTCCAAAA
TTACGACG	TTAGGACG
TTCAGGAC	TTAGGACG
TTCAGGCT	GTCAGGCT
TTCCTAAA	TTCCAAAA
TTACGCCC	TACGCCCA
TGTCCATG	TGCCATGT
TTCCTAGC	TCCTAGCG
TGCTAAAA	TGCTAAAT
TGCTAAAC	TGCTAAAT
TGCTAAAG	TGCTAAAT
TGCTAAAT	TGCTAAAT
TTACGGAC	TTAGGACG
TGCTAAAN	TGCTAAAT
TGCTAACA	TGCTAAAT
TGCTAACT	TGCTAAAT
TGCTAAGA	TGCTAAAT
TGCTAAGT	TGCTAAAT
TTACGGTA	TACGGTAT
TGCTAATA	TGCTAAAT
TGCTAATC	TGCTAAAT
TGCTAATG	TGCTAAAT
TGGCACCA	GTGGCACC
TGGCACCC	GTGGCACC
TGGCACCG	GTGGCACC
TGGCACCT	GTGGCACC
TGGCACCN	GTGGCACC
TGCTAATT	TGCTAAAT
TGCTAATN	TGCTAAAT
TGCTAANA	TGCTAAAT
TGTCCGAA	TTGTCCGA
TGTCCGAC	TTGTCCGA
TGCTAANT	TGCTAAAT
TGCTACAA	TGCTAAAT
TGTCCGAG	TTGTCCGA
TGTCCGAT	TTGTCCGA
TGTCCGAN	TTGTCCGA
TGCTACAT	TGCTAAAT
TGGCAGAC	TGGAGACT
TTACGTTC	TTGCGTTC
TTCCTCTC	TCCTCTCT
TTCCTGAA	ATTCCTGA
TTCCTGAC	ATTCCTGA
TGGTCCGA	TTGTCCGA
TTCCTGAG	ATTCCTGA
TTCCTGAT	ATTCCTGA
TTCCTGAN	ATTCCTGA
TTCATCAC	TTATCACT
TGCTAGAA	TGCTAAAT
TGGTCGAA	TGTGTCGA
TGGTCGAC	TGTGTCGA
TGCTAGAT	TGCTAAAT
TGGTCGAG	TGTGTCGA
TGGTCGAT	TGTGTCGA
TGGTCGAN	TGTGTCGA
TGCTAGCG	TCCTAGCG
TGCTAGCT	GCTAGCTC
TGNCTAAA	TGCTAAAT
TGCTATAA	TGCTAAAT
TGGCATGT	TGCCATGT
TGCTATAT	TGCTAAAT
TTACTCAC	TTATCACT
TGCTATGT	TGCCATGT
TGCTANAA	TGCTAAAT
TGCTANAT	TGCTAAAT
TGGTCTGG	TCGTCTGG
TGCTCAAA	TGCTAAAT
TGCTCAAT	TGCTAAAT
TGGCCATG	TGCCATGT
TTCCNAAA	TTCCAAAA
TGCTCATG	TGCCATGT
TGTCGCTA	ATGTCGCT
TGTCGCTC	ATGTCGCT
TGTCGCTG	ATGTCGCT
TGTCGCTT	ATGTCGCT
TGTCGCTN	ATGTCGCT
TGTCGGGG	TGTGGGGT
TGTCGGGT	TGTGGGGT
TGCTCTCT	TCCTCTCT
TGGCGACT	TGGAGACT
TTCGAAAA	TTCCAAAA
TGTCGTCG	TGTGTCGA
TGCTGAAA	TGCTAAAT
TGCTGAAT	TGCTAAAT
TTCGACAG	TTGACAGC
TTCGACTT	ATCGACTT
TTTGCGGA	TTTGTGGA
TTTGCGTT	TTGCGTTC
TTAGNACG	TTAGGACG
TTCGAGTC	TCGAGTCC
TGGCGTTC	TTGCGTTC
TTTGCTGG	TTTGTGGA
TGCTGGGG	TGTGGGGT
TGGCTAAA	TGCTAAAT
TTAGAACG	TTAGGACG
TTCGCAAA	TTCCAAAA
TGCTGTCG	TGTGTCGA
TTAGACAG	TTGACAGC
TTAGNGAC	TTAGGACG
TTCGCCCA	TACGCCCA
TTAGACGA	TTAGGACG
TTAGACGC	TTAGGACG
TTAGACGG	TTAGGACG
TTAGACGT	TTAGGACG
TTAGACGN	TTAGGACG
TTTGGACG	TTAGGACG
TTAGAGAC	TTAGGACG
TGGCTTAA	AGGCTTAA
TTCGCGTT	TTGCGTTC
TTTGGCGA	TATTGGCG
TTTGGCGC	TATTGGCG
TTTGGCGG	TATTGGCG
TTTGGCGT	TATTGGCG
TTTGGCGN	TATTGGCG
TGNGAGAC	TGGAGACT
TTTGGGAA	TTTGTGGA
TTTGGGAC	TTTGTGGA
TTTGGGAG	TTTGTGGA
TTTGGGAT	TTTGTGGA
TTTGGGAN	TTTGTGGA
TTAGATCG	TAAGATCG
TTTGGGGA	TTTGTGGA
TTTGGGGT	TGTGGGGT
TTTGGTGG	TTTGTGGA
TTCGGAAA	ATCGGAAA
TTCGGACG	TTAGGACG
TTATAACT	TTATCACT
TTATAAGG	TATAAGGG
TGNTAAAT	TGCTAAAT
TTATACAC	TTATCACT
TTTGTAGA	TTTGTGGA
TTTGTAGG	TTTGTGGA
TTATACTA	TTATCACT
TTATACTC	TTATCACT
TTATACTG	TTATCACT
TTATACTT	TTATCACT
TTATACTN	TTATCACT
TTTGTCCG	TTGTCCGA
TTTGTCGG	TTTGTGGA
TTAGCACG	TTAGGACG
TTAGCACT	TTATCACT
TTCGGTAT	TACGGTAT
TTTGTGAA	TTTGTGGA
TTTGTGAC	TTTGTGGA
TTTGTGAG	TTTGTGGA
TTTGTGAT	TTTGTGGA
TTTGTGAN	TTTGTGGA
TTTGTGCA	TTTGTGGA
TTTGTGCG	TTTGTGGA
TTTGTGGA	TTTGTGGA
TTTGTGGC	TTTGTGGA
TTTGTGGG	TTTGTGGA
TTTGTGGT	TTTGTGGA
TTTGTGGN	TTTGTGGA
TTTGTGTA	TTTGTGGA
TTTGTGTG	TTTGTGGA
TTATATCA	ATTATATC
TTTGTGNA	TTTGTGGA
TTATATCC	ATTATATC
TTATATCG	ATTATATC
TTTGTGNG	TTTGTGGA
TTATATCT	ATTATATC
TTATATCN	ATTATATC
TTTGTTGA	TTTGTGGA
TTTGTTGG	TTTGTGGA
TTAGCGAC	TTAGGACG
TTTGTNGA	TTTGTGGA
TTTGTNGG	TTTGTGGA
TTAGCGTT	TTGCGTTC
TTATCAAC	TTATCACT
TTATCAAT	TTATCACT
TTATCACA	TTATCACT
TTATCACC	TTATCACT
TTATCACG	TTATCACT
TTATCACT	TTATCACT
TTATCACN	TTATCACT
TTAACAAC	TCAACAAC
TTATCAGC	TTATCACT
TTAACACT	TTATCACT
TTATCAGT	TTATCACT
TTATCATA	TTATCACT
TTAACAGC	TTGACAGC
TTATCATC	TTATCACT
TTATCATG	TTATCACT
TTATCATT	TTATCACT
TTATCATN	TTATCACT
TTATCANC	TTATCACT
TTATCANT	TTATCACT
TTATCCAC	TTATCACT
TTAACCAG	TAACCAGC
TTATCCCT	TTATCACT
TTATCCGA	TTGTCCGA
TTAGGAAC	TTAGGACG
TTATCCTA	TTATCACT
TTAGGAAG	TTAGGACG
TTATCCTC	TTATCACT
TTATCCTG	TTATCACT
TTAGGACA	TTAGGACG
TTATCCTT	TTATCACT
TTAGGACC	TTAGGACG
TTATCCTN	TTATCACT
TTAGGACG	TTAGGACG
TTATCGAC	TTATCACT
TTAGGACT	TTAGGACG
TTAGGACN	TTAGGACG
TTAGGAGA	TTAGGACG
TTAGGAGC	TTAGGACG
TTAGGAGG	TTAGGACG
TTAGGAGT	TTAGGACG
TTATCGCT	TTATCACT
TTAGGAGN	TTAGGACG
TTAGGATC	TTAGGACG
TTAGGATG	TTAGGACG
TTAGGANC	TTAGGACG
TTAGGANG	TTAGGACG
TTAGGCAC	TTAGGACG
TTAGGCAT	TGAGGCAT
TTTGNGGA	TTTGTGGA
TTAGGCCG	TTAGGACG
TTATCTAC	TTATCACT
TTAGGCGA	TTAGGACG
TTAGGCGC	TTAGGACG
TTAGGCGG	TTAGGACG
TTAGGCGT	TTAGGACG
TTAGGCGN	TTAGGACG
TTATCTCT	TTATCACT
TTAGGGAC	TTAGGACG
TTAGGGCG	TTAGGACG
TGNGGCAT	TGAGGCAT
TTAGGTAC	TTAGGACG
TTATCNAC	TTATCACT
TTAAGACG	TTAGGACG
TTAGGTCG	TTAGGACG
TTAAGATC	TAAGATCG
TTATCNCT	TTATCACT
TTAGGNAC	TTAGGACG
TGNGGGGT	TGTGGGGT
TTTGNTGG	TTTGTGGA
TTAGGNCG	TTAGGACG
TTAAGGAC	TTAGGACG
TTATGACG	TTAGGACG
TTATGACT	TTATCACT
TTAAGGGA	TATAAGGG
TTAAGGGC	TATAAGGG
TTAAGGGG	TATAAGGG
TTAAGGGT	TATAAGGG
TTAAGGGN	TATAAGGG
TTAGTACG	TTAGGACG
TTATGCAA	CTATGCAA
TTATGCAC	TTATCACT
TTTTAAAG	GTTTAAAG
TTATGGAC	TTAGGACG
TTAGTCAC	TTATCACT
TTAGTCCG	TTGTCCGA
TTAGTGAC	TTAGGACG
TTATGTGG	TTTGTGGA
TTAATCAC	TTATCACT
TTAGTGGA	TTTGTGGA
TTAATGAA	CTTAATGA
TTAATGAC	CTTAATGA
TTAATGAG	CTTAATGA
TTAATGAT	CTTAATGA
TTAATGAN	CTTAATGA
TTATTACA	TAATTACA
TTATTACT	TTATCACT
TTTTCACT	TTATCACT
TTAATTAC	TAATTACA
TTATTCAC	TTATCACT
TTTTCCGA	TTGTCCGA
TGNAGACT	TGGAGACT
TTGNACAG	TTGACAGC
TGNGTCGA	TGTGTCGA
TTATTGGC	TATTGGCG
TGNTGGGG	TGTGGGGT
TGNAGGCA	TGAGGCAT
TGNTGTCG	TGTGTCGA
TTTTGACT	GTTTGACT
TTATNACT	TTATCACT
TTATNCAC	TTATCACT
TTGNCAGC	TTGACAGC
TGNTTTGC	TGTTTTGC
TGNTTTTG	TGTTTTGC
TTTNGTGG	TTTGTGGA
TTGNCCGA	TTGTCCGA
TTTTGGAA	TTTGTGGA
TTTTGGAC	TTTGTGGA
TTTTGGAG	TTTGTGGA
TTTTGGAT	TTTGTGGA
TTTTGGAN	TTTGTGGA
TTACAAAA	TTCCAAAA
TTTTGGCG	TATTGGCG
TTGNCGTT	TTGCGTTC
TTTTGTGG	TTTGTGGA
TTTNTGGA	TTTGTGGA
TTACACTA	TTATCACT
TTACACTC	TTATCACT
TTACACTG	TTATCACT
TTACACTT	TTATCACT
TTACACTN	TTATCACT
TTACAGCA	TTGACAGC
TTACAGCC	TTGACAGC
TTACAGCG	TTGACAGC
TTACAGCT	TTGACAGC
TTACAGCN	TTGACAGC
TTTTTGCA	TGTTTTGC
TTTTTGCC	TGTTTTGC
TTTTTGCG	TGTTTTGC
TTTTTGCT	TGTTTTGC
TTTTTGCN	TGTTTTGC
TTTTTGGA	TTTGTGGA
TTTTTTGC	TGTTTTGC
TTGNGTTC	TTGCGTTC
TTGGGACG	TTAGGACG
TTCNCAAA	TTCCAAAA
TTGGGCTA	ATGGGCTA
TNCAACAA	TCAACAAC
TTGNTCCG	TTGTCCGA
TTGGGGTA	TGTGGGGT
TTGGGGTC	TGTGGGGT
TTGGGGTG	TGTGGGGT
TTGGGGTT	TGTGGGGT
TTGGGGTN	TGTGGGGT
TTANCACT	TTATCACT
TTGGGTTC	TTGCGTTC
TGNCATGT	TGCCATGT
TTGANAGC	TTGACAGC
TTGANCAG	TTGACAGC
TTGGTCCG	TTGTCCGA
TGNCCATG	TGCCATGT
TTGGTGGA	TTTGTGGA
TTTATATC	ATTATATC
TTGGTTCA	TTGCGTTC
TTGGTTCC	TTGCGTTC
TTGGTTCG	TTGCGTTC
TTGGTTCT	TTGCGTTC
TTGGTTCN	TTGCGTTC
TTNACAGC	TTGACAGC
TTGCAAAA	TTCCAAAA
TTTATCAC	TTATCACT
TTGCACAG	TTGACAGC
TTTAAAGA	GTTTAAAG
TTTAAAGC	GTTTAAAG
TTTAAAGG	GTTTAAAG
TTTAAAGT	GTTTAAAG
TTTAAAGN	GTTTAAAG
TTTATGGA	TTTGTGGA
TNCCTAGC	TCCTAGCG
TTCGTCCG	TTGTCCGA
TTGCAGCA	TTGACAGC
TNCCTCTC	TCCTCTCT
TTGCAGCC	TTGACAGC
TTGCAGCG	TTGACAGC
TTCGTCTG	TCGTCTGG
TTGCAGCT	TTGACAGC
TTGCAGCN	TTGACAGC
TTTAAGGG	TATAAGGG
TTGCAGTT	TTGCGTTC
TTCGTGGA	TTTGTGGA
TTTAATGA	CTTAATGA
TTGCATTC	TTGCGTTC
TTCGTTCA	TTGCGTTC
TTCGTTCC	TTGCGTTC
TTCGTTCG	TTGCGTTC
TTCGTTCT	TTGCGTTC
TTCGTTCN	TTGCGTTC
TTGTACAG	TTGACAGC
TTGTACCG	TTGTCCGA
TTGTACGA	TTGTCCGA
TTGCCAAA	TTCCAAAA
TTGTAGTC	CTGTAGTC
TTGCCAGC	TTGACAGC
TTTACAGC	TTGACAGC
TTGCCATG	TGCCATGT
TTGCCCGA	TTGTCCGA
TTTCAAAA	TTCCAAAA
TTTCAACC	ATTCAACC
TTTACCGG	CTTACCGG
TTGCCGAA	TTGTCCGA
TTGCCGAC	TTGTCCGA
TTGCCGAG	TTGTCCGA
TTGCCGAT	TTGTCCGA
TTGCCGAN	TTGTCCGA
TTGCCGTT	TTGCGTTC
TTTCACTA	TTATCACT
TTTCACTC	TTATCACT
TTTCACTG	TTATCACT
TTTCACTT	TTATCACT
TTTCACTN	TTATCACT
TTGTCACG	TTGTCCGA
TTGTCACT	TTATCACT
TTGTCAGA	TTGTCCGA
TTGTCAGC	TTGACAGC
TTGTCCAA	TTGTCCGA
TTGTCCAC	TTGTCCGA
TTGTCCAG	TTGTCCGA
TTGTCCAT	TTGTCCGA
TTGTCCAN	TTGTCCGA
TTGTCCCA	TTGTCCGA
TTGCCTTC	TTGCGTTC
TTGTCCCG	TTGTCCGA
TTGTCCGA	TTGTCCGA
TTGTCCGC	TTGTCCGA
TTGTCCGG	TTGTCCGA
TTGTCCGT	TTGTCCGA
TTCTAAAA	TTCCAAAA
TTCTAAAT	TGCTAAAT
TTGTCCGN	TTGTCCGA
TTGTCCTA	TTGTCCGA
TTGTCCTG	TTGTCCGA
TTGTCCNA	TTGTCCGA
TTGTCCNG	TTGTCCGA
TTGTCGCG	TTGTCCGA
TTTCCAAA	TTCCAAAA
TTGTCGCT	ATGTCGCT
TTGTCGGA	TTGTCCGA
TTGCGATC	TTGCGTTC
TTGCGATT	TTGCGTTC
TTCTAGCG	TCCTAGCG
TTGTCGTT	TTGCGTTC
TTGTCTCG	TTGTCCGA
TTTCCGAA	TTGTCCGA
TTGAAAGC	TTGACAGC
TTTCCGAC	TTGTCCGA
TTTCCGAG	TTGTCCGA
TTGCGCTC	TTGCGTTC
TTTCCGAT	TTGTCCGA
TTTCCGAN	TTGTCCGA
TTGCGCTT	TTGCGTTC
TTGTCTGA	TTGTCCGA
TTGAACAG	TTGACAGC
TTGTCTGG	TCGTCTGG
TTCTCAAA	TTCCAAAA
TNCGAGTC	TCGAGTCC
TTTAGGAC	TTAGGACG
TTCTCACT	TTATCACT
TTGCGGTC	TTGCGTTC
TTCTCCAT	CTCTCCAT
TTGTCNCG	TTGTCCGA
TTGTCNGA	TTGTCCGA
TTGCGGTT	TTGCGTTC
TTTCCTGA	ATTCCTGA
TTCTCCGA	TTGTCCGA
TTTAGTGG	TTTGTGGA
TTGCGTAC	TTGCGTTC
TTGCGTAT	TTGCGTTC
TTGAAGCA	TTGACAGC
TNCCAAAA	TTCCAAAA
TTGAAGCC	TTGACAGC
TTGAAGCG	TTGACAGC
TTGAAGCT	TTGACAGC
TTGCGTCA	TTGCGTTC
TTGAAGCN	TTGACAGC
TTGCGTCC	TTGCGTTC
TTGCGTCG	TTGCGTTC
TTGCGTCT	TTGCGTTC
TTGCGTCN	TTGCGTTC
TTCTCTCT	TCCTCTCT
TTGCGTGC	TTGCGTTC
TTGCGTGT	TTGCGTTC
TTGCGTTA	TTGCGTTC
TTGCGTTC	TTGCGTTC
TTGCGTTG	TTGCGTTC
TTGCGTTT	TTGCGTTC
TTGCGTTN	TTGCGTTC
TTGCGTNC	TTGCGTTC
TTGCGTNT	TTGCGTTC
TTGTGCCG	TTGTCCGA
TTGTGCGA	TTGTCCGA
TTGCGNTC	TTGCGTTC
TTGCGNTT	TTGCGTTC
TTGTGGAA	TTTGTGGA
TTGTGGAC	TTTGTGGA
TTGTGGAG	TTTGTGGA
TTGTGGAT	TTTGTGGA
TTGTGGAN	TTTGTGGA
TTGCTAAA	TGCTAAAT
TTGACAAC	TTGACAGC
TTGACAAG	TTGACAGC
TTGTGGGG	TGTGGGGT
TTGACACA	TTGACAGC
TTGACACC	TTGACAGC
TTGACACG	TTGACAGC
TTGACACT	TTGACAGC
TTGACACN	TTGACAGC
TTGACAGA	TTGACAGC
TTGACAGC	TTGACAGC
TTGACAGG	TTGACAGC
TTGACAGT	TTGACAGC
TTGACAGN	TTGACAGC
TTGACATC	TTGACAGC
TTGACATG	TTGACAGC
TNCGCCCA	TACGCCCA
TTGACANC	TTGACAGC
TTGACANG	TTGACAGC
TNCCATGT	TGCCATGT
TTGACCAG	TTGACAGC
TTGTGTCG	TGTGTCGA
TTGTGTGG	TTTGTGGA
TTGACCGA	TTGTCCGA
TTGACCGC	TTGACAGC
TTGTGTTC	TTGCGTTC
TTGCTCCG	TTGTCCGA
TTCTGTGG	TTTGTGGA
TTGACGAG	TTGACAGC
TTGACGCA	TTGACAGC
TTGACGCC	TTGACAGC
TTGACGCG	TTGACAGC
TTGACGCT	TTGACAGC
TTGACGCN	TTGACAGC
TTGACGGC	TTGACAGC
TTGACGTT	TTGCGTTC
TTGACTAG	TTGACAGC
TTGCTGTT	TTGCGTTC
TTGACTGC	TTGACAGC
TTGCTTCA	TTGCGTTC
TTGCTTCC	TTGCGTTC
TTGCTTCG	TTGCGTTC
TTGCTTCT	TTGCGTTC
TTGCTTCN	TTGCGTTC
TTGCTTTC	TTGCGTTC
TTGACNAG	TTGACAGC
TTGACNGC	TTGACAGC
TTTCGTGG	TTTGTGGA
TTGAGACT	TGGAGACT
TTGAGAGC	TTGACAGC
TTTCGTTC	TTGCGTTC
TTGAGCAG	TTGACAGC
TTCTTTAA	CTCTTTAA
TTGTTCCG	TTGTCCGA
TTGTTCGA	TTGTCCGA
TTGAGGAC	TTAGGACG
TTGAGGCA	TGAGGCAT
TTGCNGTT	TTGCGTTC
TNCCCGGC	TCCCGGCT
TTGTTTTG	TGTTTTGC
TTGAGTCC	TCGAGTCC
TNAGATCG	TAAGATCG
TTGCNTTC	TTGCGTTC
TTGAGTTC	TTGCGTTC
TNCGGTAT	TACGGTAT
TTTCTGGA	TTTGTGGA
TTGATAGC	TTGACAGC
TTGTNCCG	TTGTCCGA
TTGTNCGA	TTGTCCGA
TTGATCAC	TTATCACT
TTGATCAG	TTGACAGC
TTGATCCG	TTGTCCGA
TTCNAAAA	TTCCAAAA
TTGGACAG	TTGACAGC
TNCCGGCT	TCCCGGCT
TTGGACGA	TTAGGACG
TTGGACGC	TTAGGACG
TTGGACGG	TTAGGACG
TTGGACGT	TTAGGACG
TTGGACGN	TTAGGACG
TTGGAGAC	TGGAGACT
TNAGGACG	TTAGGACG
TNAACAAC	TCAACAAC
TNAGGCAT	TGAGGCAT
TTNGACAG	TTGACAGC
TNCGTCTG	TCGTCTGG
TNAACCAG	TAACCAGC
TTGGCACC	GTGGCACC
TTGGCAGC	TTGACAGC
TTNAGGAC	TTAGGACG
TTGGCCGA	TTGTCCGA
TTGGCGTT	TTGCGTTC
TTNGCGTT	TTGCGTTC
TTTGACAG	TTGACAGC
TNAAGATC	TAAGATCG
TTTGACTA	GTTTGACT
TTTGACTC	GTTTGACT
TTTGACTG	GTTTGACT
TTTGACTT	GTTTGACT
TTTGACTN	GTTTGACT
TTNATCAC	TTATCACT
TTNGGACG	TTAGGACG
TTTGAGGA	TTTGTGGA
TTTGATGG	TTTGTGGA
TTNGTCCG	TTGTCCGA
TNCTAAAT	TGCTAAAT
TTNGTGGA	TTTGTGGA
TNCTAGCG	TCCTAGCG
TNATAAGG	TATAAGGG
TNAATTAC	TAATTACA
TNATTACA	TAATTACA
TTNCAAAA	TTCCAAAA
TNTTGGCG	TATTGGCG
TNATTGGC	TATTGGCG
TNTTGTGG	TTTGTGGA
TNATCACT	TTATCACT
TTNCCAAA	TTCCAAAA
TNTTTTGC	TGTTTTGC
TTNTCACT	TTATCACT
TTNTCCGA	TTGTCCGA
TNACCAGC	TAACCAGC
TTNCGTTC	TTGCGTTC
TTNTGTGG	TTTGTGGA
TNTAAGGG	TATAAGGG
TNACGCCC	TACGCCCA
TNACGGTA	TACGGTAT
NACATTAT	GACATTAT
TNTAGGAC	TTAGGACG
TNCTCTCT	TCCTCTCT
TNGCGTTC	TTGCGTTC
TNGACAGC	TTGACAGC
TNTATCAC	TTATCACT
TNGCTAAA	TGCTAAAT
NACCAGAG	CACCAGAG
TNTCCAAA	TTCCAAAA
TNGAGACT	TGGAGACT
NACCCGAA	ACCCGAAC
NACCCGTC	GACCCGTC
TNGTCCGA	TTGTCCGA
TNGAGGCA	TGAGGCAT
NACCCTGG	AACCCTGG
TNGAGTCC	TCGAGTCC
TNGTCTGG	TCGTCTGG
TNGGAGAC	TGGAGACT
NAAGGGTA	GAAGGGTA
NAAGGTCC	CAAGGTCC
TNGTGGGG	TGTGGGGT
TNGTGTCG	TGTGTCGA
NAAGTTGC	AAGTTGCG
TNGTTTTG	TGTTTTGC
NACCTTCG	CACCTTCG
NACGCCCA	TACGCCCA
NAATAGCT	AATAGCTT
TNTGACAG	TTGACAGC
NACGATAC	ACGATACG
TNGCCATG	TGCCATGT
NACGGTAT	TACGGTAT
NATTGGCG	TATTGGCG
NAATGACC	AATGACCG
NATTTCCC	GATTTCCC
NAATGTAG	AAATGTAG
TNTGCGTT	TTGCGTTC
NAATTACA	TAATTACA
NAATTCGT	GAATTCGT
TNTGGGGT	TGTGGGGT
TNTGTCCG	TTGTCCGA
TNTGTCGA	TGTGTCGA
TNTGTGGA	TTTGTGGA
NACTAAGC	ACTAAGCG
NATAGAAA	GATAGAAA
NACTAGTT	CACTAGTT
NATAGCTT	AATAGCTT
NAAAACAT	AAAACATG
NAAAATCC	AAAATCCC
NAAAATTT	GAAAATTT
NAAACATG	AAAACATG
NAAACGTT	AAACGTTC
NAAACTAA	AAACTAAC
NAACCAGC	TAACCAGC
NAACCCTG	AACCCTGG
NAACGTTC	AAACGTTC
NAACTAAC	AAACTAAC
NAAATCCC	AAAATCCC
NAAATGTA	AAATGTAG
NAAATTGG	CAAATTGG
NCCCGAAC	ACCCGAAC
NCCCGGCT	TCCCGGCT
NAGAGGCC	AGAGGCCG
NAAGATCG	TAAGATCG
NAGATAAT	CAGATAAT
NATCCGCC	ATCCGCCA
NAGGCTTA	AGGCTTAA
NATCGACT	ATCGACTT
NATCGGAA	ATCGGAAA
NAGTTGCG	AAGTTGCG
NACAGATC	CACAGATC
NCCGACGG	CCGACGGA
NACAGGAC	ACAGGACT
NAGCAAAG	AGCAAAGG
NCCGCCCT	CCGCCCTA
NAGGTGGT	AGGTGGTT
NATGACCG	AATGACCG
NCCGGGCG	CCGGGCGT
NCATCCAT	GCATCCAT
NCCGTTGA	CCGTTGAA
NAGTCGGT	GAGTCGGT
NAGTCTCA	AGTCTCAG
NATGGGCT	ATGGGCTA
NAGCTTCT	AGCTTCTT
NATGTCGC	ATGTCGCT
NCCTAATA	GCCTAATA
NCCTAGCG	TCCTAGCG
NCATTGTC	CCATTGTC
NATTATAT	ATTATATC
NCCTCTCT	TCCTCTCT
NATTCAAC	ATTCAACC
NATTCCTG	ATTCCTGA
NCAAAGAG	CCAAAGAG
NATAAGGG	TATAAGGG
NCCTGGTA	CCTGGTAC
NCAAATTG	CAAATTGG
NCAACAAC	TCAACAAC
NCACTAGT	CACTAGTT
NCCAAAGA	CCAAAGAG
NCAAGGTC	CAAGGTCC
NCCAATTT	CCCAATTT
NCCACCGT	CCCACCGT
NCAGATAA	CAGATAAT
NCACAGAT	CACAGATC
NCACATAG	GCACATAG
NCACCAGA	CACCAGAG
NCACCTTC	CACCTTCG
NCAGGACT	ACAGGACT
NGCGCCGG	GCGCCGGG
NGCGCGAA	GCGCGAAG
NCCATTGT	CCATTGTC
NCTCTCCA	CTCTCCAT
NCTCTTTA	CTCTTTAA
NCGTCTGG	TCGTCTGG
NCCCAATT	CCCAATTT
NCCCACCG	CCCACCGT
NGCGTGTT	GCGTGTTA
NCGTGTTA	GCGTGTTA
NCGTTGAA	CCGTTGAA
NCGCCCTA	CCGCCCTA
NCGCCGGG	GCGCCGGG
NCTGGTAC	CCTGGTAC
NGCTAAAT	TGCTAAAT
NCGCGAAG	GCGCGAAG
NGCTAGCT	GCTAGCTC
NCTGTAGT	CTGTAGTC
NGATTTCC	GATTTCCC
NCGACGGA	CCGACGGA
NGAAGGGT	GAAGGGTA
NGAATTCG	GAATTCGT
NCTTAATG	CTTAATGA
NCTTACCG	CTTACCGG
NCGAGTCC	TCGAGTCC
NCGAGTTT	CGAGTTTA
NCGATACG	ACGATACG
NCGGGAAC	CGGGAACC
NGCTTCTT	AGCTTCTT
NGACATTA	GACATTAT
NCGGGCGT	CCGGGCGT
NCTAAGCG	ACTAAGCG
NGACCCGT	GACCCGTC
NCGGGTAG	CGGGTAGG
NCTAGCTC	GCTAGCTC
NGCAAAGG	AGCAAAGG
NCTATGCA	CTATGCAA
NGCACATA	GCACATAG
NTCGGAAA	ATCGGAAA
NTCGTCTG	TCGTCTGG
NGAGGCAT	TGAGGCAT
NGAGGCCG	AGAGGCCG
NGAAAATT	GAAAATTT
NGTCTCAG	AGTCTCAG
NGCATCCA	GCATCCAT
NGGTGGTT	AGGTGGTT
NGAGTCGG	GAGTCGGT
NGAGTTTA	CGAGTTTA
NGGCTTAA	AGGCTTAA
NGATAGAA	GATAGAAA
NTCTCCAT	CTCTCCAT
NGCCATGT	TGCCATGT
NGGGAACC	CGGGAACC
NGTGGCAC	GTGGCACC
NGTGGGGT	TGTGGGGT
NTCTTTAA	CTCTTTAA
NGTGTCGA	TGTGTCGA
NGCCTAAT	GCCTAATA
NGGAGACT	TGGAGACT
NGGGTAGG	CGGGTAGG
NGTACCGA	GTACCGAA
NTACCGAA	GTACCGAA
NTACGCCC	TACGCCCA
NTACGGTA	TACGGTAT
NGTTTAAA	GTTTAAAG
NGTCAAAT	GTCAAATG
NGTTTGAC	GTTTGACT
NTCAAATG	GTCAAATG
NTCAACAA	TCAACAAC
NGTCAGGC	GTCAGGCT
NGTTTTGC	TGTTTTGC
NTAACCAG	TAACCAGC
NTGACAGC	TTGACAGC
NTAAGATC	TAAGATCG
NTGAGGCA	TGAGGCAT
NTAGGACG	TTAGGACG
NTATAAGG	TATAAGGG
NTAATTAC	TAATTACA
NTCAGGCT	GTCAGGCT
NTATCACT	TTATCACT
NTATGCAA	CTATGCAA
NTGGCACC	GTGGCACC
NTTGACAG	TTGACAGC
NTATTGGC	TATTGGCG
NTGGGCTA	ATGGGCTA
NTTGCGTT	TTGCGTTC
NTCCAAAA	TTCCAAAA
NTTAGGAC	TTAGGACG
NTCCCGGC	TCCCGGCT
NTTATATC	ATTATATC
NTTATCAC	TTATCACT
NTTGTCCG	TTGTCCGA
NTTGTGGA	TTTGTGGA
NTCCGCCA	ATCCGCCA
NTTAATGA	CTTAATGA
NTGTAGTC	CTGTAGTC
NTCCTAGC	TCCTAGCG
NTTACCGG	CTTACCGG
NTCCTCTC	TCCTCTCT
NTGTCCGA	TTGTCCGA
NTTTAAAG	GTTTAAAG
NTTCAACC	ATTCAACC
NTGTCGCT	ATGTCGCT
NTTCCAAA	TTCCAAAA
NTGCCATG	TGCCATGT
NTTCCTGA	ATTCCTGA
NTCGACTT	ATCGACTT
NTCGAGTC	TCGAGTCC
NTGTGGGG	TGTGGGGT
NTTTGACT	GTTTGACT
NTGTGTCG	TGTGTCGA
NTTTGTGG	TTTGTGGA
NTGCGTTC	TTGCGTTC
NTGTTTTG	TGTTTTGC
NTGCTAAA	TGCTAAAT
NTGGAGAC	TGGAGACT
