AAATCAAG	AAACAAGT
AACTAACT	GACTAACT
AAGCCAGG	AAGCAGGC
AAACTAAG	AAACAAGT
AAACTAGT	AAACAAGT
AAAAAAGT	AAACAAGT
AAAAAATC	AAGAAATC
AAATCCTC	GAATCCTC
AAATCCTT	AAACCTTT
AAACTCTT	AAACCTTT
AACTACTA	GACTACTA
AAATCGAG	TAATCGAG
AAGCCCGC	AACCCGCG
AAATCGTT	ACATCGTT
AACCGCGA	AACCCGCG
AACCGCGC	AACCCGCG
AACCGCGG	AACCCGCG
AACCGCGT	AACCCGCG
AACCGCGN	AACCCGCG
AAATCTTT	AAACCTTT
AAGCCGCG	AACCCGCG
AAACTTGT	AACTTGTA
AAACTTTA	AAACCTTT
AAACTTTC	AAACCTTT
AAACTTTG	AAACCTTT
AAACTTTT	AAACCTTT
AAACTTTN	AAACCTTT
AACTAGTA	AACTTGTA
AAGCCGGC	AAGCAGGC
AACNTGTA	AACTTGTA
AAAAAGTA	AAACAAGT
AAAAAGTC	AAACAAGT
AAAAAGTG	AAACAAGT
AAAAAGTT	AAACAAGT
AAAAAGTN	AAACAAGT
AACCGGCG	AACCCGCG
AAAAATCA	AAGAAATC
AAAAATCC	AAGAAATC
AAAAATCG	AAGAAATC
AAAAATCT	AAGAAATC
AAAAATCN	AAGAAATC
AACNTTGT	AACTTGTA
AACCGGTA	ACCGGTAA
AAACNAAG	AAACAAGT
AAACNAGT	AAACAAGT
AACTATGT	AACTTGTA
AAGCCTTT	AAACCTTT
AAATGGTC	AATGGTCA
AAACNCTT	AAACCTTT
AAAACAAG	AAACAAGT
AACAAATC	AAGAAATC
AACAACGC	ACAACGCG
AAATTAGA	ACAATTAG
AAATTAGC	ACAATTAG
AAATTAGG	ACAATTAG
AAATTAGT	ACAATTAG
AAATTAGN	ACAATTAG
AAACNTTT	AAACCTTT
AAGCGAGG	AAGCAGGC
AAGCGAGT	AAGGGAGT
AAAACCTT	AAACCTTT
AACAAGTA	AAACAAGT
AACAAGTC	AAACAAGT
AACAAGTG	AAACAAGT
AACAAGTT	AAACAAGT
AACAAGTN	AAACAAGT
AAAACGCG	ACAACGCG
AAAGAAAT	AAGAAATC
AACTCCGC	AACCCGCG
AAATTGCC	AAGTTGCC
AACAATTA	ACAATTAG
AAATTGTA	AACTTGTA
AACTCGCG	AACCCGCG
AAAACTTT	AAACCTTT
AACTCGTA	AACTTGTA
AAATTTCC	ATATTTCC
AACCTCGC	AACCCGCG
AAAGAAGT	AAACAAGT
AACTCTGT	AACTTGTA
AAGCGGAG	AAGGGAGT
AAGCGGCA	AAGCAGGC
AAGCGGCC	AAGCAGGC
AAGCGGCG	AAGCAGGC
AAGCGGCT	AAGCAGGC
AAGCGGCN	AAGCAGGC
AACACAAG	AAACAAGT
AAAAGCCA	CAAAGCCA
AACCTGCG	AACCCGCG
AAGCGGGC	AAGCAGGC
AAGAAAAC	AAGAAATC
AAGAAAAT	AAGAAATC
AAGAAACA	AAGAAATC
AAGAAACC	AAGAAATC
AAGAAACG	AAGAAATC
AAGAAACT	AAGAAATC
AAGAAACN	AAGAAATC
AAAAGGAT	TAAAGGAT
AAGAAAGC	AAGAAATC
AACTGACC	ATCTGACC
AAGAAAGT	AAGAAATC
AAGAAATA	AAGAAATC
AAGCGTAA	TAGCGTAA
AAGAAATC	AAGAAATC
AAGAAATG	AAGAAATC
AAGAAATT	AAGAAATC
AAGAAATN	AAGAAATC
AAGAAANC	AAGAAATC
AAGAAANT	AAGAAATC
AAGAACAT	AAGAAATC
AACACCGC	AACCCGCG
AAGCGTTT	AGCGTTTC
AACACCTT	AAACCTTT
AAGAACTC	AAGAAATC
AACCTGTA	AACTTGTA
AAGAAGAT	AAGAAATC
AACACGCG	AACCCGCG
AAGAAGGC	AAGCAGGC
AAGAAGGG	GAGAAGGG
AACCTTGG	ACCCTTGG
AACCTTGT	AACTTGTA
AAGAAGTC	AAGAAATC
AACCTTTA	AAACCTTT
AACCTTTC	AAACCTTT
AACCTTTG	AAACCTTT
AAGCTAGG	AAGCAGGC
AAGAATAT	AAGAAATC
AAGAATCA	AAGAAATC
AAGAATCC	AAGAAATC
AAGAATCG	AAGAAATC
AAGAATCT	AAGAAATC
AAGAATCN	AAGAAATC
AAGCTCAG	CAGCTCAG
AAGCTCCT	ACGCTCCT
AAGAATTC	AAGAAATC
AACTGGTA	AACTTGTA
AACTGGTC	AATGGTCA
AACCTTTT	AAACCTTT
AACCTTTN	AAACCTTT
AAGAANAT	AAGAAATC
AAGCTGCC	AAGTTGCC
AAGCTGGC	AAGCAGGC
AAGAANTC	AAGAAATC
AAANAAGT	AAACAAGT
AACTGTAA	AACTTGTA
AACTGTAC	AACTTGTA
AACTGTAG	AACTTGTA
AACTGTAT	AACTTGTA
AACTGTAN	AACTTGTA
AAGACAAG	AAACAAGT
AAGACAAT	AAGAAATC
AAGCTTGC	AAGTTGCC
AAGCTTGT	AACTTGTA
AAAGCAAG	AAACAAGT
AAGACAGG	AAGCAGGC
AAGACATC	AAGAAATC
AAAGCAGG	AAGCAGGC
AACTGTGT	AACTTGTA
AACAGGCA	AAGCAGGC
AACAGGCC	AAGCAGGC
AACAGGCG	AAGCAGGC
AACAGGCT	AAGCAGGC
AACAGGCN	AAGCAGGC
AAGACCTT	AAACCTTT
AACCNCGC	AACCCGCG
AAAATTAG	ACAATTAG
AACCNGCG	AACCCGCG
AAGCNAGG	AAGCAGGC
AACTTAGT	AACTTGTA
AACTTATA	AACTTGTA
AAAGCCAA	CAAAGCCA
AAAGCCAC	CAAAGCCA
AAAGCCAG	CAAAGCCA
AAAGCCAT	CAAAGCCA
AAAGCCAN	CAAAGCCA
AAANCAAG	AAACAAGT
AAAGCCTT	AAACCTTT
AACTTCGT	AACTTGTA
AACTTCTA	AACTTGTA
AACTTGAA	AACTTGTA
AACTTGAC	AACTTGTA
AACTTGAG	AACTTGTA
AACTTGAT	AACTTGTA
AACTTGAN	AACTTGTA
AACTTGCA	AACTTGTA
AACTTGCC	AAGTTGCC
AACTTGCT	AACTTGTA
AACTTGGA	AACTTGTA
AACTTGGT	AACTTGTA
AACTTGTA	AACTTGTA
AACTTGTC	AACTTGTA
AACTTGTG	AACTTGTA
AACTTGTT	AACTTGTA
AACTTGTN	AACTTGTA
AACTTGNA	AACTTGTA
AAGAGAAT	AAGAAATC
AACTTGNT	AACTTGTA
AACGAAAT	AAGAAATC
AACTTTAA	AACTTGTA
AACTTTAC	AACTTGTA
AACTTTAG	AACTTGTA
AACTTTAT	AACTTGTA
AACTTTAN	AACTTGTA
AAANCCTT	AAACCTTT
AAGCNGGC	AAGCAGGC
AACTTTGT	AACTTGTA
AACATCGT	ACATCGTT
AACTTTTA	AACTTGTA
AAGAGATC	AAGAAATC
AAAGCTTT	AAACCTTT
AAACAAAG	AAACAAGT
AAACAAAT	AAACAAGT
AACATGTA	AACTTGTA
AAACAACG	AAACAAGT
AACTTNGT	AACTTGTA
AAACAACT	AAACAAGT
AACTTNTA	AACTTGTA
AAACAAGA	AAACAAGT
AAACAAGC	AAACAAGT
AAACAAGG	AAACAAGT
AAACAAGT	AAACAAGT
AAACAAGN	AAACAAGT
AAACAATA	AAACAAGT
AAACAATC	AAACAAGT
AAACAATG	AAACAAGT
AAACAATT	AAACAAGT
AAACAATN	AAACAAGT
AAACAANG	AAACAAGT
AAACAANT	AAACAAGT
AAANCTTT	AAACCTTT
AAACACAG	AAACAAGT
AAGAGCCG	GAGAGCCG
AAACACGT	AAACAAGT
AAACACTT	AAACCTTT
AACATTGT	AACTTGTA
AAACAGAG	AAACAAGT
AACGAGAG	ACGAGAGT
AAACAGGC	AAGCAGGC
AAACAGGT	AAACAAGT
AAACAGTA	AAACAAGT
AAGAGGAG	AAGGGAGT
AAACAGTC	AAACAAGT
AAACAGTG	AAACAAGT
AAGAGGCA	AAGCAGGC
AAACAGTT	AAACAAGT
AAACAGTN	AAACAAGT
AAGAGGCC	AAGCAGGC
AAGAGGCG	AAGCAGGC
AAGAGGCT	AAGCAGGC
AAGAGGCN	AAGCAGGC
AAAGGAGT	AAGGGAGT
AAAGGATA	TAAAGGAT
AAAGGATC	TAAAGGAT
AAACATAG	AAACAAGT
AAACATGT	AAACAAGT
AAACATTT	AAACCTTT
AAGGAAAT	AAGAAATC
AAAGGATG	TAAAGGAT
AAAGGATT	TAAAGGAT
AAAGGATN	TAAAGGAT
AAGGAAGT	AAGGGAGT
AAGGAATC	AAGAAATC
AAACANAG	AAACAAGT
AAACANGT	AAACAAGT
AAACCAAG	AAACAAGT
AAACCAGT	AAACAAGT
AAACCATT	AAACCTTT
AAAGGGAG	AAGGGAGT
AACTNGTA	AACTTGTA
AAACCCGC	AACCCGCG
AAACCCTT	AAACCTTT
AACTNTGT	AACTTGTA
AACGCAGG	AAGCAGGC
AAGATAAT	AAGAAATC
AAACCGCG	AACCCGCG
AAAGGTCA	AATGGTCA
AAGATATC	AAGAAATC
AAGGAGAG	AAGGGAGT
AACGCCGC	AACCCGCG
AAACCGTT	AAACCTTT
AAGGAGGC	AAGCAGGC
AAACCTAT	AAACCTTT
AAGGAGTA	AAGGGAGT
AAGGAGTC	AAGGGAGT
AAACCTCT	AAACCTTT
AAACCTGT	AAACCTTT
AAGGAGTG	AAGGGAGT
AAGGAGTT	AAGGGAGT
AAGGAGTN	AAGGGAGT
AAACCTTA	AAACCTTT
AAACCTTC	AAACCTTT
AAACCTTG	AAACCTTT
AAACCTTT	AAACCTTT
AAACCTTN	AAACCTTT
AAACCTNT	AAACCTTT
AACGCGCG	AACCCGCG
AAACCNTT	AAACCTTT
AAGATGCC	AAGTTGCC
AACGCTCC	ACGCTCCT
AAACGAAG	AAACAAGT
AAGATTGC	AAGTTGCC
AACCAAGT	AAACAAGT
AAACGAGT	AAACAAGT
AAGANAAT	AAGAAATC
AACGGAGT	AAGGGAGT
AACGGCAT	CACGGCAT
AAGANATC	AAGAAATC
AACCACCA	TACCACCA
AACCACGC	AACCCGCG
AATCAAGG	ATTCAAGG
AATCAAGT	AAACAAGT
AACGGGAG	AAGGGAGT
AAGGCAGG	AAGCAGGC
AAGGCAGT	AAGGGAGT
AACCAGCG	AACCCGCG
AAACGCGA	ACAACGCG
AAACGCGC	ACAACGCG
AAACGCGG	ACAACGCG
AAACGCGT	ACAACGCG
AAACGCGN	ACAACGCG
AAACGCTT	AAACCTTT
AACGGTAA	ACCGGTAA
AACGGTCA	AATGGTCA
AAGGCCAA	AGGGCCAA
AACCAGGC	AAGCAGGC
AAAGTTGC	AAGTTGCC
AATCAGGC	AAGCAGGC
AACNCCGC	AACCCGCG
AAGGCGAG	AAGGGAGT
AACNCGCG	AACCCGCG
AAACGTTT	AAACCTTT
AAGCAAAT	AAGAAATC
AAGCAAGC	AAGCAGGC
AAGCAAGG	AAGCAGGC
AAGCAAGT	AAACAAGT
AAGCAATC	AAGAAATC
AAGCACGC	AAGCAGGC
AAGCACGG	AAGCAGGC
AACGTGTA	AACTTGTA
AAGCAGAC	AAGCAGGC
AAGCAGAG	AAGCAGGC
AAGCAGCA	AAGCAGGC
AAGCAGCC	AAGCAGGC
AAGCAGCG	AAGCAGGC
AAGCAGCT	AAGCAGGC
AAGCAGCN	AAGCAGGC
AAGCAGGA	AAGCAGGC
AAGCAGGC	AAGCAGGC
AAGCAGGG	AAGCAGGC
AAGCAGGT	AAGCAGGC
AAGCAGGN	AAGCAGGC
AAGCAGTC	AAGCAGGC
AAGCAGTG	AAGCAGGC
AAGCAGNC	AAGCAGGC
AAGCAGNG	AAGCAGGC
AACCCACG	AACCCGCG
AAGCATGC	AAGCAGGC
AACGTTGC	AAGTTGCC
AAGCATGG	AAGCAGGC
AACGTTGT	AACTTGTA
AAGGNAGT	AAGGGAGT
AACGTTTC	AGCGTTTC
AAGCANGC	AAGCAGGC
AATCCCGC	AACCCGCG
AACCCAGC	AACCCGCG
AAGCANGG	AAGCAGGC
AATCCGAG	CATCCGAG
AATCCGCG	AACCCGCG
AAGGNGAG	AAGGGAGT
AANGGAGT	AAGGGAGT
AATCCTCA	GAATCCTC
AATCCTCC	GAATCCTC
AATCCTCG	GAATCCTC
AATCCTCT	GAATCCTC
AATCCTCN	GAATCCTC
AATCCTGC	ATTCCTGC
AACCCCCG	AACCCGCG
AATCCTTT	AAACCTTT
AACCCCGA	AACCCGCG
AACCCCGC	AACCCGCG
AACCCCGG	AACCCGCG
AAGGGAAG	AAGGGAGT
AACCCCGT	AACCCGCG
AAGGGAAT	AAGGGAGT
AACCCCGN	AACCCGCG
AAGGGACG	AAGGGAGT
AAGGGACT	AAGGGAGT
AAGGGAGA	AAGGGAGT
AAGGGAGC	AAGGGAGT
AANGGGAG	AAGGGAGT
AACCCGAC	AACCCGCG
AACCCGAG	AACCCGCG
AACCCGCA	AACCCGCG
AACCCGCC	AACCCGCG
AAGGGAGG	AAGGGAGT
AACCCGCG	AACCCGCG
AAGGGAGT	AAGGGAGT
AACCCGCT	AACCCGCG
AAGGGAGN	AAGGGAGT
AACCCGCN	AACCCGCG
AAGGGATA	AAGGGAGT
AACCCGGA	AACCCGCG
AAGGGATC	AAGGGAGT
AACCCGGC	AACCCGCG
AAGGGATG	AAGGGAGT
AACCCGGG	AACCCGCG
AAGGGATT	AAGGGAGT
AAGGGATN	AAGGGAGT
AACCCGGT	AACCCGCG
AACCCGGN	AACCCGCG
AAGGGANG	AAGGGAGT
AACCCGTC	AACCCGCG
AAGGGANT	AAGGGAGT
AACCCGTG	AACCCGCG
AANGGTCA	AATGGTCA
AAGGGCAG	AAGGGAGT
AACCCGNC	AACCCGCG
AAGGGCCA	AGGGCCAA
AAATAACT	ATATAACT
AAGGGCGT	AAGGGAGT
AAATAAGT	AAACAAGT
AAGGGGAG	AAGGGAGT
AATCGAGA	TAATCGAG
AATCGAGC	TAATCGAG
AATCGAGG	TAATCGAG
AAGGGGGT	AAGGGAGT
AATCGAGT	TAATCGAG
AAGGGGTA	AAGGGAGT
AATCGAGN	TAATCGAG
AAGGGGTC	AAGGGAGT
AATCGATA	GATCGATA
AAGGGGTG	AAGGGAGT
AAGGGGTT	AAGGGAGT
AAGGGGTN	AAGGGAGT
AAGGGTAG	AAGGGAGT
AAGGGTCA	AATGGTCA
AACCCGNG	AACCCGCG
AACCCTCG	AACCCGCG
AACCCTGC	AACCCGCG
AACCCTTG	ACCCTTGG
AAGGGTCG	AGGGTCGG
AAGTAAAT	AAGAAATC
AAGGGTGT	AAGGGAGT
AAATATAT	TAATATAT
AATCGGTC	AATGGTCA
AAGGGNAG	AAGGGAGT
AACCCTTT	AAACCTTT
AATCGTCA	AATGGTCA
AACCCNCG	AACCCGCG
AACCCNGC	AACCCGCG
AATCGTTA	ACATCGTT
AATCGTTC	ACATCGTT
AATCGTTG	ACATCGTT
AATCGTTT	ACATCGTT
AATCGTTN	ACATCGTT
AAGGGNGT	AAGGGAGT
AANGTTGC	AAGTTGCC
AAGNGAGT	AAGGGAGT
AAGTAATC	AAGAAATC
AATGTCAA	AATGGTCA
AAGGTAGT	AAGGGAGT
AATGTCAC	AATGGTCA
AATGTCAG	AATGGTCA
AATGTCAT	AATGGTCA
AATGTCAN	AATGGTCA
AAGNGGAG	AAGGGAGT
AATGTCGT	ATGTCGTA
AANCAAGT	AAACAAGT
AAGGTCAA	AATGGTCA
AAGGTCAC	AATGGTCA
AAGGTCAG	AATGGTCA
AAGGTCAT	AATGGTCA
AAGGTCAN	AATGGTCA
AATCTGAC	ATCTGACC
AAGGTCGG	AGGGTCGG
AANCAGGC	AAGCAGGC
AATGTGTC	AATGGTCA
AATNGGTC	AATGGTCA
AAGGTGAG	AAGGGAGT
AAGGTGCC	AAGTTGCC
AAGTAGCC	AAGTTGCC
AATCTTGT	AACTTGTA
AATNGTCA	AATGGTCA
AAGTAGGC	AAGCAGGC
AATGTTCA	AATGGTCA
AAGTATGC	AAGTTGCC
AAGTATGG	TAGTATGG
AATGTTGC	AAGTTGCC
AANCCCGC	AACCCGCG
AAGNTGCC	AAGTTGCC
AANCCGCG	AACCCGCG
AAGNTTGC	AAGTTGCC
AANCCTTT	AAACCTTT
AAGGTTGC	AAGTTGCC
AAGTCAGG	AAGCAGGC
AATGNGTC	AATGGTCA
AAGTCGCC	AAGTTGCC
AAGTCGTA	ATGTCGTA
AATGAAAT	AAGAAATC
AATGNTCA	AATGGTCA
AAGTCTGC	AAGTTGCC
AATAAATC	AAGAAATC
AATAACTA	ATATAACT
AATAACTC	ATATAACT
AATAACTG	ATATAACT
AATAACTT	ATATAACT
AATAACTN	ATATAACT
AAGTGAGT	AAGGGAGT
AANAAATC	AAGAAATC
AANCTTGT	AACTTGTA
AATGAGTC	AATGGTCA
AAGTGCCA	AAGTTGCC
AAGTGCCC	AAGTTGCC
AAGTGCCG	AAGTTGCC
AAGTGCCT	AAGTTGCC
AAGTGCCN	AAGTTGCC
AAGTGGAG	AAGGGAGT
AATGATCA	AATGGTCA
AAGTGGCC	AAGTTGCC
AAGTGGTC	AATGGTCA
AAGTGTGC	AAGTTGCC
AATACAAG	AAACAAGT
AAGTGTTC	GAGTGTTC
AANTGGTC	AATGGTCA
AATGCAGG	AAGCAGGC
AANACAAG	AAACAAGT
AATTCAAG	ATTCAAGG
AATACCTT	AAACCTTT
AAGTTACC	AAGTTGCC
AAGTTAGC	AAGTTGCC
AAGTTCCA	AAGTTGCC
AAGTTCCC	AAGTTGCC
AAGTTCCG	AAGTTGCC
AAGTTCCT	AAGTTGCC
AAGTTCCN	AAGTTGCC
AANGAAAT	AAGAAATC
AAGTTCGC	AAGTTGCC
AANACCTT	AAACCTTT
AATTCCTG	ATTCCTGC
AAGTTGAC	AAGTTGCC
AAGTTGCA	AAGTTGCC
AAGTTGCC	AAGTTGCC
AAGTTGCG	AAGTTGCC
AAGTTGCT	AAGTTGCC
AAGTTGCN	AAGTTGCC
AAGTTGGC	AAGTTGCC
AAGTTGTA	AACTTGTA
AAGTTGTC	AAGTTGCC
AAGTTGNC	AAGTTGCC
AATGCGTC	AATGGTCA
AAGTTTCC	AAGTTGCC
AAGTTTGC	AAGTTGCC
AATGCTCA	AATGGTCA
AAGTTNCC	AAGTTGCC
AAGTTNGC	AAGTTGCC
AATGGACA	AATGGTCA
AATGGAGT	AAGGGAGT
AATGGATC	AATGGTCA
AATGGCAA	AATGGTCA
AATGGCAC	AATGGTCA
AATGGCAG	AATGGTCA
AATGGCAT	AATGGTCA
AATGGCAN	AATGGTCA
AATGGCCA	AATGGTCA
AATGGCTC	AATGGTCA
AANGCAGG	AAGCAGGC
AATAGGTC	AATGGTCA
AATGGGAG	AAGGGAGT
AATGGGCA	AATGGTCA
AANTTGCC	AAGTTGCC
AATAGTCA	AATGGTCA
AATGGGTC	AATGGTCA
AANTTGTA	AACTTGTA
AAGTNGCC	AAGTTGCC
AATGGTAA	AATGGTCA
AATGGTAC	AATGGTCA
AATATAAC	ATATAACT
AATGGTAG	AATGGTCA
AATGGTAT	AATGGTCA
AATGGTAN	AATGGTCA
AATGGTCA	AATGGTCA
AATGGTCC	AATGGTCA
AATGGTCG	AATGGTCA
AATGGTCT	AATGGTCA
AATGGTCN	AATGGTCA
AATGGTGA	AATGGTCA
AATGGTGC	AATGGTCA
AATATATA	TAATATAT
AATGGTTA	AATGGTCA
AATATATC	TAATATAT
AATGGTTC	AATGGTCA
AATATATG	TAATATAT
AATATATT	TAATATAT
AATATATN	TAATATAT
AAGTNTGC	AAGTTGCC
AATGGTNA	AATGGTCA
AATTGCCA	AAGTTGCC
AATGGTNC	AATGGTCA
AATTGCCC	AAGTTGCC
AATTGCCG	AAGTTGCC
AATTGCCT	AAGTTGCC
AATTGCCN	AAGTTGCC
AATGGNCA	AATGGTCA
AATTGGTC	AATGGTCA
AATGGNTC	AATGGTCA
AATTGTAA	AACTTGTA
AATTGTAC	AACTTGTA
AATTGTAG	AACTTGTA
AAGNAAAT	AAGAAATC
AATTGTAT	AACTTGTA
AATTGTAN	AACTTGTA
AATTGTCA	AATGGTCA
AATATTTC	ATATTTCC
AAGNAATC	AAGAAATC
AAGNAGGC	AAGCAGGC
AATTTCCA	ATATTTCC
AATTTCCC	ATATTTCC
AATTTCCG	ATATTTCC
AATTTCCT	ATATTTCC
AATTTCCN	ATATTTCC
AATTTGCC	AAGTTGCC
ACATNCGT	ACATCGTT
AATTTGTA	AACTTGTA
ACCTTAGT	GCCTTAGT
ACGACAGT	ACGAGAGT
ACCTTCAC	TCCTTCAC
ACGACCCG	CGACCCGG
ACATNGTT	ACATCGTT
AAGNCAGG	AAGCAGGC
ACAGCAGG	AAGCAGGC
ACGACGAG	ACGAGAGT
ACGACGCG	ACAACGCG
ACCTTGGA	ACCCTTGG
ACCTTGGC	ACCCTTGG
ACCTTGGG	ACCCTTGG
ACCTTGGT	ACCCTTGG
ACCTTGGN	ACCCTTGG
ACCTTGTA	AACTTGTA
ACGACTCC	ACGCTCCT
ACCTTTGG	ACCCTTGG
ACAGCGCG	ACAACGCG
ACAGCGTT	ACATCGTT
ACAGCTCA	CAGCTCAG
ACAGCTCC	ACGCTCCT
ACANACGC	ACAACGCG
ACGAGAAG	ACGAGAGT
ACGAGAAT	ACGAGAGT
ACGAGACG	ACGAGAGT
ACGAGACT	ACGAGAGT
ACGAGAGA	ACGAGAGT
ACGAGAGC	ACGAGAGT
ACGAGAGG	ACGAGAGT
ACGAGAGT	ACGAGAGT
ACGAGAGN	ACGAGAGT
ACGAGATA	ACGAGAGT
ACGAGATC	ACGAGAGT
ACGAGATG	ACGAGAGT
ACGAGATT	ACGAGAGT
ACGAGATN	ACGAGAGT
ACGAGANG	ACGAGAGT
ACGAGANT	ACGAGAGT
ACGAGCAG	ACGAGAGT
ACGAGCGT	ACGAGAGT
ACGAGGAG	ACGAGAGT
ACGAGGGT	ACGAGAGT
ACGAGGTA	ACGAGAGT
ACGAGGTC	ACGAGAGT
ACGAGGTG	ACGAGAGT
ACGAGGTT	ACGAGAGT
ACGAGGTN	ACGAGAGT
ACAAACGC	ACAACGCG
ACGAGTAG	ACGAGAGT
ACGAGTGT	ACGAGAGT
ACAAAGCC	CAAAGCCA
ACAAAGCG	ACAACGCG
ACAAAGTA	GCAAAGTA
ACGAGNAG	ACGAGAGT
ACAAATAG	ACAATTAG
ACGAGNGT	ACGAGAGT
ACAAATGG	CCAAATGG
ACAAATTA	ACAATTAG
ACAATAAG	ACAATTAG
ACAATAGA	ACAATTAG
ACAATAGC	ACAATTAG
ACAATAGG	ACAATTAG
ACAACAAG	AAACAAGT
ACAATAGT	ACAATTAG
ACAATAGN	ACAATTAG
ACGATAGT	ACGAGAGT
ACAACACG	ACAACGCG
ACANATTA	ACAATTAG
ACAACAGC	ACAACGCG
ACAGGGAG	AAGGGAGT
ACAATATA	ACAATTAG
ACAATCAG	ACAATTAG
ACAATCGC	ACAACGCG
ACAATCGT	ACATCGTT
ACGATCCT	ACGCTCCT
ACCGAGAG	ACGAGAGT
ACAATCTA	ACAATTAG
ACAACCCG	ACAACGCG
ACAACCGA	ACAACGCG
ACGATCGT	ACATCGTT
ACAACCGC	ACAACGCG
ACAACCGG	ACAACGCG
ACAACCGT	ACAACGCG
ACAACCGN	ACAACGCG
ACCGAGTA	ACCGGTAA
ACAGGTAA	ACCGGTAA
ACAACCTT	AAACCTTT
ACAGGTCT	TCAGGTCT
ACAATGAG	ACAATTAG
ACAATGCG	ACAACGCG
ACGATGAG	ACGAGAGT
ACCGATAA	ACCGGTAA
ACAACGAC	ACAACGCG
ACAACGAG	ACAACGCG
ACAATGTA	ACAATTAG
ACAACGCA	ACAACGCG
ACAACGCC	ACAACGCG
ACAACGCG	ACAACGCG
ACAACGCT	ACAACGCG
ACAACGCN	ACAACGCG
ACAACGGA	ACAACGCG
ACAACGGC	ACAACGCG
ACAACGGG	ACAACGCG
ACAACGGT	ACAACGCG
ACAACGGN	ACAACGCG
ACGATTAG	ACAATTAG
ACGATTAT	CGATTATT
ACAACGTC	ACAACGCG
ACAACGTG	ACAACGCG
ACAACGTT	ACATCGTT
ACAACGNC	ACAACGCG
ACAACGNG	ACAACGCG
ACAACTAG	ACAATTAG
ACAACTCG	ACAACGCG
ACAATTAA	ACAATTAG
ACAACTGC	ACAACGCG
ACAATTAC	ACAATTAG
ACAATTAG	ACAATTAG
ACAATTAT	ACAATTAG
ACAATTAN	ACAATTAG
ACAACTTA	ACAATTAG
ACAATTCA	ACAATTAG
ACAATTCG	ACAATTAG
ACAATTGA	ACAATTAG
ACAATTGC	ACAATTAG
ACCAGAGT	ACGAGAGT
ACAATTGG	ACAATTAG
ACANCGCG	ACAACGCG
ACAATTGT	ACAATTAG
ACAATTGN	ACAATTAG
ACAATTTA	ACAATTAG
ACAATTTG	ACAATTAG
ACAATTNA	ACAATTAG
ACAATTNG	ACAATTAG
ACAATNAG	ACAATTAG
ACAACNCG	ACAACGCG
ACAACNGC	ACAACGCG
ACAATNTA	ACAATTAG
ACANCGTT	ACATCGTT
ACAGTCGT	ACATCGTT
ACAAGAGT	ACGAGAGT
ACGANAGT	ACGAGAGT
ACAAGCGA	ACAACGCG
ACAAGCGC	ACAACGCG
ACAAGCGG	ACAACGCG
ACAAGCGT	ACAACGCG
ACAAGCGN	ACAACGCG
ACAGTTAG	ACAATTAG
ACCAGGTA	ACCGGTAA
ACAGTTGC	AAGTTGCC
ACCAGTAA	ACCGGTAA
ACAAGGCG	ACAACGCG
ACCAGTTA	CCCAGTTA
ACGANGAG	ACGAGAGT
ACAAGTAG	ACAATTAG
ACAANCGC	ACAACGCG
ACAAGTTA	ACAATTAG
ACCGCGTA	ACCGGTAA
ACAANGCG	ACAACGCG
ACAANTAG	ACAATTAG
ACCGCTAA	ACCGGTAA
ACCATCCA	CCCATCCA
ACCGCTAG	TCCGCTAG
ACCGCTCC	ACGCTCCT
ACAANTTA	ACAATTAG
ACCATCGT	ACATCGTT
ACCGCTTG	ACCCTTGG
ACATAACT	ATATAACT
ACGCNCCT	ACGCTCCT
ACGCACCT	ACGCTCCT
ACATACGC	ACAACGCG
ACATACGT	ACATCGTT
ACGCAGAG	ACGAGAGT
ACGCAGGC	AAGCAGGC
ACCNCTTG	ACCCTTGG
ACATAGTT	ACATCGTT
ACACAAGT	AAACAAGT
ACGCATCC	ACGCTCCT
ACCATTAG	ACAATTAG
ACGCNTCC	ACGCTCCT
ACCATTGG	ACCCTTGG
ACCGGAAA	ACCGGTAA
ACCGGAAC	ACCGGTAA
ACCGGAAG	ACCGGTAA
ACCGGAAT	ACCGGTAA
ACCGGAAN	ACCGGTAA
ACACACGC	ACAACGCG
ACATATTA	ACAATTAG
ACCGGATA	ACCGGTAA
ACCNGGTA	ACCGGTAA
ACATCAGT	ACATCGTT
ACGCCCCT	ACGCTCCT
ACATCATT	ACATCGTT
ACANTCGT	ACATCGTT
ACCNGTAA	ACCGGTAA
ACGCCCTA	ACGCTCCT
ACGCCCTC	ACGCTCCT
ACGCCCTG	ACGCTCCT
ACGCCCTT	ACGCTCCT
ACGCCCTN	ACGCTCCT
ACATCCGA	CATCCGAG
ACATCCGT	ACATCGTT
ACATCCTT	ACATCGTT
ACCGGCAA	ACCGGTAA
ACGGAGAG	ACGAGAGT
ACATCGAT	ACATCGTT
ACATCGCG	ACAACGCG
ACATCGCT	ACATCGTT
ACATCGGT	ACATCGTT
ACATCGTA	ACATCGTT
ACATCGTC	ACATCGTT
ACGGAGTA	ACGAGAGT
ACATCGTG	ACATCGTT
ACGGAGTC	ACGAGAGT
ACATCGTT	ACATCGTT
ACGGAGTG	ACGAGAGT
ACATCGTN	ACATCGTT
ACGGAGTT	ACGAGAGT
ACGGAGTN	ACGAGAGT
ACANTTAG	ACAATTAG
ACATCGNT	ACATCGTT
ACCGGCTA	ACCGGTAA
ACACATTA	ACAATTAG
ACATCTGT	ACATCGTT
ACATCTTA	ACATCGTT
ACATCTTC	ACATCGTT
ACATCTTG	ACATCGTT
ACGGATTC	CGGATTCC
ACATCTTT	ACATCGTT
ACATCTTN	ACATCGTT
ACGCCTCC	ACGCTCCT
ACCGGGAA	ACCGGTAA
ACATCNGT	ACATCGTT
ACATCNTT	ACATCGTT
ACCGGGTA	ACCGGTAA
ACCGGGTC	GCCGGGTC
ACGCCTTG	ACCCTTGG
ACACCCGC	AACCCGCG
ACCGGTAA	ACCGGTAA
ACCGGTAC	ACCGGTAA
ACCGGTAG	ACCGGTAA
ACGGCATA	CACGGCAT
ACGGCATC	CACGGCAT
ACGGCATG	CACGGCAT
ACGGCATT	CACGGCAT
ACGGCATN	CACGGCAT
ACGGCCAA	AGGGCCAA
ACATGCGT	ACATCGTT
ACACCGCG	ACAACGCG
ACCGGTAT	ACCGGTAA
ACCGGTAN	ACCGGTAA
ACCGGTCA	ACCGGTAA
ACCGGTGA	ACCGGTAA
ACGCGAGT	ACGAGAGT
ACCGGTTA	ACCGGTAA
ACCGGTNA	ACCGGTAA
ACATGGTC	AATGGTCA
ACATGGTT	ACATCGTT
ACCGGNAA	ACCGGTAA
ACACCGTT	ACATCGTT
ACGCGCCT	ACGCTCCT
ACGGCTCC	ACGCTCCT
ACGCGGAA	CGCGGAAG
ACATGTTA	ACATCGTT
ACATGTTC	ACATCGTT
ACATGTTG	ACATCGTT
ACATGTTT	ACATCGTT
ACATGTTN	ACATCGTT
ACCGGNTA	ACCGGTAA
ACGCGGTA	ACCGGTAA
ACCNTTGG	ACCCTTGG
ACCGTAAA	ACCGGTAA
ACCGTAAC	ACCGGTAA
ACCGTAAG	ACCGGTAA
ACGCGTCC	ACGCTCCT
ACACCTTG	ACCCTTGG
ACATTAGA	ACAATTAG
ACATTAGC	ACAATTAG
ACATTAGG	ACAATTAG
ACATTAGT	ACAATTAG
ACATTAGN	ACAATTAG
ACGCGTTT	AGCGTTTC
ACCCACTG	CCCCACTG
ACCGTAAT	ACCGGTAA
ACCGTAAN	ACCGGTAA
ACACCTTT	AAACCTTT
ACGGGCCA	AGGGCCAA
ACATTCGT	ACATCGTT
ACCCAGTT	CCCAGTTA
ACGCTACC	ACGCTCCT
ACCCATCC	CCCATCCA
ACGCTACT	ACGCTCCT
ACATTGTT	ACATCGTT
ACCCATGG	ACCCTTGG
ACCCATTG	ACCCTTGG
ACCAAATG	CCAAATGG
ACATTTAG	ACAATTAG
ACATTTCC	ATATTTCC
ACGGGTAA	ACCGGTAA
ACCAACGA	TCCAACGA
ACCAACGC	ACAACGCG
ACGGGTCG	AGGGTCGG
ACCCCACT	CCCCACTG
ACGCTCAC	ACGCTCCT
ACGCTCAT	ACGCTCCT
ACGCTCCA	ACGCTCCT
ACGCTCCC	ACGCTCCT
ACGCTCCG	ACGCTCCT
ACGCTCCT	ACGCTCCT
ACGCTCCN	ACGCTCCT
ACGCTCGC	ACGCTCCT
ACGCTCGT	ACGCTCCT
ACGCTCTA	ACGCTCCT
ACGCTCTC	ACGCTCCT
ACACGCGA	ACAACGCG
ACGCTCTG	ACGCTCCT
ACACGCGC	ACAACGCG
ACGCTCTT	ACGCTCCT
ACACGCGG	ACAACGCG
ACGCTCTN	ACGCTCCT
ACACGCGT	ACAACGCG
ACACGCGN	ACAACGCG
ACGCTCNC	ACGCTCCT
ACCGTGTA	ACCGGTAA
ACGGTAAA	ACCGGTAA
ACGGTAAC	ACCGGTAA
ACGGTAAG	ACCGGTAA
ACGGTAAT	ACCGGTAA
ACGGTAAN	ACCGGTAA
ACACGGCA	CACGGCAT
ACCGTTAA	ACCGGTAA
ACCAATTA	ACAATTAG
ACCGTTGA	CCGTTGAG
ACCGTTGG	ACCCTTGG
ACCGTTTC	AGCGTTTC
ACTAACGC	ACAACGCG
ACTAACTA	GACTAACT
ACACGGTA	ACCGGTAA
ACTAACTC	GACTAACT
ACTAACTG	GACTAACT
ACTAACTT	GACTAACT
ACGCTCNT	ACGCTCCT
ACTAACTN	GACTAACT
ACGGTCCT	ACGCTCCT
ACTAAGAA	CTAAGAAC
ACGCTGCC	ACGCTCCT
ACGGTCGG	AGGGTCGG
ACCCCGCG	AACCCGCG
ACGCTGCT	ACGCTCCT
ACCCCTAA	CCCCTAAA
ACCCCTGG	ACCCTTGG
ACCCCTTG	ACCCTTGG
ACCCCTTT	GCCCCTTT
ACGCTTCC	ACGCTCCT
ACGCTTCT	ACGCTCCT
ACTAATTA	ACAATTAG
ACGCTTGG	ACCCTTGG
ACGAAAGT	ACGAGAGT
ACGAAATC	AAGAAATC
ACGGTGGT	CGGTGGTT
ACACGTTA	ACATCGTT
ACACGTTC	ACATCGTT
ACACGTTG	ACATCGTT
ACACGTTT	ACATCGTT
ACACGTTN	ACATCGTT
ACCACCAA	TACCACCA
ACCACCAC	TACCACCA
ACCACCAG	TACCACCA
ACCACCAT	TACCACCA
ACCACCAN	TACCACCA
ACGAACGC	ACAACGCG
ACCGNGTA	ACCGGTAA
ACCGNTAA	ACCGGTAA
ACGCTNCC	ACGCTCCT
ACGAAGAG	ACGAGAGT
ACGCTNCT	ACGCTCCT
ACCACGCG	ACAACGCG
ACGAAGTA	ACGAGAGT
ACGAAGTC	ACGAGAGT
ACGAAGTG	ACGAGAGT
ACGAAGTT	ACGAGAGT
ACGAAGTN	ACGAGAGT
ACGAATTA	ACAATTAG
ACTACGCG	ACAACGCG
ACCACTTG	ACCCTTGG
ACCCGCGA	AACCCGCG
ACCCGCGC	AACCCGCG
ACCCGCGG	AACCCGCG
ACCCGCGT	AACCCGCG
ACTACTAA	GACTACTA
ACCCGCGN	AACCCGCG
ACTACTAC	GACTACTA
ACTACTAG	GACTACTA
ACTACTAT	GACTACTA
ACTACTAN	GACTACTA
ACCCGGTA	ACCGGTAA
ACACTCCT	ACGCTCCT
ACACTCGT	ACATCGTT
ACCCGTAA	ACCGGTAA
ACCCGTGG	ACCCTTGG
ACCCGTTG	ACCCTTGG
ACTCTCCT	ACGCTCCT
ACTCTGAC	ATCTGACC
ACTAGAGT	ACGAGAGT
ACTAGCAT	CTAGCATT
ACCCTAAA	CCCCTAAA
ACACTTAG	ACAATTAG
ACTAGCTC	CTAGCTCG
ACCCTAGG	ACCCTTGG
ACTCTTGG	ACCCTTGG
ACCCTATG	ACCCTTGG
ACTAGGCC	CTAGGCCC
ACCCTCCT	ACGCTCCT
ACCCTCGG	ACCCTTGG
ACACTTCT	GCACTTCT
ACCCTCTG	ACCCTTGG
ACACTTGG	ACCCTTGG
ACACTTGT	AACTTGTA
ACCTCCTA	ACGCTCCT
ACCTCCTC	ACGCTCCT
ACCTCCTG	ACGCTCCT
ACCTCCTT	ACGCTCCT
ACCTCCTN	ACGCTCCT
ACCCTGGA	ACCCTTGG
ACCCTGGC	ACCCTTGG
ACCCTGGG	ACCCTTGG
ACCCTGGT	ACCCTTGG
ACCCTGGN	ACCCTTGG
ACCCTGTC	CCCTGTCG
ACCCTGTG	ACCCTTGG
ACCCTTAG	ACCCTTGG
ACCCTTCG	ACCCTTGG
ACCCTTGA	ACCCTTGG
ACCCTTGC	ACCCTTGG
ACCCTTGG	ACCCTTGG
ACTATAAC	ATATAACT
ACCCTTGT	ACCCTTGG
ACCCTTGN	ACCCTTGG
ACCTCGAT	CCTCGATT
ACCCTTTG	ACCCTTGG
ACCCTTNG	ACCCTTGG
ACNCGGTA	ACCGGTAA
ACCTCGTT	ACATCGTT
ACCCTNGG	ACCCTTGG
ACCCTNTG	ACCCTTGG
ACNTCGTT	ACATCGTT
ACGTAGAG	ACGAGAGT
ACCTCTTG	ACCCTTGG
ACTATCGT	ACATCGTT
ACGTAGGT	GCGTAGGT
ACGTATAC	CGTATACG
ACTATTAG	ACAATTAG
ACCTGACC	ATCTGACC
ACNCTCCT	ACGCTCCT
ACTATTTC	ATATTTCC
ACCCNTGG	ACCCTTGG
ACCCNTTG	ACCCTTGG
ACTGACCA	ATCTGACC
ACTGACCC	ATCTGACC
ACTGACCG	ATCTGACC
ACTGACCT	ATCTGACC
ACTGACCN	ATCTGACC
ACGTCCTA	ACGCTCCT
ACGTCCTC	ACGCTCCT
ACGTCCTG	ACGCTCCT
ACGTCCTT	ACGCTCCT
ACCTGCAA	CCTGCAAG
ACTGAGAG	ACGAGAGT
ACGTCCTN	ACGCTCCT
ACNCTTGG	ACCCTTGG
ACTTCAAG	ATTCAAGG
ACCTGGTA	ACCGGTAA
ACGTCGTA	ATGTCGTA
ACGTCGTT	ACATCGTT
ACCTGTAA	ACCGGTAA
ACCTGTCG	CCCTGTCG
ACGTCTCC	ACGCTCCT
ACTTCCTG	ATTCCTGC
ACAGAAAC	TCAGAAAC
ACAGAAAT	AAGAAATC
ACTTCGTT	ACATCGTT
ACTTCTCT	CTTCTCTA
ACAGACGC	ACAACGCG
ACTGCAAG	CCTGCAAG
ACAGAGAG	ACGAGAGT
ACAGAGTA	ACGAGAGT
ACAGAGTC	ACGAGAGT
ACAGAGTG	ACGAGAGT
ACAGAGTT	ACGAGAGT
ACAGAGTN	ACGAGAGT
ACAGATTA	ACAATTAG
ACTCAAGG	ATTCAAGG
ACTGCTCC	ACGCTCCT
ACTTGGAG	TCTTGGAG
ACGTGAGT	ACGAGAGT
ACTTGTAA	AACTTGTA
ACTTGTAC	AACTTGTA
ACTTGTAG	AACTTGTA
ACTTGTAT	AACTTGTA
ACTTGTAN	AACTTGTA
ACNAACGC	ACAACGCG
ACNGAGAG	ACGAGAGT
ACNAATTA	ACAATTAG
ACTTTAAA	GCTTTAAA
ACTGGGAT	CTGGGATC
ACGTTCCT	ACGCTCCT
ACGTTGAG	CCGTTGAG
ACGTTGCC	AAGTTGCC
ACGTTTCA	AGCGTTTC
ACGTTTCC	AGCGTTTC
ACTGGTAA	ACCGGTAA
ACGTTTCG	AGCGTTTC
ACGTTTCT	AGCGTTTC
ACGTTTCN	AGCGTTTC
ACTGGTCA	AATGGTCA
ACNACGCG	ACAACGCG
ACTCCGGG	TCTCCGGG
ACTCCTGC	ATTCCTGC
ACTCCTTG	ACCCTTGG
AGAAATCA	AAGAAATC
AGAAATCC	AAGAAATC
AGAAATCG	AAGAAATC
AGAAATCT	AAGAAATC
AGAAATCN	AAGAAATC
ACNGCTCC	ACGCTCCT
ACTCGATT	CCTCGATT
ACTCGCCC	GCTCGCCC
ACTGTCGT	ATGTCGTA
AGAACAAG	AAACAAGT
ACNAGAGT	ACGAGAGT
ACTCGGTA	ACCGGTAA
AGAACCTT	AAACCTTT
ACNGGTAA	ACCGGTAA
AGAACGCG	ACAACGCG
ACGNAGAG	ACGAGAGT
ACTCGTTA	ACATCGTT
ACTCGTTC	ACATCGTT
ACTCGTTG	ACATCGTT
ACTCGTTT	ACATCGTT
ACTCGTTN	ACATCGTT
AGAACTGT	TGAACTGT
ACNATCGT	ACATCGTT
ACNATTAG	ACAATTAG
AGAAGGGA	GAGAAGGG
AGAAGGGC	GAGAAGGG
AGAAGGGG	GAGAAGGG
AGAAGGGT	GAGAAGGG
AGAAGGGN	GAGAAGGG
ACGNCTCC	ACGCTCCT
ACGNGAGT	ACGAGAGT
ACTTAATG	CTTAATGC
ACTTACCA	CTTACCAA
AGAATCCT	GAATCCTC
AGAATTAG	ACAATTAG
ACGNTCCT	ACGCTCCT
AGATAACT	ATATAACT
AGACAAGT	AAACAAGT
ACNCCTTG	ACCCTTGG
AGATCCCT	TGATCCCT
AGCGTAAA	TAGCGTAA
AGCGTAAC	TAGCGTAA
AGCGTAAG	TAGCGTAA
AGCGTAAT	TAGCGTAA
AGCGTAAN	TAGCGTAA
AGCGTAGG	GCGTAGGT
AGATCGAT	GATCGATA
AGCGTATC	AGCGTTTC
AGATCGTT	ACATCGTT
AGCGTATT	AGCGTTTC
AGCGTCGG	AGGGTCGG
AGCGTCTC	AGCGTTTC
AGGGGAGT	AAGGGAGT
AGCGTCTT	AGCGTTTC
AGCNGTTT	AGCGTTTC
AGCGTGTC	AGCGTTTC
AGCGTGTT	AGCGTTTC
AGCGTTAC	AGCGTTTC
AGGGGCAA	AGGGCCAA
AGCGTTAT	AGCGTTTC
AGCGTTCA	AGCGTTTC
AGCGTTCC	AGCGTTTC
AGCGTTCG	AGCGTTTC
AGGGGCCA	AGGGCCAA
AGCGTTCT	AGCGTTTC
AGCGTTCN	AGCGTTTC
AGCGTTGC	AGCGTTTC
AGGGGCGG	AGGGTCGG
AGCGTTGT	AGCGTTTC
AGCGTTTA	AGCGTTTC
AGCGTTTC	AGCGTTTC
AGCGTTTG	AGCGTTTC
AGCGTTTT	AGCGTTTC
AGCGTTTN	AGCGTTTC
AGCGTTNC	AGCGTTTC
AGCGTTNT	AGCGTTTC
AGCGTNTC	AGCGTTTC
AGCGTNTT	AGCGTTTC
AGCAAAGT	GCAAAGTA
AGGGGTCG	AGGGTCGG
AGGCAGGC	AAGCAGGC
AGATGGTC	AATGGTCA
AGCAACGC	ACAACGCG
AGGGTACG	AGGGTCGG
AGGGTAGG	AGGGTCGG
AGACCCGC	AACCCGCG
AGACCCGG	CGACCCGG
AGGCCAAA	AGGGCCAA
AGGCCAAC	AGGGCCAA
AGGCCAAG	AGGGCCAA
AGGCCAAT	AGGGCCAA
AGGCCAAN	AGGGCCAA
AGATTATT	CGATTATT
AGGCCCAA	AGGGCCAA
AGGGTCAA	AGGGCCAA
AGGGTCAG	AGGGTCGG
AGCNTTTC	AGCGTTTC
AGGGTCCA	AGGGCCAA
AGGGTCCG	AGGGTCGG
AGGGTCGA	AGGGTCGG
AGGGTCGC	AGGGTCGG
AGGGTCGG	AGGGTCGG
AGCAATTA	ACAATTAG
AGGGTCGT	AGGGTCGG
AGGGTCGN	AGGGTCGG
AGGGTCTG	AGGGTCGG
AGGGTCNG	AGGGTCGG
AGATTTCC	ATATTTCC
AGGGTGCG	AGGGTCGG
AGGGTGGA	AGGGTCGG
AGGGTGGC	AGGGTCGG
AGGGTGGG	AGGGTCGG
AGGGTGGT	AGGGTCGG
AGGGTGGN	AGGGTCGG
AGCGNTTC	AGCGTTTC
AGCGNTTT	AGCGTTTC
AGACCTTT	AAACCTTT
AGGGTTCG	AGGGTCGG
AGGGTTGG	AGGGTCGG
AGGGTTTC	AGCGTTTC
AGGGTNCG	AGGGTCGG
AGGGTNGG	AGGGTCGG
AGGCGCAT	TGGCGCAT
AGGCGCCA	AGGGCCAA
AGGGNCAA	AGGGCCAA
AGGGNCCA	AGGGCCAA
AGCACTTC	GCACTTCT
AGGGNCGG	AGGGTCGG
AGCCCCTT	GCCCCTTT
AGCCCGCG	AACCCGCG
AGGCGTCG	AGGGTCGG
AGGGNTCG	AGGGTCGG
AGGCGTTT	AGCGTTTC
AGGAAATC	AAGAAATC
AGACGTTT	AGCGTTTC
AGGCTCCT	ACGCTCCT
AGGCTCGG	AGGGTCGG
AGCCCTTG	ACCCTTGG
AGACTAAC	GACTAACT
AGCTCAGA	CAGCTCAG
AGCTCAGC	CAGCTCAG
AGCTCAGG	CAGCTCAG
AGCTCAGT	CAGCTCAG
AGCTCAGN	CAGCTCAG
AGACTACT	GACTACTA
AGCAGGCA	AAGCAGGC
AGCAGGCC	AAGCAGGC
AGCAGGCG	AAGCAGGC
AGCAGGCT	AAGCAGGC
AGCAGGCN	AAGCAGGC
AGCTCCTA	ACGCTCCT
AGCTCCTC	ACGCTCCT
AGCTCCTG	ACGCTCCT
AGCTCCTT	ACGCTCCT
AGCTCCTN	ACGCTCCT
AGCTCGCC	GCTCGCCC
AGCAGTTT	AGCGTTTC
AGGACCAA	AGGGCCAA
AGGTCCAA	AGGGCCAA
AGGTCGGA	AGGGTCGG
AGGTCGGC	AGGGTCGG
AGGTCGGG	AGGGTCGG
AGGTCGGT	AGGGTCGG
AGGTCGGN	AGGGTCGG
AGGTCGTA	ATGTCGTA
AGGAGAGT	ACGAGAGT
AGCTGACC	ATCTGACC
AGCCGGGT	GCCGGGTC
AGCCGGTA	ACCGGTAA
AGGAGCCA	AGGGCCAA
AGCATCGT	ACATCGTT
AGACTTGT	AACTTGTA
AGCCGTTT	AGCGTTTC
AGGTGCCA	AGGGCCAA
AGGAGTCG	AGGGTCGG
AGGGACAA	AGGGCCAA
AGGGACCA	AGGGCCAA
AGGGACGG	AGGGTCGG
AGCATTTC	AGCGTTTC
AGGTGGTT	CGGTGGTT
AGCTGTTT	AGCGTTTC
AGGTGTCG	AGGGTCGG
AGGGAGTA	AAGGGAGT
AGGGAGTC	AAGGGAGT
AGGGAGTG	AAGGGAGT
AGGGAGTT	AAGGGAGT
AGGGAGTN	AAGGGAGT
AGGGATCG	AGGGTCGG
AGGATCGG	AGGGTCGG
AGGATTCC	CGGATTCC
AGGTTCGG	AGGGTCGG
AGCTTGTA	AACTTGTA
AGCTTTAA	GCTTTAAA
AGGGCAAA	AGGGCCAA
AGGGCAAC	AGGGCCAA
AGGGCAAG	AGGGCCAA
AGGGCAAT	AGGGCCAA
AGCTTTCA	AGCGTTTC
AGGGCAAN	AGGGCCAA
AGCTTTCC	AGCGTTTC
AGGGCACA	AGGGCCAA
AGTATAAC	ATATAACT
AGCTTTCG	AGCGTTTC
AGCTTTCT	AGCGTTTC
AGCTTTCN	AGCGTTTC
AGCCTTAG	GCCTTAGT
AGGTTGCC	AAGTTGCC
AGTATACG	CGTATACG
AGGGCCAA	AGGGCCAA
AGGGCCAC	AGGGCCAA
AGGGCCAG	AGGGCCAA
AGCTTTTC	AGCGTTTC
AGGGCCAT	AGGGCCAA
AGGGCCAN	AGGGCCAA
AGGGCCCA	AGGGCCAA
AGCCTTGG	ACCCTTGG
AGCCTTTC	AGCGTTTC
AGGTTTCA	AGCGTTTC
AGGTTTCC	AGCGTTTC
AGGTTTCG	AGCGTTTC
AGGGCCGA	AGGGCCAA
AGGTTTCT	AGCGTTTC
AGGTTTCN	AGCGTTTC
AGGGCCGG	AGGGTCGG
AGTATGGA	TAGTATGG
AGTATGGC	TAGTATGG
AGTATGGG	TAGTATGG
AGTATGGT	TAGTATGG
AGTATGGN	TAGTATGG
AGGGCCTA	AGGGCCAA
AGAGAAAT	AAGAAATC
AGGGCCNA	AGGGCCAA
AGGGCGAA	AGGGCCAA
AGAGAAGG	GAGAAGGG
AGTATTTC	ATATTTCC
AGGGCGCA	AGGGCCAA
AGGGCGGA	AGGGTCGG
AGGGCGGC	AGGGTCGG
AGGGCGGG	AGGGTCGG
AGGGCGGT	AGGGTCGG
AGGGCGGN	AGGGTCGG
AGGGCTAA	AGGGCCAA
AGGGCTCA	AGGGCCAA
AGGGCTCG	AGGGTCGG
AGAGAGCC	GAGAGCCG
AGTGCCAA	AGGGCCAA
AGGGCNAA	AGGGCCAA
AGGGCNCA	AGGGCCAA
AGNGCCAA	AGGGCCAA
AGAGAGTA	ACGAGAGT
AGAGAGTC	ACGAGAGT
AGAGAGTG	ACGAGAGT
AGAGAGTT	ACGAGAGT
AGAGAGTN	ACGAGAGT
AGTCAAGC	GTCAAGCC
AGTCAAGG	ATTCAAGG
AGAGCAGG	AAGCAGGC
AGAGCCAA	AGGGCCAA
AGTGGACA	GTGGACAA
ATAACAAG	AAACAAGT
AGAGCCGA	GAGAGCCG
AGAGCCGC	GAGAGCCG
AGAGCCGG	GAGAGCCG
AGAGCCGT	GAGAGCCG
AGAGCCGN	GAGAGCCG
ATAACCCC	TTAACCCC
AGTGGCCA	AGGGCCAA
ATAACCTT	AAACCTTT
ATAACGCG	ACAACGCG
AGTGGGGT	TGTGGGGT
AGTGGTCA	AATGGTCA
AGTGGTCG	AGGGTCGG
AGNGGCCA	AGGGCCAA
ATAAGAAC	CTAAGAAC
AGCGAGAG	ACGAGAGT
AGAGGCCA	AGGGCCAA
AGTCCTGC	ATTCCTGC
AGTGTCGG	AGGGTCGG
AGNGGTCG	AGGGTCGG
AGTGTCGT	ATGTCGTA
AGCGATTC	AGCGTTTC
AGCGATTT	AGCGTTTC
AGAGGGAG	AAGGGAGT
AGTGTTCA	GAGTGTTC
AGTGTTCC	GAGTGTTC
AGTGTTCG	GAGTGTTC
AGAGGTCG	AGGGTCGG
AGTGTTCT	GAGTGTTC
AGTGTTCN	GAGTGTTC
AGNGTCGG	AGGGTCGG
AGTGTTTC	AGCGTTTC
AGCGCCAA	AGGGCCAA
ATAATAAC	ATATAACT
ATAATATA	TAATATAT
AGCGCTCC	ACGCTCCT
AGCGCTTC	AGCGTTTC
AGCGCTTT	AGCGTTTC
AGTCGTAA	ATGTCGTA
AGTCGTAC	ATGTCGTA
AGTCGTAG	ATGTCGTA
AGTCGTAT	ATGTCGTA
AGTCGTAN	ATGTCGTA
ATAATCGA	TAATCGAG
AGTCGTTT	AGCGTTTC
AGNGTTTC	AGCGTTTC
AGCGGAAG	CGCGGAAG
AGCGGACT	TGCGGACT
AGAGTCGG	AGGGTCGG
AGCGGCCA	AGGGCCAA
ATAATTAG	ACAATTAG
AGAGTGTT	GAGTGTTC
ATAATTCC	ATATTTCC
AGAGTTGC	AAGTTGCC
ATAATTTC	ATATTTCC
AGAGTTTC	AGCGTTTC
AGCGGTAA	ACCGGTAA
AGCGGTCG	AGGGTCGG
AGCGGTTC	AGCGTTTC
AGCGGTTT	AGCGTTTC
AGTTCAAG	ATTCAAGG
AGTTCCTG	ATTCCTGC
AGGNCCAA	AGGGCCAA
ATACAACT	ATATAACT
ATACAAGG	ATTCAAGG
ATACAAGT	AAACAAGT
AGGNGCCA	AGGGCCAA
AGGNGTCG	AGGGTCGG
ATACCACC	TACCACCA
AGTTGCCA	AAGTTGCC
AGTTGCCC	AAGTTGCC
AGTTGCCG	AAGTTGCC
AGTTGCCT	AAGTTGCC
AGTTGCCN	AAGTTGCC
ATACCCGC	AACCCGCG
ATACCCTG	GTACCCTG
AGGNTCGG	AGGGTCGG
ATACCTGC	ATTCCTGC
ATACCTTT	AAACCTTT
AGNCGTTT	AGCGTTTC
ATAAAACT	ATATAACT
ATAAACTA	ATATAACT
ATAAACTC	ATATAACT
ATAAACTG	ATATAACT
AGTTTCCC	GTTTCCCG
ATAAACTT	ATATAACT
ATAAACTN	ATATAACT
ATAAAGGA	TAAAGGAT
ATACGGAT	GTACGGAT
AGTTTGCA	GTTTGCAT
AGTTTTGA	TGTTTTGA
ATATGAAC	ATATAACT
ATACTAAC	ATATAACT
ATATGACC	ATCTGACC
ATATGACT	ATATAACT
ATCAACGC	ACAACGCG
ATGCGGAC	TGCGGACT
ATCAAGCC	GTCAAGCC
ATCAAGGA	ATTCAAGG
ATCAAGGC	ATTCAAGG
ATCAAGGG	ATTCAAGG
ATCAAGGT	ATTCAAGG
ATCAAGGN	ATTCAAGG
ATGCGTAA	ATGTCGTA
ATGCGTAC	ATGTCGTA
ATGCGTAG	ATGTCGTA
ATGCGTAT	ATGTCGTA
ATGCGTAN	ATGTCGTA
ATGCGTTT	AGCGTTTC
ATACTGAC	ATCTGACC
ATATGGTC	AATGGTCA
ATCAATTA	ACAATTAG
ATATGTCC	ATATTTCC
ATACTTCC	ATATTTCC
ATATGTTC	ATATTTCC
ATACTTGT	AACTTGTA
ATACTTTC	ATATTTCC
ATCTCAAG	ATTCAAGG
ATATTAAC	ATATAACT
ATCTCACC	ATCTGACC
ATATTACC	ATATTTCC
ATATTACT	ATATAACT
ATGTAACT	ATATAACT
ATGTAAGC	TTGTAAGC
ATATTATC	ATATTTCC
ATCTCCGG	TCTCCGGG
ATCTCCTG	ATTCCTGC
ATATTCCA	ATATTTCC
ATATTCCC	ATATTTCC
ATGTACGT	ATGTCGTA
ATATTCCG	ATATTTCC
ATATTCCT	ATATTTCC
ATATTCCN	ATATTTCC
ATATTCTC	ATATTTCC
ATCTCGAC	ATCTGACC
AGTACCCT	GTACCCTG
ATCTCGTA	ATGTCGTA
ATGCTCCT	ACGCTCCT
ATGCTCGT	ATGTCGTA
ATGCTGAC	ATCTGACC
ATGTAGTA	ATGTCGTA
AGTACGGA	GTACGGAT
ATATTGCC	ATATTTCC
ATATTGTC	ATATTTCC
ATCAGAAA	TCAGAAAC
ATCAGACC	ATCTGACC
ATGAAATC	AAGAAATC
ATATTTAC	ATATTTCC
ATGAACTG	TGAACTGT
ATATTTCA	ATATTTCC
ATATTTCC	ATATTTCC
ATATTTCG	ATATTTCC
ATATTTCT	ATATTTCC
ATATTTCN	ATATTTCC
ATATTTGC	ATATTTCC
ATATTTTC	ATATTTCC
ATCAGGTC	TCAGGTCT
ATATTTNC	ATATTTCC
ATCTGAAC	ATCTGACC
ATCTGACA	ATCTGACC
ATCTGACC	ATCTGACC
ATCTGACG	ATCTGACC
ATATTNCC	ATATTTCC
ATCTGACT	ATCTGACC
ATCTGACN	ATCTGACC
ATCTGAGC	ATCTGACC
ATCTGATC	ATCTGACC
ATATTNTC	ATATTTCC
ATGTCAAG	ATTCAAGG
ATGTCAGT	ATGTCGTA
ATGTCATA	ATGTCGTA
ATATNAAC	ATATAACT
ATATNACT	ATATAACT
ATCTGANC	ATCTGACC
ATCTGCAC	ATCTGACC
ATCTGCCA	ATCTGACC
ATCTGCCC	ATCTGACC
ATCTGCCG	ATCTGACC
ATCTGCCT	ATCTGACC
ATCTGCCN	ATCTGACC
ATGACGTA	ATGTCGTA
ATCATAAC	ATATAACT
ATCTGGAC	ATCTGACC
ATCTGGCC	ATCTGACC
ATCATCGT	ACATCGTT
ATCATGAC	ATCTGACC
ATGTCCGT	ATGTCGTA
ATGTCCTA	ATGTCGTA
ATGTCCTG	ATTCCTGC
ATCTGTAC	ATCTGACC
ATGTCGAA	ATGTCGTA
ATGTCGAC	ATGTCGTA
ATGTCGAG	ATGTCGTA
ATGTCGAT	ATGTCGTA
ATCTGTCC	ATCTGACC
ATATNTCC	ATATTTCC
ATGTCGAN	ATGTCGTA
ATGTCGCA	ATGTCGTA
ATATNTTC	ATATTTCC
ATGTCGCT	ATGTCGTA
ATGTCGGA	ATGTCGTA
ATGTCGGT	ATGTCGTA
ATGTCGTA	ATGTCGTA
ATGTCGTC	ATGTCGTA
ATGTCGTG	ATGTCGTA
ATGTCGTT	ATGTCGTA
ATGTCGTN	ATGTCGTA
ATGTCGNA	ATGTCGTA
ATGTCGNT	ATGTCGTA
ATGTCTAA	ATGTCGTA
ATGTCTAC	ATGTCGTA
ATGTCTAG	ATGTCGTA
ATGTCTAT	ATGTCGTA
ATGTCTAN	ATGTCGTA
ATCATTTC	ATATTTCC
ATGTCTGA	TGTCTGAC
ATGTCTGT	ATGTCGTA
ATGTCTTA	ATGTCGTA
ATGAGAGT	ACGAGAGT
ATCTGNAC	ATCTGACC
ATCTGNCC	ATCTGACC
ATGGACAA	GTGGACAA
ATGTCNGT	ATGTCGTA
ATGTCNTA	ATGTCGTA
ATCTTACC	ATCTGACC
ATGTGACC	ATCTGACC
ATGTGCGT	ATGTCGTA
ATCTTGAC	ATCTGACC
ATCTTGGA	TCTTGGAG
ATCTTGTA	AACTTGTA
ATGAGTTA	TTGAGTTA
ATCTTTCC	ATATTTCC
ATGTGGGG	TGTGGGGT
ATGATAAC	ATATAACT
ATANAACT	ATATAACT
ATGTGGTA	ATGTCGTA
ATGTGTAA	ATGTCGTA
ATGTGTAC	ATGTCGTA
ATGTGTAG	ATGTCGTA
ATGTGTAT	ATGTCGTA
ATGTGTAN	ATGTCGTA
ATGATCCC	TGATCCCT
ATCTNACC	ATCTGACC
ATGATCGT	ATGTCGTA
ATCCAACG	TCCAACGA
ATCCAAGG	ATTCAAGG
ATGGCCAA	AGGGCCAA
ATAGAAAT	AAGAAATC
ATAGAACT	ATATAACT
ATGGCGCA	TGGCGCAT
ATGGCGTA	ATGTCGTA
ATGTTCGT	ATGTCGTA
ATGATTTC	ATATTTCC
ATCTNGAC	ATCTGACC
ATGTTGCC	AAGTTGCC
ATGTTGTA	ATGTCGTA
ATGTTTCC	ATATTTCC
ATGTTTTG	TGTTTTGA
ATCCCGCG	AACCCGCG
ATGGGAGT	AAGGGAGT
ATGGGATC	CTGGGATC
ATGTNCGT	ATGTCGTA
ATGGGCCA	AGGGCCAA
ATCCCTGC	ATTCCTGC
ATCCCTTG	ACCCTTGG
ATGTNGTA	ATGTCGTA
ATCCTGAC	ATCTGACC
ATCCTGCA	ATTCCTGC
ATCCTGCC	ATTCCTGC
ATCCTGCG	ATTCCTGC
ATCCGACC	ATCTGACC
ATCCTGCT	ATTCCTGC
ATGGGTCG	AGGGTCGG
ATCCTGCN	ATTCCTGC
ATCCGAGA	CATCCGAG
ATCCGAGC	CATCCGAG
ATCCGAGG	CATCCGAG
ATCCGAGT	CATCCGAG
ATAGCAGG	AAGCAGGC
ATCCGAGN	CATCCGAG
ATAGCATT	CTAGCATT
ATCCGCTA	TCCGCTAG
ATGCAAGG	ATTCAAGG
ATCCTTCA	TCCTTCAC
ATCCTTGG	ACCCTTGG
ATCCGGTA	ACCGGTAA
ATGCACGA	TTGCACGA
ATAGCGTA	TAGCGTAA
ATGCAGGC	AAGCAGGC
ATAGCTCG	CTAGCTCG
ATGGTCAA	AATGGTCA
ATGGTCAC	AATGGTCA
ATGGTCAG	AATGGTCA
ATGGTCAT	AATGGTCA
ATGGTCAN	AATGGTCA
ATGGTCGG	AGGGTCGG
ATGGTCGT	ATGTCGTA
ATAGGCCC	CTAGGCCC
ATAGGGAG	AAGGGAGT
ATGNCGTA	ATGTCGTA
ATCGACCA	ATCTGACC
ATCGACCC	ATCTGACC
ATCGACCG	ATCTGACC
ATCGACCT	ATCTGACC
ATCGACCN	ATCTGACC
ATCGAGAG	ACGAGAGT
ATGCCGTA	ATGTCGTA
ATCNGACC	ATCTGACC
ATCGATAA	GATCGATA
ATCGATAC	GATCGATA
ATCGATAG	GATCGATA
ATCGATAT	GATCGATA
ATCGATAN	GATCGATA
ATANTAAC	ATATAACT
ATGCCTGC	ATTCCTGC
ATAGTAAC	ATATAACT
ATAGTATG	TAGTATGG
ATTTAACT	ATATAACT
ATTTAAGG	ATTCAAGG
ATAGTCGT	ATGTCGTA
ATANTTCC	ATATTTCC
ATNGTCGT	ATGTCGTA
ATANTTTC	ATATTTCC
ATCGCTCC	ACGCTCCT
ATCNTGAC	ATCTGACC
ATCGGACC	ATCTGACC
ATAGTTCC	ATATTTCC
ATAGTTGC	AAGTTGCC
ATCGGCAG	TTCGGCAG
ATAGTTTC	ATATTTCC
ATCGGTAA	ACCGGTAA
ATNCAAGG	ATTCAAGG
ATTTCAAG	ATTCAAGG
ANACAAGT	AAACAAGT
ATNTAACT	ATATAACT
ATTCCAAG	ATTCAAGG
ATCGTCGT	ATGTCGTA
ATTCCAGC	ATTCCTGC
ATTCCAGG	ATTCAAGG
ATTCCATG	ATTCCTGC
ATTTCCCG	GTTTCCCG
ATCGTGAC	ATCTGACC
ATTCCCGC	ATTCCTGC
ATTCCCTG	ATTCCTGC
ATTTCCTG	ATTCCTGC
ATTCCGCA	ATTCCTGC
ATTCCGCC	ATTCCTGC
ATTCCGCG	ATTCCTGC
ATTCCGCT	ATTCCTGC
ATCGTTTC	AGCGTTTC
ATTCCGCN	ATTCCTGC
ATTCCGGC	ATTCCTGC
ATTCCGTG	ATTCCTGC
ATTCCTAC	ATTCCTGC
ATTTCGTA	ATGTCGTA
ATTCCTAG	ATTCCTGC
ATTCCTCA	ATTCCTGC
ATTCCTCC	ATTCCTGC
ATTCCTCG	ATTCCTGC
ATTCCTCT	ATTCCTGC
ATTCCTCN	ATTCCTGC
ATTCCTGA	ATTCCTGC
ATTCCTGC	ATTCCTGC
ATTCCTGG	ATTCCTGC
ATTCCTGT	ATTCCTGC
ATTCCTGN	ATTCCTGC
ATTCCTTC	ATTCCTGC
ATTCCTTG	ATTCCTGC
ATTCCTNC	ATTCCTGC
ATTCCTNG	ATTCCTGC
ANACCCGC	AACCCGCG
ATTCCNGC	ATTCCTGC
ATTCCNTG	ATTCCTGC
ATTCGAAG	ATTCAAGG
ATATAAAC	ATATAACT
ATATAAAT	ATATAACT
ATTCGAGG	ATTCAAGG
ATATAACA	ATATAACT
ATATAACC	ATATAACT
ATNCCTGC	ATTCCTGC
ATATAACG	ATATAACT
ATATAACT	ATATAACT
ATATAACN	ATATAACT
ATATAAGC	ATATAACT
ATTTCTGC	ATTCCTGC
ATATAAGT	ATATAACT
ATATAATA	ATATAACT
ATATAATC	ATATAACT
ANACCTTT	AAACCTTT
ATATAATG	ATATAACT
ATATAATT	ATATAACT
ATATAATN	ATATAACT
ATATAANC	ATATAACT
ATTCGCTG	ATTCCTGC
ATNTCAAG	ATTCAAGG
ATTCGGCA	TTCGGCAG
ATATAANT	ATATAACT
ATATACAC	ATATAACT
ATATACCT	ATATAACT
ATTCGTAA	ATGTCGTA
ATTCGTAC	ATGTCGTA
ATTCGTAG	ATGTCGTA
ATTCGTAT	ATGTCGTA
ATTCGTAN	ATGTCGTA
ATATACTA	ATATAACT
ATATACTC	ATATAACT
ATATACTG	ATATAACT
ATATACTT	ATATAACT
ATATACTN	ATATAACT
ATTCGTGC	ATTCCTGC
ATNTCCTG	ATTCCTGC
ATNTCGTA	ATGTCGTA
ATATAGAC	ATATAACT
ATTTGACC	ATCTGACC
ATTCTAAG	ATTCAAGG
ATTCTACA	TTCTACAT
ATATAGCT	ATATAACT
ATTCTAGG	ATTCAAGG
ATATATAC	ATATAACT
ATATATCC	ATATTTCC
ATATATCT	ATATAACT
ATCTAACC	ATCTGACC
ATCTAACT	ATATAACT
ATATATTC	ATATTTCC
ATNTGACC	ATCTGACC
ATTCTCTA	CTTCTCTA
ATTCTCTG	ATTCCTGC
ATATANAC	ATATAACT
ATATANCT	ATATAACT
ATTTGCAT	GTTTGCAT
ATCTACAT	TTCTACAT
ATCTACCA	ATCTGACC
ATCTACCC	ATCTGACC
ATCTACCG	ATCTGACC
ATCTACCT	ATCTGACC
ATCTACCN	ATCTGACC
ATATCAAC	ATATAACT
ATATCAAG	ATTCAAGG
ATCTAGAC	ATCTGACC
ATATCACT	ATATAACT
ATTCTGAC	ATCTGACC
ATTCTGCA	ATTCCTGC
ATTCTGCC	ATTCCTGC
ATTTGTGG	TTTGTGGC
ATTCTGCG	ATTCCTGC
ATTCTGCT	ATTCCTGC
ATTCTGCN	ATTCCTGC
ATATCCTG	ATTCCTGC
ATATCGTA	ATGTCGTA
ATTCTTGC	ATTCCTGC
ATATCGTT	ACATCGTT
ATATCTCC	ATATTTCC
ATATCTTC	ATATTTCC
ANACTTGT	AACTTGTA
ATTCNAAG	ATTCAAGG
ATTTTCCA	ATATTTCC
ATTTTCCC	ATATTTCC
ATTTTCCG	ATATTTCC
ATTTTCCT	ATATTTCC
ATTTTCCN	ATATTTCC
ATNCTGAC	ATCTGACC
ATGNTCGT	ATGTCGTA
ATTCNAGG	ATTCAAGG
ATTTTTCC	ATATTTCC
ATTCNCTG	ATTCCTGC
ANAACAAG	AAACAAGT
ANAACCTT	AAACCTTT
ATTCNTGC	ATTCCTGC
ANAGAAAT	AAGAAATC
ANAACGCG	ACAACGCG
ATTGAAGG	ATTCAAGG
ATNTTTCC	ATATTTCC
ATTGACCA	ATCTGACC
ATTGACCC	ATCTGACC
ATTGACCG	ATCTGACC
ATTGACCT	ATCTGACC
ATTGACCN	ATCTGACC
ATTAAAGG	ATTCAAGG
ATTGAGTT	TTGAGTTA
ANAGCAGG	AAGCAGGC
ATTAACCC	TTAACCCC
ATTAACTA	ATATAACT
ATTAACTC	ATATAACT
ATTAACTG	ATATAACT
ATTAACTT	ATATAACT
ATTAACTN	ATATAACT
ATTAAGGA	ATTCAAGG
ATTAAGGC	ATTCAAGG
ATTAAGGG	ATTCAAGG
ATTAAGGT	ATTCAAGG
ATTAAGGN	ATTCAAGG
ATTAATGC	CTTAATGC
ATTNAAGG	ATTCAAGG
ANGTTGCC	AAGTTGCC
ATTACAAG	ATTCAAGG
ATTGCAAG	ATTCAAGG
ANGAGAGT	ACGAGAGT
ATTGCACG	TTGCACGA
ATTACCAA	CTTACCAA
ANAATTAG	ACAATTAG
ATTACCTG	ATTCCTGC
ATTNCAAG	ATTCAAGG
ATTACTGC	ATTCCTGC
ATTNCCTG	ATTCCTGC
ATTGCCTG	ATTCCTGC
ATTNCTGC	ATTCCTGC
ANCATCGT	ACATCGTT
ATTGCTGC	ATTCCTGC
ANGGCCAA	AGGGCCAA
ATTATAAC	ATATAACT
ATNATAAC	ATATAACT
ANGGGAGT	AAGGGAGT
ATTATTTC	ATATTTCC
ANGGGCCA	AGGGCCAA
ATTGGTCA	AATGGTCA
ATNATTTC	ATATTTCC
ANGGGTCG	AGGGTCGG
ATTGTAAG	TTGTAAGC
ATTGTCGT	ATGTCGTA
ANGCAGGC	AAGCAGGC
ATTGTGGC	TTTGTGGC
ANGGTCGG	AGGGTCGG
ATTCAAAG	ATTCAAGG
ATTCAACG	ATTCAAGG
ATTCAAGA	ATTCAAGG
ATTCAAGC	ATTCAAGG
ATTCAAGG	ATTCAAGG
ATTCAAGT	ATTCAAGG
ATTCAAGN	ATTCAAGG
ATTCAATG	ATTCAAGG
ATTCAANG	ATTCAAGG
ATTCACAG	ATTCAAGG
ATTCACGG	ATTCAAGG
ATTCACTG	ATTCCTGC
ATTCAGAG	ATTCAAGG
ATTCAGGA	ATTCAAGG
ATTCAGGC	ATTCAAGG
ATTCAGGG	ATTCAAGG
ATTCAGGT	ATTCAAGG
ATTCAGGN	ATTCAAGG
ATTCATAG	ATTCAAGG
ATTCATGC	ATTCCTGC
ATTCATGG	ATTCAAGG
ANCGCTCC	ACGCTCCT
ATTCANAG	ATTCAAGG
ANCCCGCG	AACCCGCG
ATTCANGG	ATTCAAGG
ANCCCTTG	ACCCTTGG
ANAGGGAG	AAGGGAGT
ANGCGTTT	AGCGTTTC
ANCGGTAA	ACCGGTAA
ANCCGGTA	ACCGGTAA
ANGCTCCT	ACGCTCCT
ANAGTTGC	AAGTTGCC
ANCGTTTC	AGCGTTTC
ANGTCGTA	ATGTCGTA
ANATAACT	ATATAACT
ANCCTTGG	ACCCTTGG
CAACGCCA	CAAAGCCA
CAACGCGA	ACAACGCG
CAACGCGC	ACAACGCG
CAACGCGG	ACAACGCG
CAACGCGT	ACAACGCG
CAACGCGN	ACAACGCG
CAACGGCA	CACGGCAT
ANATCGTT	ACATCGTT
ANCAACGC	ACAACGCG
ANCGAGAG	ACGAGAGT
CAACTCAG	CAGCTCAG
ANGAAATC	AAGAAATC
ANCAATTA	ACAATTAG
ANCTGACC	ATCTGACC
CAACTTGT	AACTTGTA
CAAAACCA	CAAAGCCA
CAAAAGCC	CAAAGCCA
ANATGGTC	AATGGTCA
ANCTTGTA	AACTTGTA
CAAAATGG	CCAAATGG
CAAACAAG	AAACAAGT
CAAACCAA	CAAAGCCA
CAAACCAC	CAAAGCCA
CAAACCAG	CAAAGCCA
CAAACCAT	CAAAGCCA
CAAACCAN	CAAAGCCA
CAAACCCA	CAAAGCCA
CAAACCTT	AAACCTTT
CAAACGCC	CAAAGCCA
ANATTTCC	ATATTTCC
CAAAGAAC	CTAAGAAC
CAAAGACA	CAAAGCCA
CAAAGACC	CAAAGCCA
CAAGAAAT	AAGAAATC
CAAGAACA	CTAAGAAC
CAAGAACC	CTAAGAAC
CAAGAACG	CTAAGAAC
CAAGAACT	CTAAGAAC
CAAAGCAA	CAAAGCCA
CAAAGCAC	CAAAGCCA
CAAAGCAG	CAAAGCCA
CAAAGCAT	CAAAGCCA
CAAAGCAN	CAAAGCCA
CAAAGCCA	CAAAGCCA
CAAAGCCC	CAAAGCCA
CAAAGCCG	CAAAGCCA
CAAAGCCT	CAAAGCCA
CAAAGCCN	CAAAGCCA
CAAAGCGA	CAAAGCCA
CAAAGCGC	CAAAGCCA
CAAGAACN	CTAAGAAC
CAAAGCTA	CAAAGCCA
CAAAGCTC	CAAAGCCA
CAAAGCNA	CAAAGCCA
CAAAGCNC	CAAAGCCA
CAAAGGAT	TAAAGGAT
CAAAGGCA	CAAAGCCA
CAAAGGCC	CAAAGCCA
CAAAGTAA	GCAAAGTA
CAAAGTAC	GCAAAGTA
CAAAGTAG	GCAAAGTA
CAAAGTAT	GCAAAGTA
CAAAGTAN	GCAAAGTA
CAAAGTCA	CAAAGCCA
CAAAGTCC	CAAAGCCA
CAAAGNCA	CAAAGCCA
CAAAGNCC	CAAAGCCA
CAAGAGCC	CAAAGCCA
CAAATCCA	CAAAGCCA
CAAATGCC	CAAAGCCA
CAAATGGA	CCAAATGG
CAAATGGC	CCAAATGG
CAAATGGG	CCAAATGG
CAAATGGT	CCAAATGG
CAAATGGN	CCAAATGG
ANTGGTCA	AATGGTCA
CAAANCCA	CAAAGCCA
ANTATAAC	ATATAACT
CAAGCAGG	AAGCAGGC
CAAGCATT	CTAGCATT
CAAGCCAA	CAAAGCCA
CAAGCCAC	CAAAGCCA
CAAGCCAG	CAAAGCCA
CAAGCCAT	CAAAGCCA
CAAGCCAN	CAAAGCCA
CAAANGCC	CAAAGCCA
ANTGTCGT	ATGTCGTA
CAAGCTCA	CAGCTCAG
CAAGCTCG	CTAGCTCG
ANTATTTC	ATATTTCC
CAACAAGT	AAACAAGT
CAAGGCAT	CACGGCAT
CAAGGCCA	CAAAGCCA
CAAGGCCC	CTAGGCCC
CAAGGGAG	AAGGGAGT
CAACAGCC	CAAAGCCA
ANTCAAGG	ATTCAAGG
CAACCCGC	AACCCGCG
CAACCCGG	CGACCCGG
CAAGTTGC	AAGTTGCC
CAGCACAG	CAGCTCAG
ANTTCAAG	ATTCAAGG
CAACCGAG	CATCCGAG
ANTTCCTG	ATTCCTGC
CAGCAGGC	AAGCAGGC
CAGCATCA	CAGCTCAG
CAACCTTT	AAACCTTT
CAGCATTA	CTAGCATT
CAGCATTC	CTAGCATT
CAGCATTG	CTAGCATT
CAGCATTT	CTAGCATT
CAGCATTN	CTAGCATT
CAGGTCAG	CAGCTCAG
CAGCCAGA	CAGCTCAG
CAGCCAGC	CAGCTCAG
CAGCCAGG	CAGCTCAG
CAGCCAGT	CAGCTCAG
CAGCCAGN	CAGCTCAG
CAGGTCTA	TCAGGTCT
CAGGTCTC	TCAGGTCT
CAGGTCTG	TCAGGTCT
CAGGTCTT	TCAGGTCT
CAGGTCTN	TCAGGTCT
CAGCCCAG	CAGCTCAG
ANTCCTGC	ATTCCTGC
CAGGTGGT	CGGTGGTT
CAGCCGAG	CATCCGAG
CAGCCTCA	CAGCTCAG
CAGNCTCA	CAGCTCAG
CACAAATG	CCAAATGG
CACCCACT	CCCCACTG
CACAACGC	ACAACGCG
CACAAGCC	CAAAGCCA
CACCCGAG	CATCCGAG
CACCCGCG	AACCCGCG
CACCCGGA	CGACCCGG
CACCCGGC	CGACCCGG
CACCCGGG	CGACCCGG
CACCCGGT	CGACCCGG
CACCCGGN	CGACCCGG
CACAATTA	ACAATTAG
CAGCGCAG	CAGCTCAG
CACCCTAA	CCCCTAAA
ANTCTGAC	ATCTGACC
CACCCTTG	ACCCTTGG
CAGCGGAA	CGCGGAAG
CACCGAGA	CATCCGAG
CACCGAGC	CATCCGAG
CACCGAGG	CATCCGAG
CACCGAGT	CATCCGAG
CACCGAGN	CATCCGAG
CAGCGGCA	CACGGCAT
CACCGCAT	CACGGCAT
CACGNCAT	CACGGCAT
CAGCGTAA	TAGCGTAA
CACGNGCA	CACGGCAT
CAGCGTCA	CAGCTCAG
CACCGGCA	CACGGCAT
CACCGGTA	ACCGGTAA
CAATAGCC	CAAAGCCA
CAATATAT	TAATATAT
CAGCGTTT	AGCGTTTC
CAGNTCAG	CAGCTCAG
CACCTAAA	CCCCTAAA
CAGTATAC	CGTATACG
CACAGCAT	CACGGCAT
CACAGCCA	CAAAGCCA
CACTAACT	GACTAACT
CACCTCAG	CAGCTCAG
CAGTATGG	TAGTATGG
CACCTGTC	CCCTGTCG
CAGCTAAG	CAGCTCAG
CAGCTACA	CAGCTCAG
CAGCTAGA	CAGCTCAG
CAGCTAGC	CAGCTCAG
CAGCTAGG	CAGCTCAG
CAGCTAGT	CAGCTCAG
CAGCTAGN	CAGCTCAG
CACAGGCA	CACGGCAT
CACTACTA	GACTACTA
CAGCTCAA	CAGCTCAG
CAGCTCAC	CAGCTCAG
CAGCTCAG	CAGCTCAG
CAGCTCAT	CAGCTCAG
CAGCTCAN	CAGCTCAG
CAGCTCCA	CAGCTCAG
CAGCTCCG	CAGCTCAG
CAGCTCTA	CAGCTCAG
CAGCTCTG	CAGCTCAG
CAGCTCNA	CAGCTCAG
CAGCTCNG	CAGCTCAG
CAGCTGAG	CAGCTCAG
CAGTCAGA	CAGCTCAG
CAGTCAGC	CAGCTCAG
CAGTCAGG	CAGCTCAG
CAGTCAGT	CAGCTCAG
CAGTCAGN	CAGCTCAG
CAGCTGCA	CAGCTCAG
CACAGTTA	CCCAGTTA
CAATCCGA	CATCCGAG
CAGTCCGA	CATCCGAG
CAATCCTC	GAATCCTC
CACTCAGA	CAGCTCAG
CACTCAGC	CAGCTCAG
CACTCAGG	CAGCTCAG
CACTCAGT	CAGCTCAG
CACTCAGN	CAGCTCAG
CAGCTTAG	CAGCTCAG
CAGCTTCA	CAGCTCAG
CAATCGAG	TAATCGAG
CACNGCAT	CACGGCAT
CAGTCTCA	CAGCTCAG
CACTCCGA	CATCCGAG
CAGCTNAG	CAGCTCAG
CACATCCA	CCCATCCA
CACATCGT	ACATCGTT
CAGCTNCA	CAGCTCAG
CACTCGAT	CCTCGATT
CACNGGCA	CACGGCAT
CAGCNCAG	CAGCTCAG
CAATGCCA	CAAAGCCA
CAGTGGTT	CGGTGGTT
CAATGGTC	AATGGTCA
CAGTGTTC	GAGTGTTC
CACGACAT	CACGGCAT
CATAAGAA	CTAAGAAC
CATAAGCC	CAAAGCCA
CACGAGAG	ACGAGAGT
CATAATGC	CTTAATGC
CACGAGCA	CACGGCAT
CAGCNTCA	CAGCTCAG
CAGTTCAG	CAGCTCAG
CACTGCAA	CCTGCAAG
CACTGCAT	CACGGCAT
CATACCAA	CTTACCAA
CAGTTGAG	CCGTTGAG
CATACCGA	CATCCGAG
CAGTTGCC	AAGTTGCC
CATACGAG	CATCCGAG
CAATTAGA	ACAATTAG
CAATTAGC	ACAATTAG
CAATTAGG	ACAATTAG
CAATTAGT	ACAATTAG
CAATTAGN	ACAATTAG
CACTGGCA	CACGGCAT
CAATTATT	CGATTATT
CACTGTCG	CCCTGTCG
CATAGCAT	CTAGCATT
CACGCATA	CACGGCAT
CACGCATC	CACGGCAT
CATAGCCA	CAAAGCCA
CACGCATG	CACGGCAT
CACGCATT	CACGGCAT
CAGGATTC	CGGATTCC
CACGCATN	CACGGCAT
CATAGCTC	CTAGCTCG
CACGCCAT	CACGGCAT
CATAGGCC	CTAGGCCC
CACGCGCA	CACGGCAT
CACCACCA	TACCACCA
CACGCTCA	CAGCTCAG
CACGCTCC	ACGCTCCT
CACCACTG	CCCCACTG
CATATAAC	ATATAACT
CATATACG	CGTATACG
CAGGCATA	CACGGCAT
CAGGCATC	CACGGCAT
CAGGCATG	CACGGCAT
CAGGCATT	CACGGCAT
CAGGCATN	CACGGCAT
CACCAGTT	CCCAGTTA
CACGGAAG	CGCGGAAG
CACGGAAT	CACGGCAT
CACGGACA	CACGGCAT
CACCATCC	CCCATCCA
CACTTCTA	GCACTTCT
CACGGATA	CACGGCAT
CACTTCTC	GCACTTCT
CACGGATC	CACGGCAT
CACTTCTG	GCACTTCT
CACGGATG	CACGGCAT
CACTTCTT	GCACTTCT
CACGGATT	CACGGCAT
CACTTCTN	GCACTTCT
CACGGATN	CACGGCAT
CAGAAACA	TCAGAAAC
CAGAAACC	TCAGAAAC
CAGAAACG	TCAGAAAC
CAGAAACT	TCAGAAAC
CAGAAACN	TCAGAAAC
CACGGCAA	CACGGCAT
CACGGCAC	CACGGCAT
CACGGCAG	CACGGCAT
CACGGCAT	CACGGCAT
CAGAAATC	AAGAAATC
CACGGCAN	CACGGCAT
CACGGCCA	CACGGCAT
CAGGCCCA	CTAGGCCC
CAGGCCCC	CTAGGCCC
CAGGCCCG	CTAGGCCC
CACGGCCT	CACGGCAT
CAGGCCCT	CTAGGCCC
CAGGCCCN	CTAGGCCC
CACGGCGA	CACGGCAT
CACGGCGT	CACGGCAT
CACGGCTA	CACGGCAT
CACGGCTC	CACGGCAT
CACGGCTG	CACGGCAT
CACGGCTT	CACGGCAT
CACGGCTN	CACGGCAT
CACGGCNA	CACGGCAT
CACGGCNT	CACGGCAT
CACGGGAT	CACGGCAT
CACGGGCA	CACGGCAT
CATATTTC	ATATTTCC
CACTTGTA	AACTTGTA
CATGGCAT	CACGGCAT
CAGGCTCA	CAGCTCAG
CAGAAGCC	CAAAGCCA
CAGAAGGG	GAGAAGGG
CATGGGAT	CTGGGATC
CCAGAAAC	TCAGAAAC
CACGGTAT	CACGGCAT
CACGGTCA	CACGGCAT
CATGGTCA	AATGGTCA
CAGGGAGT	AAGGGAGT
CAGGGATC	CTGGGATC
CAANAGCC	CAAAGCCA
CCAGAATG	CCAAATGG
CAGGGCAT	CACGGCAT
CAGGGCCA	AGGGCCAA
CACGGNAT	CACGGCAT
CACGGNCA	CACGGCAT
CCAAGAAC	CTAAGAAC
CCAAGATG	CCAAATGG
CAGGGTCG	AGGGTCGG
CACGTCAT	CACGGCAT
CCAAGCCA	CAAAGCCA
CAGACCCG	CGACCCGG
CATGTCGT	ATGTCGTA
CACGTGCA	CACGGCAT
CACGTTGA	CCGTTGAG
CCAGATGG	CCAAATGG
CAGACTCA	CAGCTCAG
CCAAGTGG	CCAAATGG
CCAAGTTA	CCCAGTTA
CCAGCAAG	CCTGCAAG
CCAATATG	CCAAATGG
CCAGCATT	CTAGCATT
CCAATCCA	CCCATCCA
CAANGCCA	CAAAGCCA
CAGAGCCA	CAAAGCCA
CAGAGCCG	GAGAGCCG
CCAATGGA	CCAAATGG
CCAATGGC	CCAAATGG
CCAATGGG	CCAAATGG
CCAATGGT	CCAAATGG
CCAATGGN	CCAAATGG
CCAATTAG	ACAATTAG
CCAATTGG	CCAAATGG
CATTAATG	CTTAATGC
CATTACCA	CTTACCAA
CCAGCTCA	CAGCTCAG
CCAGCTCG	CTAGCTCG
CATNCCGA	CATCCGAG
CATNCGAG	CATCCGAG
CCAANATG	CCAAATGG
CCAGGCCC	CTAGGCCC
CAGATCAG	CAGCTCAG
CCAGGTCT	TCAGGTCT
CATTATTA	CGATTATT
CATTATTC	CGATTATT
CATTATTG	CGATTATT
CATTATTT	CGATTATT
CATTATTN	CGATTATT
CCAANTGG	CCAAATGG
CATCACGA	CATCCGAG
CAGATTAT	CGATTATT
CAGATTCC	CGGATTCC
CATCAGAG	CATCCGAG
CATTCAAG	ATTCAAGG
CCAGTTAA	CCCAGTTA
CCAGTTAC	CCCAGTTA
CCAGTTAG	CCCAGTTA
CCAGTTAT	CCCAGTTA
CCAGTTAN	CCCAGTTA
CCAGTTGA	CCGTTGAG
CATTCCGA	CATCCGAG
CATTCCTG	ATTCCTGC
CATTCGAG	CATCCGAG
CCACAATG	CCAAATGG
CATTCTCT	CTTCTCTA
CATCCAAG	CATCCGAG
CCACACTG	CCCCACTG
CATCCAGA	CATCCGAG
CATCCAGC	CATCCGAG
CATCCAGG	CATCCGAG
CATCCAGT	CATCCGAG
CATCCAGN	CATCCGAG
CCACAGTT	CCCAGTTA
CATCCCAG	CATCCGAG
CATCCCGA	CATCCGAG
CATCCGAA	CATCCGAG
CATCCGAC	CATCCGAG
CATCCGAG	CATCCGAG
CATCCGAT	CATCCGAG
CATCCGAN	CATCCGAG
CATCCGCA	CATCCGAG
CATCCGCG	CATCCGAG
CATCCGGA	CATCCGAG
CATCCGGC	CATCCGAG
CATCCGGG	CATCCGAG
CATCCGGT	CATCCGAG
CATCCGGN	CATCCGAG
CCATAATG	CCAAATGG
CCACATCC	CCCATCCA
CCACATGG	CCAAATGG
CATCCGTA	CATCCGAG
CATCCGTG	CATCCGAG
CATCCGNA	CATCCGAG
CATCCGNG	CATCCGAG
CATCCTAG	CATCCGAG
CATCCTGA	CATCCGAG
CANGCTCA	CAGCTCAG
CCATATGG	CCAAATGG
CATCCNAG	CATCCGAG
CATCCNGA	CATCCGAG
CCACCACT	CCCCACTG
CCATCCAA	CCCATCCA
CCATCCAC	CCCATCCA
CCATCCAG	CCCATCCA
CCATCCAT	CCCATCCA
CCATCCAN	CCCATCCA
CATCGAGA	CATCCGAG
CCATCCGA	CATCCGAG
CATCGAGC	CATCCGAG
CATCGAGG	CATCCGAG
CATCGAGT	CATCCGAG
CATCGAGN	CATCCGAG
CCACCCGG	CGACCCGG
CATCGATA	GATCGATA
CATCGATT	CCTCGATT
CCATCGAT	CCTCGATT
CANGGCAT	CACGGCAT
CATCGCGA	CATCCGAG
CCATCGTT	ACATCGTT
CATCGGAG	CATCCGAG
CANCCGAG	CATCCGAG
CATCGGCA	CACGGCAT
CCACCTAA	CCCCTAAA
CATCGTTA	ACATCGTT
CATCGTTC	ACATCGTT
CATCGTTG	ACATCGTT
CATCGTTT	ACATCGTT
CATCGTTN	ACATCGTT
CANAAGCC	CAAAGCCA
CCAAAAGG	CCAAATGG
CCATGCAA	CCTGCAAG
CCACGATT	CCTCGATT
CCAAAATG	CCAAATGG
CCAAACGG	CCAAATGG
CCAAACTG	CCAAATGG
CCAAAGCC	CAAAGCCA
CANCGGCA	CACGGCAT
CCAAAGGA	CCAAATGG
CCAAAGGC	CCAAATGG
CCAAAGGG	CCAAATGG
CCAAAGGT	CCAAATGG
CCACGGCA	CACGGCAT
CCAAAGGN	CCAAATGG
CCAAAGTA	GCAAAGTA
CCAAAGTG	CCAAATGG
CCATGTCG	CCCTGTCG
CCAAATAG	CCAAATGG
CCAAATCG	CCAAATGG
CCAAATGA	CCAAATGG
CCAAATGC	CCAAATGG
CCAAATGG	CCAAATGG
CCAAATGT	CCAAATGG
CCAAATGN	CCAAATGG
CCAAATTG	CCAAATGG
CCAAATNG	CCAAATGG
CCAAANGG	CCAAATGG
CCAAANTG	CCAAATGG
CATCTCAG	CAGCTCAG
CATCTCGA	CATCCGAG
CATCTCTA	CTTCTCTA
CCAACATG	CCAAATGG
CANCTCAG	CAGCTCAG
CCAACGAA	TCCAACGA
CCAACGAC	TCCAACGA
CCAACGAG	TCCAACGA
CCAACGAT	TCCAACGA
CCAACGAN	TCCAACGA
CCAACGCG	ACAACGCG
CATCTGAC	ATCTGACC
CATCTGAG	CATCCGAG
CCAACTGG	CCAAATGG
CCACTAAA	CCCCTAAA
CANAGCCA	CAAAGCCA
CCTAAATG	CCAAATGG
CCGCTAAA	CCCCTAAA
CCGCTAGA	TCCGCTAG
CCGCTAGC	TCCGCTAG
CCGCTAGG	TCCGCTAG
CCGCTAGT	TCCGCTAG
CCGCTAGN	TCCGCTAG
CCGCTCAG	CAGCTCAG
CCGCTCCT	ACGCTCCT
CCTAAGAA	CTAAGAAC
CCGCTGAG	CCGTTGAG
CCACTGTC	CCCTGTCG
CATCNCGA	CATCCGAG
CCTAATGC	CTTAATGC
CCGCTGTC	CCCTGTCG
CCACTTCT	GCACTTCT
CATCNGAG	CATCCGAG
CCCACACT	CCCCACTG
CCGCTTGA	CCGTTGAG
CCTAATGG	CCAAATGG
CCCCNAAA	CCCCTAAA
CCCCNACT	CCCCACTG
CCCACCAA	CCCATCCA
CCCACCAC	CCCATCCA
CCCACCAG	CCCATCCA
CCCACCAT	CCCATCCA
CCCACCAN	CCCATCCA
CCCACCCA	CCCATCCA
CCCCNCTG	CCCCACTG
CCTACAAG	CCTGCAAG
CCCCNTAA	CCCCTAAA
CCCACGTT	CCCAGTTA
CCCACTAA	CCCCTAAA
CCCACTCC	CCCATCCA
CCCACTGA	CCCCACTG
CCCACTGC	CCCCACTG
CCCACTGG	CCCCACTG
CCTACCAA	CTTACCAA
CCCACTGT	CCCCACTG
CCCACTGN	CCCCACTG
CCCACTTA	CCCAGTTA
CCTACGAT	CCTCGATT
CCCGACTG	CCCCACTG
CCGGAAGA	CGCGGAAG
CCGGAAGC	CGCGGAAG
CCGGAAGG	CGCGGAAG
CCGGAAGT	CGCGGAAG
CCGGAAGN	CGCGGAAG
CCCAGATA	CCCAGTTA
CCCGAGTT	CCCAGTTA
CCCAGATT	CCCAGTTA
CCCGATCC	CCCATCCA
CCCGATTA	CCTCGATT
CCCGATTC	CCTCGATT
CCCGATTG	CCTCGATT
CCCGATTT	CCTCGATT
CCCGATTN	CCTCGATT
CCCAGCCA	CCCATCCA
CCCGCAAG	CCTGCAAG
CCCAGCTA	CCCAGTTA
CCCAGCTT	CCCAGTTA
CCCGCACT	CCCCACTG
CCCTGACG	CCCTGTCG
CCGGATTC	CGGATTCC
CCCTGATC	CCCTGTCG
CCCAGGTA	CCCAGTTA
CCCAGGTT	CCCAGTTA
CCTAGATT	CCTCGATT
CCCAGTAA	CCCAGTTA
CCCAGTAC	CCCAGTTA
CCCAGTAG	CCCAGTTA
CCCTGCAA	CCTGCAAG
CCCAGTAT	CCCAGTTA
CCCAGTAN	CCCAGTTA
CCTAGCAA	CCTGCAAG
CCCAGTCA	CCCAGTTA
CCCAGTCC	CCCATCCA
CCTAGCAT	CTAGCATT
CCCAGTCG	CCCTGTCG
CCGGCAAG	CCTGCAAG
CCCAGTCT	CCCAGTTA
CCCAGTGA	CCCAGTTA
CCCAGTGT	CCCAGTTA
CCCAGTTA	CCCAGTTA
CCCAGTTC	CCCAGTTA
CCCAGTTG	CCCAGTTA
CCCAGTTT	CCCAGTTA
CCCAGTTN	CCCAGTTA
CCTAGCTC	CTAGCTCG
CCCAGTNA	CCCAGTTA
CCGGCATA	CACGGCAT
CCCGCTAA	CCCCTAAA
CCCAGTNT	CCCAGTTA
CCCGCTAG	TCCGCTAG
CCGGCATC	CACGGCAT
CCGGCATG	CACGGCAT
CCGGCATT	CACGGCAT
CCGGCATN	CACGGCAT
CCCTGCCG	CCCTGTCG
CCCTGCGA	CCCTGTCG
CCTAGGCC	CTAGGCCC
CCCTGCGC	CCCTGTCG
CCCTGCGG	CCCTGTCG
CCCAGNTA	CCCAGTTA
CCCTGCGT	CCCTGTCG
CCCTGCGN	CCCTGTCG
CCCAGNTT	CCCAGTTA
CCCTGCTC	CCCTGTCG
CCGTCGAG	CCGTTGAG
CCGTCGAT	CCTCGATT
CCCATAAA	CCCCTAAA
CCCATACA	CCCATCCA
CCCATACC	CCCATCCA
CCCGGAAG	CGCGGAAG
CATGCAAG	CCTGCAAG
CCTAGTTA	CCCAGTTA
CCCATCAA	CCCATCCA
CCCATCAC	CCCATCCA
CCCATCAG	CCCATCCA
CCCATCAT	CCCATCCA
CCCATCAN	CCCATCCA
CCCATCCA	CCCATCCA
CCCATCCC	CCCATCCA
CCCGGCAT	CACGGCAT
CCGTCTGA	CCGTTGAG
CCCTGGCG	CCCTGTCG
CCCATCCG	CCCATCCA
CCCATCCT	CCCATCCA
CCCATCCN	CCCATCCA
CCCATCGA	CCCATCCA
CCCATCGC	CCCATCCA
CCTATACG	CGTATACG
CCCGGGTC	GCCGGGTC
CATGCCGA	CATCCGAG
CCCTGGTC	CCCTGTCG
CCCATCTA	CCCATCCA
CCCGGTAA	ACCGGTAA
CCCATCTC	CCCATCCA
CCCATCNA	CCCATCCA
CCCATCNC	CCCATCCA
CCCGGTCG	CCCTGTCG
CCTATCCA	CCCATCCA
CCCGGTTA	CCCAGTTA
CCCATGCA	CCCATCCA
CCCTGTAC	CCCTGTCG
CCCATGCC	CCCATCCA
CCCTGTAG	CCCTGTCG
CCCTGTCA	CCCTGTCG
CCGGGATC	CTGGGATC
CCCTGTCC	CCCTGTCG
CCCTGTCG	CCCTGTCG
CCCTGTCT	CCCTGTCG
CCCTGTCN	CCCTGTCG
CCCTGTGA	CCCTGTCG
CCCTGTGC	CCCTGTCG
CCCTGTGG	CCCTGTCG
CCCTGTGT	CCCTGTCG
CCCTGTGN	CCCTGTCG
CCCTGTTA	CCCAGTTA
CCCTGTTC	CCCTGTCG
CATGCGAG	CATCCGAG
CCCATGTC	CCCTGTCG
CCCATGTT	CCCAGTTA
CCCGTAAA	CCCCTAAA
CCCATTAA	CCCAGTTA
CCCATTAC	CCCAGTTA
CCCATTAG	CCCAGTTA
CCCATTAT	CCCAGTTA
CCCATTAN	CCCAGTTA
CCCATTCA	CCCATCCA
CCCATTCC	CCCATCCA
CCCATTTA	CCCAGTTA
CCCTGTTG	CCCTGTCG
CCGTGAGA	CCGTTGAG
CCGTGAGC	CCGTTGAG
CCCTGTNC	CCCTGTCG
CCGTGAGG	CCGTTGAG
CCCTGTNG	CCCTGTCG
CCGTGAGT	CCGTTGAG
CCGTGAGN	CCGTTGAG
CATGCTCA	CAGCTCAG
CCCATNCA	CCCATCCA
CCCATNCC	CCCATCCA
CCGGGTCA	GCCGGGTC
CCGGGTCC	GCCGGGTC
CCCTGNCG	CCCTGTCG
CCGGGTCG	GCCGGGTC
CCGTGCAA	CCTGCAAG
CCGGGTCT	GCCGGGTC
CCGGGTCN	GCCGGGTC
CCCTGNTC	CCCTGTCG
CCCGTCCA	CCCATCCA
CCCGTCGA	CCCTGTCG
CCCGTCGC	CCCTGTCG
CCCGTCGG	CCCTGTCG
CCCGTCGT	CCCTGTCG
CCCGTCGN	CCCTGTCG
CCCTTAAA	CCCCTAAA
CANTCCGA	CATCCGAG
CCGTGGAG	CCGTTGAG
CCCGTGTC	CCCTGTCG
CCGTGGTT	CGGTGGTT
CCCGTTAA	CCCAGTTA
CCCANCCA	CCCATCCA
CCCTTAGT	GCCTTAGT
CCCGTTAC	CCCAGTTA
CCCGTTAG	CCCAGTTA
CCCGTTAT	CCCAGTTA
CCCGTTAN	CCCAGTTA
CCATTATT	CGATTATT
CCGTGTCG	CCCTGTCG
CCCGTTGA	CCGTTGAG
CCGGTAAA	ACCGGTAA
CCGGTAAC	ACCGGTAA
CCGTGTGA	CCGTTGAG
CCGGTAAG	ACCGGTAA
CCGGTAAT	ACCGGTAA
CCGGTAAN	ACCGGTAA
CCCTTCAC	TCCTTCAC
CCCTTCCA	CCCATCCA
CCCTTCGA	CCCTGTCG
CCCANGTT	CCCAGTTA
CCCTTCGC	CCCTGTCG
CCCTTCGG	CCCTGTCG
CCCTTCGT	CCCTGTCG
CCCTTCGN	CCCTGTCG
CCATTGAG	CCGTTGAG
CCCANTCC	CCCATCCA
CCGTTAAG	CCGTTGAG
CCCTTGAG	CCGTTGAG
CCCANTTA	CCCAGTTA
CCCTTGGA	ACCCTTGG
CCGTTAGA	CCGTTGAG
CCGTTAGC	CCGTTGAG
CCCTTGGC	ACCCTTGG
CCGTTAGG	CCGTTGAG
CCCTTGGG	ACCCTTGG
CCGTTAGT	CCGTTGAG
CCCTTGGT	ACCCTTGG
CCCTTGGN	ACCCTTGG
CCCTTGTC	CCCTGTCG
CCGTTAGN	CCGTTGAG
CCCTTTCG	CCCTGTCG
CCGTTCAG	CCGTTGAG
CCGTTCGA	CCGTTGAG
CCTCAAGA	CCTGCAAG
CCCCAAAA	CCCCTAAA
CCTCAAGC	CCTGCAAG
CCCCAAAC	CCCCTAAA
CCTCAAGG	CCTGCAAG
CCCCAAAG	CCCCTAAA
CCTCAAGT	CCTGCAAG
CCCCAAAT	CCCCTAAA
CCTCAAGN	CCTGCAAG
CCCCAAAN	CCCCTAAA
CCTCAATT	CCTCGATT
CCCCAACT	CCCCACTG
CCGTTGAA	CCGTTGAG
CCGTTGAC	CCGTTGAG
CCCCAATG	CCCCACTG
CCTCACTG	CCCCACTG
CCGTTGAG	CCGTTGAG
CCGTTGAT	CCGTTGAG
CCGGTGAG	CCGTTGAG
CCGTTGAN	CCGTTGAG
CCGTTGCA	CCGTTGAG
CCTCAGAT	CCTCGATT
CCCCACAG	CCCCACTG
CCCCACAT	CCCCACTG
CCGGTGGT	CGGTGGTT
CCGTTGCG	CCGTTGAG
CCCCACCG	CCCCACTG
CCCCACCT	CCCCACTG
CCCCACGA	CCCCACTG
CCCCACGC	CCCCACTG
CCCCACGG	CCCCACTG
CCCCACGT	CCCCACTG
CCCCACGN	CCCCACTG
CCCCACTA	CCCCACTG
CCCCACTC	CCCCACTG
CCCCACTG	CCCCACTG
CCGTTGGA	CCGTTGAG
CCCCACTT	CCCCACTG
CCCCACTN	CCCCACTG
CCTCAGTT	CCCAGTTA
CCGTTGGC	CCGTTGAG
CCCTAAAA	CCCCTAAA
CCGTTGGG	CCGTTGAG
CCCTAAAC	CCCCTAAA
CCCTAAAG	CCCCTAAA
CCCTAAAT	CCCCTAAA
CCCCACNG	CCCCACTG
CCCTAAAN	CCCCTAAA
CCCCACNT	CCCCACTG
CCGTTGGT	CCGTTGAG
CCGTTGGN	CCGTTGAG
CCTCATCC	CCCATCCA
CCGTTGTA	CCGTTGAG
CCCCAGCT	CCCCACTG
CCGTTGTG	CCGTTGAG
CCTCATTA	CCTCGATT
CCTCATTC	CCTCGATT
CCTCATTG	CCTCGATT
CCTCATTT	CCTCGATT
CCGTTGNA	CCGTTGAG
CCTCATTN	CCTCGATT
CCCCAGTG	CCCCACTG
CCCCAGTT	CCCAGTTA
CCGTTGNG	CCGTTGAG
CCGTTTAG	CCGTTGAG
CCCCATAA	CCCCTAAA
CCCTACTG	CCCCACTG
CCCTNGTC	CCCTGTCG
CCCCATCC	CCCATCCA
CCCCATCT	CCCCACTG
CCCCATGA	CCCCACTG
CCCCATGC	CCCCACTG
CCCCATGG	CCCCACTG
CCCCATGT	CCCCACTG
CCCCATGN	CCCCACTG
CCGTTTGA	CCGTTGAG
CCCCATTG	CCCCACTG
CCCTNTCG	CCCTGTCG
CCTCCAAG	CCTGCAAG
CCGGTTGA	CCGTTGAG
CCGTTNAG	CCGTTGAG
CCTCCACT	CCCCACTG
CCCTAGTC	CCCTGTCG
CCCTAGTT	CCCAGTTA
CCGTTNGA	CCGTTGAG
CCCTATCC	CCCATCCA
CCCTATCG	CCCTGTCG
CCCCANCT	CCCCACTG
CCTCCATT	CCTCGATT
CCCCANTG	CCCCACTG
CCCCCAAA	CCCCTAAA
CCTCCGAG	CATCCGAG
CCTCCGAT	CCTCGATT
CCCCCACT	CCCCACTG
CCCTCACT	CCCCACTG
CCCNACTG	CCCCACTG
CCTCCGGG	TCTCCGGG
CCGTNGAG	CCGTTGAG
CCCTCCAA	CCCATCCA
CCCTCCAC	CCCATCCA
CCCTCCAG	CCCATCCA
CCCTCCAT	CCCATCCA
CCCTCCAN	CCCATCCA
CCTCCTAA	CCCCTAAA
CCCNAGTT	CCCAGTTA
CCCCCCTG	CCCCACTG
CCCNATCC	CCCATCCA
CCCTCGAT	CCTCGATT
CCCTCGTC	CCCTGTCG
CCCCCTAA	CCCCTAAA
CCGAAATG	CCAAATGG
CCCTCTAA	CCCCTAAA
CCCCCTGA	CCCCACTG
CCCCCTGC	CCCCACTG
CCCCCTGG	CCCCACTG
CCCCCTGT	CCCCACTG
CCCCCTGN	CCCCACTG
CCCTCTCG	CCCTGTCG
CCCCCTTT	GCCCCTTT
CCGTNTGA	CCGTTGAG
CCCNCACT	CCCCACTG
CCCCGAAA	CCCCTAAA
CCCCGACT	CCCCACTG
CGAGTATT	CGATTATT
CCCCGATT	CCTCGATT
CCGAATGG	CCAAATGG
CCCCGCTG	CCCCACTG
CCCNCTAA	CCCCTAAA
CCCCGTAA	CCCCTAAA
CCCCGTCG	CCCTGTCG
CCCCGTTA	CCCAGTTA
CGAGTGGT	CGGTGGTT
CGAGTGTT	GAGTGTTC
CCANAATG	CCAAATGG
CCGACCCG	CGACCCGG
CGAGTTAT	CGATTATT
CCCCTAAA	CCCCTAAA
CCCCTAAC	CCCCTAAA
CCCCTAAG	CCCCTAAA
CCCCTAAT	CCCCTAAA
CCCCTAAN	CCCCTAAA
CCCCTACA	CCCCTAAA
CCCCTACT	CCCCACTG
CCCCTAGA	CCCCTAAA
CCCNGTCG	CCCTGTCG
CCGTAGAG	CCGTTGAG
CCCNGTTA	CCCAGTTA
CCGTAGGT	GCGTAGGT
CCCNTAAA	CCCCTAAA
CCCCTATA	CCCCTAAA
CCANATGG	CCAAATGG
CCCCTANA	CCCCTAAA
CCGTATAC	CGTATACG
CCCCTCAA	CCCCTAAA
CCCCTCCA	CCCATCCA
CCCNTCCA	CCCATCCA
CCCNTGTC	CCCTGTCG
CCCCTCTG	CCCCACTG
CCGTATGA	CCGTTGAG
CCCCTGAA	CCCCTAAA
CCCCTGTC	CCCTGTCG
CCCCTTAA	CCCCTAAA
CCCCTTGG	ACCCTTGG
CCCCTTTA	GCCCCTTT
CCCCTTTC	GCCCCTTT
CCCCTTTG	GCCCCTTT
CCCCTTTT	GCCCCTTT
CCCCTTTN	GCCCCTTT
CCCCTNAA	CCCCTAAA
CCGAGAGT	ACGAGAGT
CCNAAATG	CCAAATGG
CCTTAATG	CTTAATGC
CCTTACCA	CTTACCAA
CCNAATGG	CCAAATGG
CCTTAGTA	GCCTTAGT
CCTTAGTC	GCCTTAGT
CCTTAGTG	GCCTTAGT
CCTTAGTT	GCCTTAGT
CCTTAGTN	GCCTTAGT
CCGAGTTA	CCCAGTTA
CGATAATT	CGATTATT
CCNCCACT	CCCCACTG
CGATACGA	CGTATACG
CGATACGC	CGTATACG
CGATACGG	CGTATACG
CGATACGT	CGTATACG
CGATACGN	CGTATACG
CCGATCCA	CCCATCCA
CCTTCAAG	CCTGCAAG
CCTTCACA	TCCTTCAC
CCTTCACC	TCCTTCAC
CCTTCACG	TCCTTCAC
CCTTCACT	TCCTTCAC
CCTTCACN	TCCTTCAC
CGATATAC	CGTATACG
CGATATAT	CGATTATT
CCNCCTAA	CCCCTAAA
CGATATTA	CGATTATT
CGATATTC	CGATTATT
CGATATTG	CGATTATT
CGATATTT	CGATTATT
CGATATTN	CGATTATT
CCGATGAG	CCGTTGAG
CCTTCGAT	CCTCGATT
CCGATTAT	CGATTATT
CCGATTCC	CGGATTCC
CCGATTGA	CCGTTGAG
CCNCGATT	CCTCGATT
CCTTCTCT	CTTCTCTA
CGATCATT	CGATTATT
CGATCCCG	CGACCCGG
CGATCCCT	TGATCCCT
CGATCCGA	CATCCGAG
CGATCCGG	CGACCCGG
CCNCTAAA	CCCCTAAA
CCTTGAGA	CCGTTGAG
CCTTGAGC	CCGTTGAG
CCTTGAGG	CCGTTGAG
CCTTGAGT	CCGTTGAG
CCTTGAGN	CCGTTGAG
CCTTGATT	CCTCGATT
CCTTGCAA	CCTGCAAG
CCNCTGTC	CCCTGTCG
CGATCGAT	GATCGATA
CCNAGTTA	CCCAGTTA
CCTTGGAG	TCTTGGAG
CCGNTGAG	CCGTTGAG
CGAAAGCC	CAAAGCCA
CCCAAATG	CCAAATGG
CCCAACCA	CCCATCCA
CCCAACGA	TCCAACGA
CCTTGTCG	CCCTGTCG
CCCAACTG	CCCCACTG
CGAAATGG	CCAAATGG
CCGCAAGA	CCTGCAAG
CCGCAAGC	CCTGCAAG
CCGCAAGG	CCTGCAAG
CCGCAAGT	CCTGCAAG
CCGCAAGN	CCTGCAAG
CGATCTAT	CGATTATT
CCCAAGTT	CCCAGTTA
CCTTTAAA	GCTTTAAA
CCCAATCC	CCCATCCA
CCGNTTGA	CCGTTGAG
CCCAATGG	CCAAATGG
CCCAATTA	CCCAGTTA
CCNATCCA	CCCATCCA
CCGCACTG	CCCCACTG
CGAACCCG	CGACCCGG
CGAACCGG	CGACCCGG
CCTCGAAT	CCTCGATT
CCTCGACT	CCTCGATT
CCTCGAGT	CCTCGATT
CCTCGATA	CCTCGATT
CCTCGATC	CCTCGATT
CCTCGATG	CCTCGATT
CCTCGATT	CCTCGATT
CCTCGATN	CCTCGATT
CCTTTGAG	CCGTTGAG
CCTCGANT	CCTCGATT
CCTCGCAA	CCTGCAAG
CCGCAGTT	CCCAGTTA
CCTCGCAT	CCTCGATT
CCTCGCCC	GCTCGCCC
CCGCATCC	CCCATCCA
CCTCGCTT	CCTCGATT
CGATGATT	CGATTATT
CCTCGGAT	CCTCGATT
CGAACTGT	TGAACTGT
CCTCGGTT	CCTCGATT
CCTCGTAT	CCTCGATT
CCTCGTTA	CCTCGATT
CCTCGTTC	CCTCGATT
CCTCGTTG	CCTCGATT
CCTCGTTT	CCTCGATT
CCTCGTTN	CCTCGATT
CGAAGAAC	CTAAGAAC
CCTCGNAT	CCTCGATT
CCTCGNTT	CCTCGATT
CCGCCACT	CCCCACTG
CCTCTAAA	CCCCTAAA
CGAAGCCA	CAAAGCCA
CGACACCG	CGACCCGG
CGACACGG	CGACCCGG
CCTCTATT	CCTCGATT
CGATGGTT	CGGTGGTT
CGATGTAT	CGATTATT
CCTCTCTA	CTTCTCTA
CCNGCAAG	CCTGCAAG
CCTCTGAT	CCTCGATT
CCGCCTAA	CCCCTAAA
CGAATACG	CGTATACG
CCTCTGTC	CCCTGTCG
CGAATATT	CGATTATT
CGAATCCT	GAATCCTC
CGATTAAT	CGATTATT
CGATTACT	CGATTATT
CGATTAGT	CGATTATT
CGATTATA	CGATTATT
CGATTATC	CGATTATT
CGATTATG	CGATTATT
CGATTATT	CGATTATT
CGATTATN	CGATTATT
CGATTANT	CGATTATT
CGATTCAT	CGATTATT
CGATTCCA	CGGATTCC
CGATTCCC	CGGATTCC
CGATTCCG	CGGATTCC
CGATTCCT	CGGATTCC
CGATTCCN	CGGATTCC
CGATTCTT	CGATTATT
CGAATTAT	CGATTATT
CGAATTCC	CGGATTCC
CGATTGAT	CGATTATT
CCGCGATT	CCTCGATT
CGATTGTT	CGATTATT
CGATTTAT	CGATTATT
CCTCNATT	CCTCGATT
CGATTTTA	CGATTATT
CGATTTTC	CGATTATT
CGATTTTG	CGATTATT
CGATTTTT	CGATTATT
CGATTTTN	CGATTATT
CGACCACG	CGACCCGG
CGACCAGG	CGACCCGG
CGATTNAT	CGATTATT
CGACCCAG	CGACCCGG
CCGCGGAA	CGCGGAAG
CGACCCCG	CGACCCGG
CGATTNTT	CGATTATT
CGACCCGA	CGACCCGG
CGACCCGC	CGACCCGG
CGACCCGG	CGACCCGG
CGACCCGT	CGACCCGG
CGACCCGN	CGACCCGG
CCNCACTG	CCCCACTG
CGACCCTG	CGACCCGG
CCTCNGAT	CCTCGATT
CGACCCNG	CGACCCGG
CCNCAGTT	CCCAGTTA
CGATNATT	CGATTATT
CCNCATCC	CCCATCCA
CGACCGCG	CGACCCGG
CGACCGGA	CGACCCGG
CGACCGGC	CGACCCGG
CGACCGGG	CGACCCGG
CGGGCCAA	AGGGCCAA
CCTNCAAG	CCTGCAAG
CGACCGGT	CGACCCGG
CGCGGAAA	CGCGGAAG
CGCGGAAC	CGCGGAAG
CGCGGAAG	CGCGGAAG
CGCGGAAT	CGCGGAAG
CGCGGAAN	CGCGGAAG
CGCGGACA	CGCGGAAG
CGCGGACG	CGCGGAAG
CGCGGACT	TGCGGACT
CGCGGAGA	CGCGGAAG
CGCGGAGC	CGCGGAAG
CGCGGAGG	CGCGGAAG
CGCGGAGT	CGCGGAAG
CGACCGGN	CGACCCGG
CGCGGAGN	CGCGGAAG
CGCGGATA	CGCGGAAG
CGCGGATG	CGCGGAAG
CGCGGANA	CGCGGAAG
CGCGGANG	CGCGGAAG
CGCGGCAA	CGCGGAAG
CGCGGCAG	CGCGGAAG
CGCGGCAT	CACGGCAT
CCTGAAAG	CCTGCAAG
CGACCTCG	CGACCCGG
CCTGAAGA	CCTGCAAG
CCTGAAGC	CCTGCAAG
CCTGAAGG	CCTGCAAG
CCTGAAGT	CCTGCAAG
CCTGAAGN	CCTGCAAG
CGACCTGG	CGACCCGG
CCTGACAA	CCTGCAAG
CCTNCGAT	CCTCGATT
CGCGGGAA	CGCGGAAG
CGATNTAT	CGATTATT
CGCGGGAG	CGCGGAAG
CGACCNCG	CGACCCGG
CGCGGTAA	CGCGGAAG
CGCGGTAG	CGCGGAAG
CGACCNGG	CGACCCGG
CGGGGAAG	CGCGGAAG
CCNGTTGA	CCGTTGAG
CGGGGATC	CTGGGATC
CGCGGNAA	CGCGGAAG
CGCGGNAG	CGCGGAAG
CCTNGATT	CCTCGATT
CCTNGCAA	CCTGCAAG
CGCGTAAG	CGCGGAAG
CGCGTAGG	GCGTAGGT
CCTGATTA	CCTCGATT
CCTGATTC	CCTCGATT
CCTGATTG	CCTCGATT
CCTGATTT	CCTCGATT
CCTGATTN	CCTCGATT
CGGGGGTT	CGGTGGTT
CGACGCCG	CGACCCGG
CGCGTGAA	CGCGGAAG
CCTGCAAA	CCTGCAAG
CCTGCAAC	CCTGCAAG
CCTGCAAG	CCTGCAAG
CCTGCAAT	CCTGCAAG
CCTGCAAN	CCTGCAAG
CCTGCACA	CCTGCAAG
CCTGCACG	CCTGCAAG
CGACGCGG	CGACCCGG
CCTGCAGA	CCTGCAAG
CGGGGTTA	CGGTGGTT
CCTGCAGC	CCTGCAAG
CGGGGTTC	CGGTGGTT
CCTGCAGG	CCTGCAAG
CGGGGTTG	CGGTGGTT
CGGGGTTT	CGGTGGTT
CGGGGTTN	CGGTGGTT
CCTGCAGT	CCTGCAAG
CCTGCAGN	CCTGCAAG
CCTGCATA	CCTGCAAG
CCTGCATG	CCTGCAAG
CCTGCANA	CCTGCAAG
CGACGGAA	CGCGGAAG
CCTGCANG	CCTGCAAG
CGCGTGGT	CGGTGGTT
CGACGGCA	CACGGCAT
CCTGCCAA	CCTGCAAG
CCTGCCAG	CCTGCAAG
CCTGCGAA	CCTGCAAG
CCTGCGAG	CCTGCAAG
CCTGCGAT	CCTCGATT
CGCGTTGA	CCGTTGAG
CCTGCTAA	CCTGCAAG
CCTGCTAG	CCTGCAAG
CGCGTTTC	AGCGTTTC
CCTGCNAA	CCTGCAAG
CCTGCNAG	CCTGCAAG
CCTGGAAG	CCTGCAAG
CGCGNAAG	CGCGGAAG
CCTGGATT	CCTCGATT
CCTGGCAA	CCTGCAAG
CCTGGGAT	CTGGGATC
CGTAGACG	CGTATACG
CGGGTCGG	AGGGTCGG
CGCGNGAA	CGCGGAAG
CGTAGCAT	CTAGCATT
CGACTAAC	GACTAACT
CGTAGCTC	CTAGCTCG
CGGGTGGT	CGGTGGTT
CGACTACT	GACTACTA
CGACTATT	CGATTATT
CGTAGGCC	CTAGGCCC
CGGGTTCC	CGGATTCC
CCTGTAAG	CCTGCAAG
CGTAGGTA	GCGTAGGT
CGTAGGTC	GCGTAGGT
CGTAGGTG	GCGTAGGT
CGTAGGTT	GCGTAGGT
CGACTCCG	CGACCCGG
CGTAGGTN	GCGTAGGT
CGTAGTAC	CGTATACG
CGACTCGG	CGACCCGG
CCNTCGAT	CCTCGATT
CCTGTCAA	CCTGCAAG
CCTGTCGA	CCCTGTCG
CCTGTCGC	CCCTGTCG
CCTGTCGG	CCCTGTCG
CCTGTCGT	CCCTGTCG
CCTGTCGN	CCCTGTCG
CGTATAAC	CGTATACG
CGTATAAG	CGTATACG
CGACTTAT	CGATTATT
CGTATACA	CGTATACG
CGTATACC	CGTATACG
CCTGTTGA	CCGTTGAG
CGTATACG	CGTATACG
CGTATACT	CGTATACG
CGTATACN	CGTATACG
CGTATAGA	CGTATACG
CGTATAGC	CGTATACG
CGTATAGG	CGTATACG
CGTATAGT	CGTATACG
CGTATAGN	CGTATACG
CGTATATC	CGTATACG
CGTATATG	CGTATACG
CGTATANC	CGTATACG
CGTATANG	CGTATACG
CGTATCAC	CGTATACG
CGCCACTG	CCCCACTG
CCTGNAAG	CCTGCAAG
CGTATCCG	CGTATACG
CGTATCGA	CGTATACG
CGTATCGC	CGTATACG
CGTATCGG	CGTATACG
CCTGNCAA	CCTGCAAG
CGTATCGT	CGTATACG
CGTATCGN	CGTATACG
CGCCAGTT	CCCAGTTA
CGTATGAC	CGTATACG
CGCCATCC	CCCATCCA
CGTATGCG	CGTATACG
CGCTATAC	CGTATACG
CGTATTAC	CGTATACG
CGTATTAT	CGATTATT
CGTATTCC	CGGATTCC
CGTATTCG	CGTATACG
CCNTGCAA	CCTGCAAG
CGTATNAC	CGTATACG
CGTATNCG	CGTATACG
CGCTCAGA	CAGCTCAG
CGCTCAGC	CAGCTCAG
CGCTCAGG	CAGCTCAG
CGCTCAGT	CAGCTCAG
CGCTCAGN	CAGCTCAG
CGCCCACT	CCCCACTG
CGCTCCTA	ACGCTCCT
CGCTCCTC	ACGCTCCT
CGCTCCTG	ACGCTCCT
CGCTCCTT	ACGCTCCT
CGCTCCTN	ACGCTCCT
CGTANACG	CGTATACG
CGCTCGAT	CCTCGATT
CGCTCGCC	GCTCGCCC
CGACNCCG	CGACCCGG
CGCCCCGG	CGACCCGG
CGCCCCTT	GCCCCTTT
CGANCCCG	CGACCCGG
CGACNCGG	CGACCCGG
CGANCCGG	CGACCCGG
CGCNGAAG	CGCGGAAG
CGCCCGGA	CGACCCGG
CGCCCGGC	CGACCCGG
CGCCCGGG	CGACCCGG
CGCCCGGT	CGACCCGG
CGCCCGGN	CGACCCGG
CCNTGTCG	CCCTGTCG
CGGTAGGT	CGGTGGTT
CGTANTAC	CGTATACG
CGGTAGTT	CGGTGGTT
CGCCCTAA	CCCCTAAA
CGCTGAAG	CGCGGAAG
CGGTATAC	CGTATACG
CGCNGGAA	CGCGGAAG
CGGTATTC	CGGATTCC
CGTCAAGC	GTCAAGCC
CGAGAAGG	GAGAAGGG
CGCCGAAG	CGCGGAAG
CGCTGCAA	CCTGCAAG
CGTCATAC	CGTATACG
CCNTTGAG	CCGTTGAG
CGAGAGCC	GAGAGCCG
CGAGAGTA	ACGAGAGT
CGAGAGTC	ACGAGAGT
CGAGAGTG	ACGAGAGT
CGAGAGTT	ACGAGAGT
CGAGAGTN	ACGAGAGT
CGCCGGAA	CGCGGAAG
CGCTGGAA	CGCGGAAG
CGCCGGGT	GCCGGGTC
CGAGATTC	CGGATTCC
CGGTCGGT	CGGTGGTT
CGGTCGTT	CGGTGGTT
CGTCCCGG	CGACCCGG
CGCTGGTT	CGGTGGTT
CGAGCATT	CTAGCATT
CGAGCCCG	CGACCCGG
CGTCCGAG	CATCCGAG
CGAGCCGG	CGACCCGG
CGCCTAAA	CCCCTAAA
CGCTGTCG	CCCTGTCG
CGAGCTCA	CAGCTCAG
CGAGCTCG	CTAGCTCG
CGGTGAGT	CGGTGGTT
CGGTGATT	CGGTGGTT
CGGTGCGT	CGGTGGTT
CGGTGCTT	CGGTGGTT
CGGTGGAT	CGGTGGTT
CGGTGGCT	CGGTGGTT
CGCTTATT	CGATTATT
CGAGGAAG	CGCGGAAG
CGGTGGGT	CGGTGGTT
CGGTGGTA	CGGTGGTT
CGGTGGTC	CGGTGGTT
CGGTGGTG	CGGTGGTT
CGGTGGTT	CGGTGGTT
CGGTGGTN	CGGTGGTT
CGGTGGNT	CGGTGGTT
CGGTGTGT	CGGTGGTT
CGGTGTTA	CGGTGGTT
CGCCTGTC	CCCTGTCG
CGGTGTTC	CGGTGGTT
CGGTGTTG	CGGTGGTT
CGGTGTTT	CGGTGGTT
CGGTGTTN	CGGTGGTT
CGCTTTAA	GCTTTAAA
CGAGGCCC	CTAGGCCC
CGCCTTAG	GCCTTAGT
CGGTGNGT	CGGTGGTT
CGGTGNTT	CGGTGGTT
CGTCGATT	CCTCGATT
CGGTTATT	CGATTATT
CGANTATT	CGATTATT
CGGTTCCA	CGGATTCC
CGGTTCCC	CGGATTCC
CGGTTCCG	CGGATTCC
CGGTTCCT	CGGATTCC
CGGTTCCN	CGGATTCC
CGGTTGAG	CCGTTGAG
CGGTTGGT	CGGTGGTT
CGTCGGAA	CGCGGAAG
CGGTTGTT	CGGTGGTT
CGGTTTCC	CGGATTCC
CGANTTAT	CGATTATT
CGGTNGGT	CGGTGGTT
CGGTNGTT	CGGTGGTT
CTAAAAAC	CTAAGAAC
CGCGAAAG	CGCGGAAG
CTAAAACA	CTAAGAAC
CTAAAACC	CTAAGAAC
CTAAAACG	CTAAGAAC
CTAAAACT	CTAAGAAC
CTAAAACN	CTAAGAAC
CGCGAAGA	CGCGGAAG
CGCGAAGC	CGCGGAAG
CGCGAAGG	CGCGGAAG
CGCGAAGT	CGCGGAAG
CGCGAAGN	CGCGGAAG
CGGAATCC	CGGATTCC
CGGAATTC	CGGATTCC
CGTCTACG	CGTATACG
CTAAAGAA	CTAAGAAC
CTAAAGCC	CAAAGCCA
CTAAAGGA	TAAAGGAT
CGCGAGAA	CGCGGAAG
CTAAATGC	CTTAATGC
CTAAATGG	CCAAATGG
CGTCTCTA	CTTCTCTA
CGCGATTC	CGGATTCC
CGNACCCG	CGACCCGG
CTAACAAC	CTAAGAAC
CGTCTGAC	TGTCTGAC
CGCGCAAG	CGCGGAAG
CGGNATTC	CGGATTCC
CGCAAAGT	GCAAAGTA
CGGACCCG	CGACCCGG
CGGATACC	CGGATTCC
CGGATACG	CGTATACG
CGCAAATG	CCAAATGG
CGGATATC	CGGATTCC
CTAACATT	CTAGCATT
CGCGCGAA	CGCGGAAG
CTAACCAA	CTTACCAA
CGGATCCA	CGGATTCC
CGGATCCC	CGGATTCC
CGGATCCG	CGGATTCC
CGGATCCT	CGGATTCC
CGGATCCN	CGGATTCC
CTAACCCC	TTAACCCC
CGGATCTC	CGGATTCC
CGGATGCC	CGGATTCC
CGGATGGT	CGGTGGTT
CGGATGTC	CGGATTCC
CGGATTAC	CGGATTCC
CTAACGAA	CTAAGAAC
CGGATTAT	CGATTATT
CGGATTCA	CGGATTCC
CGGATTCC	CGGATTCC
CGGATTCG	CGGATTCC
CGGATTCT	CGGATTCC
CGGATTCN	CGGATTCC
CGGATTGC	CGGATTCC
CGGATTTC	CGGATTCC
CGGATTNC	CGGATTCC
CGGACTCC	CGGATTCC
CGGATNCC	CGGATTCC
CGGACTTC	CGGATTCC
CGGATNTC	CGGATTCC
CGTTTACG	CGTATACG
CGTTTATT	CGATTATT
CTAACTCG	CTAGCTCG
CGTTTCCC	GTTTCCCG
CGTTTGCA	GTTTGCAT
CGGANTCC	CGGATTCC
CGGANTTC	CGGATTCC
CTAAGAAA	CTAAGAAC
CTAAGAAC	CTAAGAAC
CTAAGAAG	CTAAGAAC
CTAAGAAT	CTAAGAAC
CTAAGAAN	CTAAGAAC
CTAAGACA	CTAAGAAC
CTAAGACC	CTAAGAAC
CTAAGACG	CTAAGAAC
CGTTTTGA	TGTTTTGA
CTAAGACT	CTAAGAAC
CTAAGACN	CTAAGAAC
CTAAGAGA	CTAAGAAC
CTAAGAGC	CTAAGAAC
CTAAGATA	CTAAGAAC
CTAAGATC	CTAAGAAC
CTAAGANA	CTAAGAAC
CTAAGANC	CTAAGAAC
CTAAGCAA	CTAAGAAC
CTAAGCAC	CTAAGAAC
CTAAGCAT	CTAGCATT
CTAAGCCA	CAAAGCCA
CTAAGCCC	CTAGGCCC
CGCACCCG	CGACCCGG
CTAAGCTC	CTAGCTCG
CGGAGGTT	CGGTGGTT
CTAAGGAA	CTAAGAAC
CTAAGGAC	CTAAGAAC
CTAAGGCC	CTAGGCCC
CGGAGTCC	CGGATTCC
CTATCATT	CTAGCATT
CGNATACG	CGTATACG
CTAAGTAA	CTAAGAAC
CTAAGTAC	CTAAGAAC
CGGNGGTT	CGGTGGTT
CGGAGTTC	CGGATTCC
CGCACTTC	GCACTTCT
CGGCATTC	CGGATTCC
CTATCCGA	CATCCGAG
CTAAGNAA	CTAAGAAC
CTAAGNAC	CTAAGAAC
CGCAGAAG	CGCGGAAG
CTATCTCG	CTAGCTCG
CTATCTCT	CTTCTCTA
CGNATTAT	CGATTATT
CGGCCCGG	CGACCCGG
CGNATTCC	CGGATTCC
CTAATAAC	CTAAGAAC
CGCAGGAA	CGCGGAAG
CTAATATA	TAATATAT
CTATGAAC	CTAAGAAC
CGCAGTTA	CCCAGTTA
CTATGCAT	CTAGCATT
CTATGCCC	CTAGGCCC
CGGNTGGT	CGGTGGTT
CTAATCGA	TAATCGAG
CTATGCTC	CTAGCTCG
CTATGGCC	CTAGGCCC
CGCATACG	CGTATACG
CGGCGCAT	TGGCGCAT
CGCATCCA	CCCATCCA
CGGNTTCC	CGGATTCC
CGGCGGAA	CGCGGAAG
CTAATGAA	CTAAGAAC
CTAATGCA	CTTAATGC
CTAATGCC	CTTAATGC
CGGCGGTT	CGGTGGTT
CTAATGCG	CTTAATGC
CTAATGCT	CTTAATGC
CTAATGCN	CTTAATGC
CTATTATT	CGATTATT
CGCATTAT	CGATTATT
CGCATTCC	CGGATTCC
CGGCTCAG	CAGCTCAG
CTATTTCC	ATATTTCC
CGTNATAC	CGTATACG
CTAANAAC	CTAAGAAC
CGNGATTC	CGGATTCC
CGGCTGGT	CGGTGGTT
CGGCTTCC	CGGATTCC
CGTGATAC	CGTATACG
CGTAAACG	CGTATACG
CGTGATTC	CGGATTCC
CTAANGAA	CTAAGAAC
CGTAACGA	CGTATACG
CGTAACGC	CGTATACG
CGTAACGG	CGTATACG
CGTAACGT	CGTATACG
CGTAACGN	CGTATACG
CGTAAGAA	CTAAGAAC
CGTGCAAG	CCTGCAAG
CGTAATAC	CGTATACG
CGTAATGC	CTTAATGC
CGNGGAAG	CGCGGAAG
CGTACACG	CGTATACG
CGTACCAA	CTTACCAA
CGTNTACG	CGTATACG
CGTACCCG	CGACCCGG
CGTACCCT	GTACCCTG
CGTACGGA	GTACGGAT
CGGGAAGA	CGCGGAAG
CTANAGAA	CTAAGAAC
CGGGAAGC	CGCGGAAG
CGGGAAGG	CGCGGAAG
CGTACTAC	CGTATACG
CGGGAAGT	CGCGGAAG
CGGGAAGN	CGCGGAAG
CGNCCCGG	CGACCCGG
CGTGGAAG	CGCGGAAG
CGTGGACA	GTGGACAA
CTACAGAA	CTAAGAAC
CTACATTA	CTAGCATT
CTACATTC	CTAGCATT
CTACATTG	CTAGCATT
CTACATTT	CTAGCATT
CTACATTN	CTAGCATT
CGGGATCA	CTGGGATC
CGGGATCC	CTGGGATC
CGTGGGAT	CTGGGATC
CGGGATCG	CTGGGATC
CGGGATCT	CTGGGATC
CGGGATCN	CTGGGATC
CGGGATTC	CGGATTCC
CGTGGGGT	TGTGGGGT
CTANCATT	CTAGCATT
CTACCAAA	CTTACCAA
CTACCAAC	CTTACCAA
CTACCAAG	CTTACCAA
CGTGGTTA	CGGTGGTT
CTACCAAT	CTTACCAA
CGTGGTTC	CGGTGGTT
CTACCAAN	CTTACCAA
CGTGGTTG	CGGTGGTT
CGTGGTTT	CGGTGGTT
CTACCACC	TACCACCA
CGTGGTTN	CGGTGGTT
CTACCATT	CTAGCATT
CGNGTGGT	CGGTGGTT
CTACCCGG	CGACCCGG
CGTGTACG	CGTATACG
CTACCCTG	GTACCCTG
CGNCGGAA	CGCGGAAG
CTACTCGA	CTAGCTCG
CTACTCGC	CTAGCTCG
CTACTCGG	CTAGCTCG
CTACTCGT	CTAGCTCG
CGNTGGTT	CGGTGGTT
CTACTCGN	CTAGCTCG
CTACTCTA	CTTCTCTA
CTACCTCG	CTAGCTCG
CTANCTCG	CTAGCTCG
CGTGTGGT	CGGTGGTT
CTACGAAC	CTAAGAAC
CGNTTATT	CGATTATT
CTACGCAT	CTAGCATT
CTACGCCC	CTAGGCCC
CTACGCTC	CTAGCTCG
CTANGAAC	CTAAGAAC
CTACGGAT	GTACGGAT
CTACGGCA	CACGGCAT
CTACGGCC	CTAGGCCC
CTANGCAT	CTAGCATT
CTANGCCC	CTAGGCCC
CTANGCTC	CTAGCTCG
CGTTAATG	CTTAATGC
CTAGAACA	CTAAGAAC
CTAGAACC	CTAAGAAC
CTAGAACG	CTAAGAAC
CTAGAACT	CTAAGAAC
CTAGAACN	CTAAGAAC
CGTTACCA	CTTACCAA
CTAGAATT	CTAGCATT
CGTTACGA	CGTATACG
CGTTACGC	CGTATACG
CTANGGCC	CTAGGCCC
CGTTACGG	CGTATACG
CGTTACGT	CGTATACG
CGTTACGN	CGTATACG
CTAGACAT	CTAGCATT
CTAGACCC	CTAGGCCC
CTGGNATC	CTGGGATC
CTAGACTC	CTAGCTCG
CTAGAGAA	CTAAGAAC
CTAGAGCC	CTAGGCCC
CGTTATAC	CGTATACG
CGTTATTA	CGATTATT
CGTTATTC	CGATTATT
CGTTATTG	CGATTATT
CGTTATTT	CGATTATT
CTGGNGAT	CTGGGATC
CGTTATTN	CGATTATT
CTAGATCG	CTAGCTCG
CTAGATTA	CTAGCATT
CTAGATTC	CTAGCATT
CTAGATTG	CTAGCATT
CTAGATTT	CTAGCATT
CTAGATTN	CTAGCATT
CGNTATAC	CGTATACG
CTAGCAAT	CTAGCATT
CTAGCACG	CTAGCTCG
CTAGCACT	CTAGCATT
CTAGCAGT	CTAGCATT
CTAGCATA	CTAGCATT
CTAGCATG	CTAGCATT
CTAGCATT	CTAGCATT
CTAGCATN	CTAGCATT
CTAGCANT	CTAGCATT
CTCTAATG	CTTAATGC
CTAGCCAT	CTAGCATT
CTAGCCCA	CTAGGCCC
CTAGCCCC	CTAGGCCC
CTAGCCCT	CTAGGCCC
CTAGCCCN	CTAGGCCC
CTAGCCGA	CTAGCTCG
CTAGCCGC	CTAGCTCG
CTAGCCGG	CTAGCTCG
CTAGCCGT	CTAGCTCG
CTAGCCGN	CTAGCTCG
CTAGCCTC	CTAGCTCG
CTAGCCTT	CTAGCATT
CTCTACAT	TTCTACAT
CTCTACCA	CTTACCAA
CTGTAAGC	TTGTAAGC
CTAGCGAT	CTAGCATT
CTAGCGCC	CTAGGCCC
CTGTAATG	CTTAATGC
CTGTACCA	CTTACCAA
CTAGCGCG	CTAGCTCG
CTAGCGTA	TAGCGTAA
CTAGCGTC	CTAGCTCG
CTAGCGTT	CTAGCATT
CTAGCTAC	CTAGCTCG
CTAGCTAG	CTAGCTCG
CTAGCTAT	CTAGCATT
CTAGCTCC	CTAGCTCG
CTAGCTCG	CTAGCTCG
CTAGCTCT	CTAGCTCG
CTAGCTCN	CTAGCTCG
CGTTCTCT	CTTCTCTA
CTAGCTGA	CTAGCTCG
CTAGCTGC	CTAGCTCG
CTAGCTGG	CTAGCTCG
CTAGCTGT	CTAGCTCG
CTAGCTGN	CTAGCTCG
CTAGCTTA	CTAGCATT
CTAGCTTT	CTAGCATT
CTGTATAC	CGTATACG
CTAGCTTN	CTAGCATT
CTAGCTNC	CTAGCTCG
CTAGCTNG	CTAGCTCG
CTAGCNAT	CTAGCATT
CTAGCNCG	CTAGCTCG
CTAGCNTC	CTAGCTCG
CTAGCNTT	CTAGCATT
CGTTGAGA	CCGTTGAG
CGTTGAGC	CCGTTGAG
CGTTGAGG	CCGTTGAG
CGTTGAGT	CCGTTGAG
CGTTGAGN	CCGTTGAG
CTAGGAAC	CTAAGAAC
CTTCAAGG	ATTCAAGG
CTAGGACC	CTAGGCCC
CTCCGAGA	CATCCGAG
CTCCGAGC	CATCCGAG
CTCCGAGG	CATCCGAG
CTTCAATG	CTTAATGC
CTAGGATC	CTGGGATC
CTAGGATT	CTAGCATT
CTTCACCA	CTTACCAA
CTCCGAGT	CATCCGAG
CTCCGAGN	CATCCGAG
CTAGGCAC	CTAGGCCC
CTTCACTA	CTTCTCTA
CTAGGCAT	CTAGCATT
CTAGGCCA	CTAGGCCC
CTAGGCCC	CTAGGCCC
CTAGGCCG	CTAGGCCC
CTAGGCCT	CTAGGCCC
CTAGGCCN	CTAGGCCC
CTAGGCGC	CTAGGCCC
CGTTGGTT	CGGTGGTT
CTAGGCNC	CTAGGCCC
CTCCGCTA	TCCGCTAG
CTAGGGAT	CTGGGATC
CTAGGGCC	CTAGGCCC
CTCTCCGG	TCTCCGGG
CTTCATCT	CTTCTCTA
CTTCATGC	CTTAATGC
CTAGGTCC	CTAGGCCC
CTAGGTCG	CTAGCTCG
CTCTCGAT	CCTCGATT
CTCCGGGA	TCTCCGGG
CTCCGGGC	TCTCCGGG
CTCCGGGG	TCTCCGGG
CTCCGGGT	TCTCCGGG
CTCCGGGN	TCTCCGGG
CTGTCGTA	ATGTCGTA
CTAGGNCC	CTAGGCCC
CTCTCTAA	CTTCTCTA
CTCTCTAC	CTTCTCTA
CTCTCTAG	CTTCTCTA
CTCTCTAT	CTTCTCTA
CTCTCTAN	CTTCTCTA
CTCTCTCT	CTTCTCTA
CTGTCTCT	CTTCTCTA
CTTCCAAA	CTTACCAA
CTGTCTGA	TGTCTGAC
CTTCCAAC	CTTACCAA
CTTCCAAG	CTTACCAA
CTTCCAAT	CTTACCAA
CTTCCAAN	CTTACCAA
CTTCCCAA	CTTACCAA
CTCTGACC	ATCTGACC
CTTCCCTA	CTTCTCTA
CTCTGCAA	CCTGCAAG
CTAGTATG	TAGTATGG
CTAGTATT	CTAGCATT
CTCCTAAA	CCCCTAAA
CTAGTCAT	CTAGCATT
CTGTGATC	CTGGGATC
CTTCCGAG	CATCCGAG
CTAGTCCC	CTAGGCCC
CTAGTCGA	CTAGCTCG
CTAGTCGC	CTAGCTCG
CTAGTCGG	CTAGCTCG
CTAGTCGT	CTAGCTCG
CTAGTCGN	CTAGCTCG
CTAGTCTC	CTAGCTCG
CTCCTCTA	CTTCTCTA
CTTCCTAA	CTTCTCTA
CTTCCTAC	CTTCTCTA
CTTCCTAG	CTTCTCTA
CTTCCTAT	CTTCTCTA
CTTCCTAN	CTTCTCTA
CTAGTGCC	CTAGGCCC
CTGTGGAT	CTGGGATC
CTGTGGGG	TGTGGGGT
CTTCCTCT	CTTCTCTA
CTTCCTGC	ATTCCTGC
CTGTGGTT	CGGTGGTT
CTCCTGTC	CCCTGTCG
CTAGTTCG	CTAGCTCG
CTCCTTCA	TCCTTCAC
CTCTGTCG	CCCTGTCG
CTTCGATT	CCTCGATT
CTTCGCTA	CTTCTCTA
CTGTTGAG	CCGTTGAG
CTTCGGCA	TTCGGCAG
CTCAAATG	CCAAATGG
CTAGNATT	CTAGCATT
CTTCGTCT	CTTCTCTA
CTAGNCAT	CTAGCATT
CTAGNCCC	CTAGGCCC
CTCAAGAA	CTAAGAAC
CTCAAGCC	GTCAAGCC
CTAGNCTC	CTAGCTCG
CTGTTTTG	TGTTTTGA
CTTCTACA	TTCTACAT
CTTCTACT	CTTCTCTA
CTTCTATA	CTTCTCTA
CTTCTCAA	CTTCTCTA
CTTCTCAC	CTTCTCTA
CTTCTCAG	CTTCTCTA
CTTCTCAT	CTTCTCTA
CTTCTCAN	CTTCTCTA
CTTCTCCA	CTTCTCTA
CTAGNGCC	CTAGGCCC
CTTCTCCT	CTTCTCTA
CTTCTCGA	CTTCTCTA
CTTCTCGT	CTTCTCTA
CTTCTCTA	CTTCTCTA
CTTCTCTC	CTTCTCTA
CTTCTCTG	CTTCTCTA
CTTCTCTT	CTTCTCTA
CTTCTCTN	CTTCTCTA
CTTCTCNA	CTTCTCTA
CTTCTCNT	CTTCTCTA
CTTCTGCT	CTTCTCTA
CTCAATGC	CTTAATGC
CTGAACTG	TGAACTGT
CTTCTGTA	CTTCTCTA
CTTCTTAA	CTTCTCTA
CTTCTTAC	CTTCTCTA
CTTCTTAG	CTTCTCTA
CTTCTTAT	CTTCTCTA
CTAGNTCG	CTAGCTCG
CTGAAGAA	CTAAGAAC
CTTCTTAN	CTTCTCTA
CTTCTTCT	CTTCTCTA
CTTCTTTA	CTTCTCTA
CTCTTGGA	TCTTGGAG
CTCACCAA	CTTACCAA
CTTCTNCT	CTTCTCTA
CTTCTNTA	CTTCTCTA
CTGAATGC	CTTAATGC
CTTCNCTA	CTTCTCTA
CTATAACT	ATATAACT
CTCGATTA	CCTCGATT
CTCGATTC	CCTCGATT
CTCGATTG	CCTCGATT
CTCGATTT	CCTCGATT
CTCGATTN	CCTCGATT
CTATAATG	CTTAATGC
CTATACCA	CTTACCAA
CTTCNTCT	CTTCTCTA
CTATACGA	CGTATACG
CTATACGC	CGTATACG
CTATACGG	CGTATACG
CTATACGT	CGTATACG
CTATACGN	CGTATACG
CTATAGAA	CTAAGAAC
CTGACCAA	CTTACCAA
CTGACCCG	CGACCCGG
CTCGCATT	CTAGCATT
CTCGCCCA	GCTCGCCC
CTCGCCCC	GCTCGCCC
CTCGCCCG	GCTCGCCC
CTCGCCCT	GCTCGCCC
CTCGCCCN	GCTCGCCC
CTTGAATG	CTTAATGC
CTCGCTCG	CTAGCTCG
CTTGACCA	CTTACCAA
CTGNGATC	CTGGGATC
CTCAGAAA	TCAGAAAC
CTCAGAAC	CTAAGAAC
CTGNGGAT	CTGGGATC
CTTGAGTT	TTGAGTTA
CTGAGAAC	CTAAGAAC
CTTGATGC	CTTAATGC
CTCAGCAT	CTAGCATT
CTCGGAAG	CGCGGAAG
CTGAGATC	CTGGGATC
CTCAGCTC	CTAGCTCG
CTCAGGCC	CTAGGCCC
CTCAGGTC	TCAGGTCT
CTGAGCAT	CTAGCATT
CTCGGATC	CTGGGATC
CTCAGTTA	CCCAGTTA
CTGAGCTC	CTAGCTCG
CTTGCAAG	CCTGCAAG
CTCGGCAG	TTCGGCAG
CTTGCACG	TTGCACGA
CTCGGCAT	CACGGCAT
CTTGCATT	CTAGCATT
CTCGGCCC	CTAGGCCC
CTGAGGAT	CTGGGATC
CTGCGATC	CTGGGATC
CTTGCCAA	CTTACCAA
CTGAGGCC	CTAGGCCC
CTGCGGAA	CGCGGAAG
CTGCGGAC	TGCGGACT
CTGCGGAT	CTGGGATC
CTCGGGAT	CTGGGATC
CTCATCCA	CCCATCCA
CTTGCTCG	CTAGCTCG
CTTGCTCT	CTTCTCTA
CTGAGTTA	TTGAGTTA
CTTGGAGA	TCTTGGAG
CTTGGAGC	TCTTGGAG
CTTGGAGG	TCTTGGAG
CTTGGAGT	TCTTGGAG
CTTGGAGN	TCTTGGAG
CTTGGATC	CTGGGATC
CTTGGCCC	CTAGGCCC
CTTGGGAT	CTGGGATC
CTGCTCAG	CAGCTCAG
CTGATCCC	TGATCCCT
CTGCTCGA	CTAGCTCG
CTGCTCGC	CTAGCTCG
CTGCTCGG	CTAGCTCG
CTGCTCGT	CTAGCTCG
CTGCTCGN	CTAGCTCG
CTGCTCTA	CTTCTCTA
CTCGTTGA	CCGTTGAG
CTTAAAGC	CTTAATGC
CTTAAATG	CTTAATGC
CTTAACAA	CTTACCAA
CTTAACCA	CTTACCAA
CTGATTAT	CGATTATT
CTTAACCC	TTAACCCC
CTGATTCC	CGGATTCC
CTTAACGC	CTTAATGC
CTTAACTG	CTTAATGC
CTTAAGAA	CTAAGAAC
CTTAAGCA	CTTAATGC
CTTAAGCC	CTTAATGC
CTTAAGCG	CTTAATGC
CTTAAGCT	CTTAATGC
CTTAAGCN	CTTAATGC
CTTAAGGC	CTTAATGC
CTTAAGTG	CTTAATGC
CTTAATAC	CTTAATGC
CTTAATAG	CTTAATGC
CTTAATCA	CTTAATGC
CTTAATCC	CTTAATGC
CTTAATCG	CTTAATGC
CTTAATCT	CTTAATGC
CTTAATCN	CTTAATGC
CTTAATGA	CTTAATGC
CTTAATGC	CTTAATGC
CTTAATGG	CTTAATGC
CTTAATGT	CTTAATGC
CTTAATGN	CTTAATGC
CTTAATTC	CTTAATGC
CTTAATTG	CTTAATGC
CTTAATNC	CTTAATGC
CTTAATNG	CTTAATGC
CTTAANGC	CTTAATGC
CTTAANTG	CTTAATGC
CTCCAACG	TCCAACGA
CTTACAAA	CTTACCAA
CTTACAAC	CTTACCAA
CTTACAAG	CTTACCAA
CTTACAAT	CTTACCAA
CTTACAAN	CTTACCAA
CTTACACA	CTTACCAA
CTTACATG	CTTAATGC
CTGGAATC	CTGGGATC
CTGGACAA	GTGGACAA
CTTACCAA	CTTACCAA
CTTACCAC	CTTACCAA
CTTACCAG	CTTACCAA
CTCCACTG	CCCCACTG
CTTACCAT	CTTACCAA
CTTACCAN	CTTACCAA
CTTACCCA	CTTACCAA
CTTACCGA	CTTACCAA
CTGGAGAT	CTGGGATC
CTTACCTA	CTTACCAA
CTTACCNA	CTTACCAA
CTTACGAA	CTTACCAA
CTTACGCA	CTTACCAA
CTGGATCA	CTGGGATC
CTGGATCC	CTGGGATC
CTGGATCG	CTGGGATC
CTGGATCT	CTGGGATC
CTCCAGTT	CCCAGTTA
CTGGATCN	CTGGGATC
CTGGATTC	CGGATTCC
CTTACTAA	CTTACCAA
CTTACTCA	CTTACCAA
CTTNCCAA	CTTACCAA
CTTACTCT	CTTCTCTA
CTTACTGC	CTTAATGC
CTGGCATC	CTGGGATC
CTGGCATT	CTAGCATT
CTCCATCC	CCCATCCA
CTTACNAA	CTTACCAA
CTGGCCCA	CTAGGCCC
CTGGCCCC	CTAGGCCC
CTGGCCCG	CTAGGCCC
CTGGCCCT	CTAGGCCC
CTGGCCCN	CTAGGCCC
CTTACNCA	CTTACCAA
CTGGCGAT	CTGGGATC
CTGGCGCA	TGGCGCAT
CTGGCTCG	CTAGCTCG
CTTAGAAC	CTAAGAAC
CTTAGATG	CTTAATGC
CTGGGAAC	CTGGGATC
CTTAGCAA	CTTACCAA
CTGGGAAT	CTGGGATC
CTGGGACA	CTGGGATC
CTTAGCAT	CTAGCATT
CTTNCTCT	CTTCTCTA
CTGGGACC	CTGGGATC
CTTAGCCA	CTTACCAA
CTGGGACG	CTGGGATC
CTGGGACT	CTGGGATC
CTGGGACN	CTGGGATC
CTGGGAGC	CTGGGATC
CTGGGAGT	CTGGGATC
CTGGGATA	CTGGGATC
CTGGGATC	CTGGGATC
CTGGGATG	CTGGGATC
CTGGGATT	CTGGGATC
CTGGGATN	CTGGGATC
CTGGGANC	CTGGGATC
CTGGGANT	CTGGGATC
CTGGGCAT	CTGGGATC
CTGGGCCC	CTAGGCCC
CTGGGCTC	CTGGGATC
CTCCCACT	CCCCACTG
CTGCAAGA	CCTGCAAG
CTGGGGAT	CTGGGATC
CTGCAAGC	CCTGCAAG
CTTAGCTC	CTAGCTCG
CTGCAAGG	CCTGCAAG
CTGCAAGT	CCTGCAAG
CTGCAAGN	CCTGCAAG
CTGGGGTC	CTGGGATC
CTTAGGCC	CTAGGCCC
CTGGGTAT	CTGGGATC
CTGGGTCA	CTGGGATC
CTGGGTCC	CTGGGATC
CTGGGTCG	CTGGGATC
CTGCACGA	TTGCACGA
CTGGGTCT	CTGGGATC
CTGGGTCN	CTGGGATC
CTGGGTTC	CTGGGATC
CTTAGTGC	CTTAATGC
CTGGGNAT	CTGGGATC
CTGGGNTC	CTGGGATC
CTGCATTA	CTAGCATT
CTGCATTC	CTAGCATT
CTGCATTG	CTAGCATT
CTGCATTT	CTAGCATT
CTGCATTN	CTAGCATT
CTGGTATC	CTGGGATC
CTTATACG	CGTATACG
CTTATATG	CTTAATGC
CTCCCTAA	CCCCTAAA
CTTATCAA	CTTACCAA
CTTATCCA	CTTACCAA
CNACCCGG	CGACCCGG
CTTATCTA	CTTCTCTA
CTNGGATC	CTGGGATC
CTNGGCCC	CTAGGCCC
CTTATGCA	CTTAATGC
CTTATGCC	CTTAATGC
CTTATGCG	CTTAATGC
CTTATGCT	CTTAATGC
CTTATGCN	CTTAATGC
CTTGTAAG	TTGTAAGC
CTGGTGAT	CTGGGATC
CTNGGGAT	CTGGGATC
CTTATTGC	CTTAATGC
CTGGTGGT	CGGTGGTT
CTTGTCTA	CTTCTCTA
CTTANATG	CTTAATGC
CTTANCAA	CTTACCAA
CTTANCCA	CTTACCAA
CTTGTGGC	TTTGTGGC
CTTNTCTA	CTTCTCTA
CTTANTGC	CTTAATGC
CNACGGCA	CACGGCAT
CNAGCATT	CTAGCATT
CNAGCTCA	CAGCTCAG
CNAGCTCG	CTAGCTCG
CNAGGCCC	CTAGGCCC
CTTTAAAA	GCTTTAAA
CTTTAAAC	GCTTTAAA
CTTTAAAG	GCTTTAAA
CTTTAAAT	GCTTTAAA
CTTTAAAN	GCTTTAAA
CTTTAATG	CTTAATGC
CTNTAATG	CTTAATGC
CTTTACCA	CTTACCAA
CTNTACCA	CTTACCAA
CTTTATGC	CTTAATGC
CTNAAGAA	CTAAGAAC
CTNAATGC	CTTAATGC
CTNACCAA	CTTACCAA
CTTTCCAA	CTTACCAA
CTTTCCCG	GTTTCCCG
CTNTCTCT	CTTCTCTA
CTNCTCTA	CTTCTCTA
CTTTCTAA	CTTCTCTA
CTTTCTAC	CTTCTCTA
CTTTCTAG	CTTCTCTA
CTTTCTAT	CTTCTCTA
CTTTCTAN	CTTCTCTA
CTTTCTCT	CTTCTCTA
CTNAGAAC	CTAAGAAC
CNCAAATG	CCAAATGG
CTNAGCAT	CTAGCATT
CTNAGCTC	CTAGCTCG
CTTTGCAT	GTTTGCAT
CTNAGGCC	CTAGGCCC
CTTTGTGG	TTTGTGGC
CNAAAGCC	CAAAGCCA
CNAAATGG	CCAAATGG
CTTTTCTA	CTTCTCTA
CNATCCGA	CATCCGAG
CNGTGGTT	CGGTGGTT
CNGACCCG	CGACCCGG
CNTCTCTA	CTTCTCTA
CNGTTGAG	CCGTTGAG
CTNGCATT	CTAGCATT
CNAAGAAC	CTAAGAAC
CTNGCTCG	CTAGCTCG
CNAAGCCA	CAAAGCCA
CNATTATT	CGATTATT
CNGATTAT	CGATTATT
CNGATTCC	CGGATTCC
CNCGGAAG	CGCGGAAG
CTTNAATG	CTTAATGC
CNCGGCAT	CACGGCAT
CTTNACCA	CTTACCAA
CTTNATGC	CTTAATGC
CNTAAGAA	CTAAGAAC
CNCGTTGA	CCGTTGAG
CNTAATGC	CTTAATGC
CNTGCAAG	CCTGCAAG
CNTACCAA	CTTACCAA
CNCAGTTA	CCCAGTTA
CNGGATTC	CGGATTCC
CNCATCCA	CCCATCCA
CNGCGGAA	CGCGGAAG
CNGCTCAG	CAGCTCAG
CNTGGGAT	CTGGGATC
CNTAGCAT	CTAGCATT
CNGGGATC	CTGGGATC
CNTAGCTC	CTAGCTCG
CNTAGGCC	CTAGGCCC
CNCTCGAT	CCTCGATT
CNCCACTG	CCCCACTG
CNTATACG	CGTATACG
CNGGTGGT	CGGTGGTT
CNCCAGTT	CCCAGTTA
CNCCATCC	CCCATCCA
CNCTGCAA	CCTGCAAG
CNCCCACT	CCCCACTG
CNCTGTCG	CCCTGTCG
CNCCCTAA	CCCCTAAA
CNTTAATG	CTTAATGC
CNTTACCA	CTTACCAA
CNGTATAC	CGTATACG
CNCCTAAA	CCCCTAAA
CNCCTGTC	CCCTGTCG
GAACCCGC	AACCCGCG
GAACCCTC	GAATCCTC
GAACCCTG	GTACCCTG
GAACCTCA	GAATCCTC
GAACCTCC	GAATCCTC
GAACCTCG	GAATCCTC
GAACCTCT	GAATCCTC
GAACCTCN	GAATCCTC
CNTCCGAG	CATCCGAG
GAACCTTT	AAACCTTT
CNTCGATT	CCTCGATT
GAACGATA	GATCGATA
GAANTCCT	GAATCCTC
CNTTCTCT	CTTCTCTA
GAACGGAT	GTACGGAT
GAACTAAC	GACTAACT
GAACTACT	GACTACTA
GAAAAGGG	GAGAAGGG
GAAAAGTA	GCAAAGTA
GAACTCCT	GAATCCTC
GAACTGTA	TGAACTGT
GAACTGTC	TGAACTGT
GAACTGTG	TGAACTGT
GAATAACT	GACTAACT
GAACTGTT	TGAACTGT
GAACTGTN	TGAACTGT
GAACTTCT	GCACTTCT
GAACTTGT	AACTTGTA
GACAAACT	GACTAACT
GAATACCT	GAATCCTC
GAAACAAG	AAACAAGT
GAATACTA	GACTACTA
GACAAAGT	GCAAAGTA
GAATACTC	GAATCCTC
GACAACGC	ACAACGCG
GAATATAT	TAATATAT
GACAACTC	GACTAACT
GACAACTG	GACTAACT
GACAACTT	GACTAACT
GACAACTN	GACTAACT
GAAACCTC	GAATCCTC
GAAACCTT	AAACCTTT
GACAAGCC	GTCAAGCC
GACAAGGG	GAGAAGGG
GACAATTA	ACAATTAG
GAATCACT	GAATCCTC
GAATCATC	GAATCCTC
GAATCCAC	GAATCCTC
GAATCCAT	GAATCCTC
GAATCCCA	GAATCCTC
GAATCCCC	GAATCCTC
GAATCCCG	GAATCCTC
GAATCCCT	GAATCCTC
GAATCCCN	GAATCCTC
GAATCCGC	GAATCCTC
GAATCCGT	GAATCCTC
GAATCCTA	GAATCCTC
GAATCCTC	GAATCCTC
GAATCCTG	GAATCCTC
GAATCCTT	GAATCCTC
GAATCCTN	GAATCCTC
GAATCCNC	GAATCCTC
GAATCCNT	GAATCCTC
GAATCGAG	TAATCGAG
GAATCGAT	GATCGATA
GAATCGCT	GAATCCTC
GAATCGTC	GAATCCTC
GAAGAAAT	AAGAAATC
GAAGAAGG	GAGAAGGG
GAATCTCA	GAATCCTC
GAATCTCC	GAATCCTC
GAATCTCG	GAATCCTC
GAATCTCT	GAATCCTC
GAATCTCN	GAATCCTC
GAATCTTC	GAATCCTC
GAAAGCCA	CAAAGCCA
GAAAGCCG	GAGAGCCG
GAATCNCT	GAATCCTC
GAAGAGCC	GAGAGCCG
GAATCNTC	GAATCCTC
GAGANAGG	GAGAAGGG
GAAAGGAT	TAAAGGAT
GAAAGGGA	GAGAAGGG
GAAAGGGC	GAGAAGGG
GAAAGGGG	GAGAAGGG
GAAAGGGT	GAGAAGGG
GAAAGGGN	GAGAAGGG
GAAAGTAA	GCAAAGTA
GAAAGTAC	GCAAAGTA
GAAAGTAG	GCAAAGTA
GAAAGTAT	GCAAAGTA
GAAAGTAN	GCAAAGTA
GAGANCCG	GAGAGCCG
GACACTAA	GACTACTA
GACACTAC	GACTACTA
GACACTAG	GACTACTA
GACACTAT	GACTACTA
GAATGCCT	GAATCCTC
GAGANGCC	GAGAGCCG
GAATGCTC	GAATCCTC
GACACTAN	GACTACTA
GAGANGGG	GAGAAGGG
GAAATCCT	GAATCCTC
GACACTTC	GCACTTCT
GAATGGTC	AATGGTCA
GAAGCAGG	AAGCAGGC
GAAGCCGA	GAGAGCCG
GAAGCCGC	GAGAGCCG
GACAGCCG	GAGAGCCG
GAAGCCGG	GAGAGCCG
GAAGCCGT	GAGAGCCG
GAAGCCGN	GAGAGCCG
GAAGCCTC	GAATCCTC
GAATGTTC	GAGTGTTC
GAGCAAGG	GAGAAGGG
GACGTAAC	GACTAACT
GACGTACT	GACTACTA
GACGTAGG	GCGTAGGT
GACATAAC	GACTAACT
GACATACT	GACTACTA
GACATCCT	GAATCCTC
GAGCAGCC	GAGAGCCG
GACATCGT	ACATCGTT
GAGCAGGC	AAGCAGGC
GAGCAGGG	GAGAAGGG
GAATTCCT	GAATCCTC
GAATTCTC	GAATCCTC
GAAGGGAG	AAGGGAGT
GACGTGTT	GAGTGTTC
GAACAAGT	AAACAAGT
GAAGTCCT	GAATCCTC
GAGCGATA	GATCGATA
GAGCGCCG	GAGAGCCG
GAAGTGTT	GAGTGTTC
GAAGTTGC	AAGTTGCC
GAGCGTAA	TAGCGTAA
GAATNCCT	GAATCCTC
GACTAAAC	GACTAACT
GACTAAAT	GACTAACT
GAATNCTC	GAATCCTC
GACTAACA	GACTAACT
GACTAACC	GACTAACT
GACTAACG	GACTAACT
GACTAACT	GACTAACT
GACTAACN	GACTAACT
GAGCGTTC	GAGTGTTC
GACTAAGC	GACTAACT
GAGCGTTT	AGCGTTTC
GATGCGAT	GATCGATA
GACTAAGT	GACTAACT
GACTAATC	GACTAACT
GACTAATG	GACTAACT
GACTAATT	GACTAACT
GACTAATN	GACTAACT
GACTAANC	GACTAACT
GACTAANT	GACTAACT
GACTACAA	GACTACTA
GACTACAG	GACTACTA
GACTACAT	GACTACTA
GACTACAN	GACTACTA
GACTACCA	GACTACTA
GACTACGA	GACTACTA
GACTACGT	GACTACTA
GACTACTA	GACTACTA
GACTACNA	GACTACTA
GACTACNT	GACTACTA
GACTAGAC	GACTAACT
GACTAGTA	GACTACTA
GAGGGAGT	AAGGGAGT
GACTATAA	GACTACTA
GACTATAG	GACTACTA
GACTATAT	GACTACTA
GACTATAN	GACTACTA
GAGGGCCA	AGGGCCAA
GAGGGCCG	GAGAGCCG
GAGNAAGG	GAGAAGGG
GACTATTA	GACTACTA
GACTANAC	GACTAACT
GAGGGTCG	AGGGTCGG
GAGGGTTC	GAGTGTTC
GAGCTAAC	GACTAACT
GAGCTACT	GACTACTA
GACTANTA	GACTACTA
GACTCAAC	GACTAACT
GAGNAGCC	GAGAGCCG
GAGNAGGG	GAGAAGGG
GACTCCTA	GACTACTA
GACTCCTC	GAATCCTC
GAGGTGTT	GAGTGTTC
GAGCTCAG	CAGCTCAG
GAGGTTCA	GAGTGTTC
GAGGTTCC	GAGTGTTC
GAGGTTCG	GAGTGTTC
GAGGTTCT	GAGTGTTC
GAGGTTCN	GAGTGTTC
GACTCGAT	GATCGATA
GACTCGCC	GCTCGCCC
GACTCTAA	GACTACTA
GACTCTAC	GACTACTA
GACTCTAG	GACTACTA
GACTCTAT	GACTACTA
GACTCTAN	GACTACTA
GATGGACA	GTGGACAA
GACCAACT	GACTAACT
GATGGATA	GATCGATA
GACCACCA	TACCACCA
GACTGAAC	GACTAACT
GACCACTA	GACTACTA
GAGCTGTT	GAGTGTTC
GACTGCTA	GACTACTA
GAGTAACT	GACTAACT
GAGTAAGG	GAGAAGGG
GATGGTCA	AATGGTCA
GAGTACTA	GACTACTA
GAGTAGCC	GAGAGCCG
GAGTAGGG	GAGAAGGG
GAGTAGGT	GCGTAGGT
GACTGTTC	GAGTGTTC
GAANCCTC	GAATCCTC
GAGTAGTT	GAGTGTTC
GAGTATGG	TAGTATGG
GAGTATTC	GAGTGTTC
GACNTAAC	GACTAACT
GACNTACT	GACTACTA
GACTTAAC	GACTAACT
GACTTAGT	GCCTTAGT
GACCCCTT	GCCCCTTT
GACTTCTC	GCACTTCT
GACTTCTG	GCACTTCT
GACTTCTT	GCACTTCT
GACTTCTN	GCACTTCT
GACTTGTA	AACTTGTA
GATGTCGT	ATGTCGTA
GACCCGCG	AACCCGCG
GACCCGGA	CGACCCGG
GACCCGGC	CGACCCGG
GACCCGGG	CGACCCGG
GACCCGGT	CGACCCGG
GACCCGGN	CGACCCGG
GATATAAC	ATATAACT
GACTTTAA	GCTTTAAA
GACCCTGA	GTACCCTG
GACCCTGC	GTACCCTG
GACCCTGG	GTACCCTG
GACCCTGT	GTACCCTG
GACCCTGN	GTACCCTG
GATGTGTT	GAGTGTTC
GACCCTTG	ACCCTTGG
GACCCTTT	GCCCCTTT
GATGTTCA	GAGTGTTC
GATGTTCC	GAGTGTTC
GATGTTCG	GAGTGTTC
GATGTTCT	GAGTGTTC
GATGTTCN	GAGTGTTC
GATATCCT	GAATCCTC
GAGTCCTC	GAATCCTC
GAGTCGAT	GATCGATA
GACCGATA	GATCGATA
GAGTCGTT	GAGTGTTC
GACTNAAC	GACTAACT
GATATTTC	ATATTTCC
GAGTCTTC	GAGTGTTC
GAGGAAGG	GAGAAGGG
GAGNGCCG	GAGAGCCG
GACCGGGT	GCCGGGTC
GAGGACAA	GTGGACAA
GACCGGTA	ACCGGTAA
GACTNCTA	GACTACTA
GAGNGTTC	GAGTGTTC
GAGGAGCC	GAGAGCCG
GAGGAGGG	GAGAAGGG
GAGTGATC	GAGTGTTC
GAGTGATT	GAGTGTTC
GAGTGCCG	GAGAGCCG
GACCTAAC	GACTAACT
GAGTGCTC	GAGTGTTC
GACCTACT	GACTACTA
GAGTGCTT	GAGTGTTC
GATTAACT	GACTAACT
GAGNTGTT	GAGTGTTC
GAGTGGTC	GAGTGTTC
GAGTGGTT	GAGTGTTC
GAGAAAGG	GAGAAGGG
GAGTGTAC	GAGTGTTC
GAGTGTAT	GAGTGTTC
GAGTGTCA	GAGTGTTC
GAGTGTCC	GAGTGTTC
GAGAAATC	AAGAAATC
GAGTGTCG	GAGTGTTC
GAGTGTCT	GAGTGTTC
GAGTGTCN	GAGTGTTC
GAGGCCGA	GAGAGCCG
GAGGCCGC	GAGAGCCG
GAGGCCGG	GAGAGCCG
GAGGCCGT	GAGAGCCG
GAGTGTGC	GAGTGTTC
GAGTGTGT	GAGTGTTC
GAGTGTTA	GAGTGTTC
GAGTGTTC	GAGTGTTC
GAGTGTTG	GAGTGTTC
GAGTGTTT	GAGTGTTC
GAGGCCGN	GAGAGCCG
GATCAAGC	GTCAAGCC
GAGTGTTN	GAGTGTTC
GAGAACCG	GAGAGCCG
GAGTGTNC	GAGTGTTC
GATCAATA	GATCGATA
GAGTGTNT	GAGTGTTC
GACNAACT	GACTAACT
GATTACTA	GACTACTA
GAGAACGG	GAGAAGGG
GATCAGAT	GATCGATA
GAGTGNTC	GAGTGTTC
GAGTGNTT	GAGTGTTC
GACNACTA	GACTACTA
GACCTTAG	GCCTTAGT
GAGAAGAG	GAGAAGGG
GAGAAGCC	GAGAGCCG
GAGAAGCG	GAGAAGGG
GAGAAGGA	GAGAAGGG
GAGAAGGC	GAGAAGGG
GAGAAGGG	GAGAAGGG
GAGAAGGT	GAGAAGGG
GAGAAGGN	GAGAAGGG
GAGAAGTG	GAGAAGGG
GAGAAGNG	GAGAAGGG
GATCATAA	GATCGATA
GATCATAC	GATCGATA
GATCATAG	GATCGATA
GATCATAT	GATCGATA
GATCATAN	GATCGATA
GATTATTA	CGATTATT
GATTATTC	CGATTATT
GATTATTG	CGATTATT
GATTATTT	CGATTATT
GAGAATGG	GAGAAGGG
GATAACTA	GACTAACT
GATAACTC	GACTAACT
GATAACTG	GACTAACT
GATAACTT	GACTAACT
GATAACTN	GACTAACT
GATTATTN	CGATTATT
GAGTTGCC	AAGTTGCC
GATAAGGG	GAGAAGGG
GAGAANGG	GAGAAGGG
GAGTTGTT	GAGTGTTC
GAGTTTCA	GAGTGTTC
GAGTTTCC	GAGTGTTC
GAGTTTCG	GAGTGTTC
GATCCATA	GATCGATA
GAGTTTCT	GAGTGTTC
GAGTTTCN	GAGTGTTC
GAGTTTTC	GAGTGTTC
GAGACAGG	GAGAAGGG
GATTCAAG	ATTCAAGG
GATACCCT	GTACCCTG
GATACGAT	GATCGATA
GATACGGA	GTACGGAT
GAGACCCG	GAGAGCCG
GAGACCGA	GAGAGCCG
GAGACCGC	GAGAGCCG
GAGACCGG	GAGAGCCG
GAGACCGT	GAGAGCCG
GAGACCGN	GAGAGCCG
GATCCCTA	TGATCCCT
GATACTAA	GACTACTA
GATACTAC	GACTACTA
GATACTAG	GACTACTA
GATACTAT	GACTACTA
GATACTAN	GACTACTA
GATCCCTC	TGATCCCT
GATCCCTG	TGATCCCT
GATCCCTT	TGATCCCT
GATCCCTN	TGATCCCT
GATTCCCG	GTTTCCCG
GAGACGCC	GAGAGCCG
GAGACGGG	GAGAAGGG
GATCCGAG	CATCCGAG
GATCCGAT	GATCGATA
GATTCCTC	GAATCCTC
GATTCCTG	ATTCCTGC
GAGTNGTT	GAGTGTTC
GATTCGAT	GATCGATA
GATCCTCA	GAATCCTC
GATCCTCC	GAATCCTC
GATCCTCG	GAATCCTC
GATCCTCT	GAATCCTC
GATCCTCN	GAATCCTC
GANAGCCG	GAGAGCCG
GAGAGACC	GAGAGCCG
GAGAGACG	GAGAGCCG
GAGAGAGG	GAGAAGGG
GAGTNTTC	GAGTGTTC
GATAGATA	GATCGATA
GATCGAAA	GATCGATA
GATCGAAC	GATCGATA
GATCGAAG	GATCGATA
GATCGAAT	GATCGATA
GATCGAAN	GATCGATA
GATCGACA	GATCGATA
GATCGACT	GATCGATA
GATCGAGA	GATCGATA
GATAGCCG	GAGAGCCG
GAGAGCAC	GAGAGCCG
GACGAACT	GACTAACT
GAGAGCAG	GAGAGCCG
GAGAGCCA	GAGAGCCG
GAGAGCCC	GAGAGCCG
GATCGAGT	GATCGATA
GAGAGCCG	GAGAGCCG
GAGAGCCT	GAGAGCCG
GATCGATA	GATCGATA
GAGAGCCN	GAGAGCCG
GAGAGCGA	GAGAGCCG
GAGAGCGC	GAGAGCCG
GAGAGCGG	GAGAGCCG
GAGAGCGT	GAGAGCCG
GAGAGCGN	GAGAGCCG
GAGAGCTC	GAGAGCCG
GACGAAGG	GAGAAGGG
GATCGATC	GATCGATA
GAGAGCTG	GAGAGCCG
GATCGATG	GATCGATA
GATCGATT	GATCGATA
GATCGATN	GATCGATA
GATCGANA	GATCGATA
GAGAGCNC	GAGAGCCG
GATCGANT	GATCGATA
GAGAGCNG	GAGAGCCG
GATTGATA	GATCGATA
GAGAGGCC	GAGAGCCG
GAGAGGCG	GAGAGCCG
GATCGCAT	GATCGATA
GATCGCCC	GCTCGCCC
GAGAGGGA	GAGAAGGG
GAGAGGGC	GAGAAGGG
GAGAGGGG	GAGAAGGG
GATTGCAT	GTTTGCAT
GAGAGGGT	GAGAAGGG
GAGAGGGN	GAGAAGGG
GATCGCTA	GATCGATA
GAGAGTCC	GAGAGCCG
GAGAGTCG	GAGAGCCG
GCAACAGT	GCAAAGTA
GAGAGTTC	GAGTGTTC
GACGACTA	GACTACTA
GATCGGAT	GATCGATA
GAGAGNCC	GAGAGCCG
GAGAGNCG	GAGAGCCG
GATCGGTA	GATCGATA
GACGAGAG	ACGAGAGT
GACGAGCC	GAGAGCCG
GATCGTAA	GATCGATA
GATCGTAC	GATCGATA
GATCGTAG	GATCGATA
GATCGTAT	GATCGATA
GATCGTAN	GATCGATA
GATCGTTA	GATCGATA
GANATCCT	GAATCCTC
GACGATAA	GATCGATA
GACGATAC	GATCGATA
GACGATAG	GATCGATA
GACGATAT	GATCGATA
GACGATAN	GATCGATA
GAGATAGG	GAGAAGGG
GATCGNAT	GATCGATA
GATTGTTC	GAGTGTTC
GATCGNTA	GATCGATA
GAGATCCG	GAGAGCCG
GAGATCCT	GAATCCTC
GCAACGCG	ACAACGCG
GCAACGTA	GCAAAGTA
GATCTAAC	GACTAACT
GAGATGCC	GAGAGCCG
GAGATGGG	GAGAAGGG
GCAACTTC	GCACTTCT
GAGATGTT	GAGTGTTC
GATCTACT	GACTACTA
GATTTAAA	GCTTTAAA
GATCTATA	GATCGATA
GCACNTCT	GCACTTCT
GATTTCCC	GTTTCCCG
GCACNTTC	GCACTTCT
GCAAGAGT	GCAAAGTA
GATTTGCA	GTTTGCAT
GANGAAGG	GAGAAGGG
GCAAGCCA	GTCAAGCC
GCAAGCCC	GTCAAGCC
GCAAGCCG	GTCAAGCC
GCAAGCCT	GTCAAGCC
GCAAGCCN	GTCAAGCC
GACGCTCC	ACGCTCCT
GATCTGAC	ATCTGACC
GATCTGAT	GATCGATA
GANGAGCC	GAGAGCCG
GCAGAAAC	TCAGAAAC
GCAAGGTA	GCAAAGTA
GCAGAAGG	GAGAAGGG
GCAGAAGT	GCAAAGTA
GCAAGTAA	GCAAAGTA
GCAAGTAC	GCAAAGTA
GCAAGTAG	GCAAAGTA
GCAAGTAT	GCAAAGTA
GCAAGTAN	GCAAAGTA
GCAGAGCC	GAGAGCCG
GCAGAGTA	GCAAAGTA
GCCAAAGT	GCAAAGTA
GACGGATA	GTACGGAT
GACGGATC	GTACGGAT
GACGGATG	GTACGGAT
GACGGATT	GTACGGAT
GCCAAATG	CCAAATGG
GACGGATN	GTACGGAT
GACGGCAT	CACGGCAT
GCAATAGT	GCAAAGTA
GCAATCCT	GAATCCTC
GCCAACGA	TCCAACGA
GATCNATA	GATCGATA
GCAATGTA	GCAAAGTA
GCCAAGCC	GTCAAGCC
GCCAAGTA	GCAAAGTA
GACGGGTC	GCCGGGTC
GATCNGAT	GATCGATA
GCAATTAG	ACAATTAG
GCAATTCT	GCACTTCT
GCAANAGT	GCAAAGTA
GCAGCTCA	CAGCTCAG
GCAGCTTC	GCACTTCT
GATGAAGG	GAGAAGGG
GCAANGTA	GCAAAGTA
GCCACCTT	GCCCCTTT
GATGAGCC	GAGAGCCG
GATGATAA	GATCGATA
GATGATAC	GATCGATA
GATGATAG	GATCGATA
GATGATAT	GATCGATA
GATGATAN	GATCGATA
GCCACTTC	GCACTTCT
GCCACTTT	GCCCCTTT
GCAGGGTC	GCCGGGTC
GCAGGTCT	TCAGGTCT
GCACAAGT	GCAAAGTA
GCCAGGGT	GCCGGGTC
GCCAGGTC	GCCGGGTC
GCAGTAGG	GCGTAGGT
GCCAGTTA	CCCAGTTA
GCACAGTA	GCAAAGTA
GCAGTGTT	GAGTGTTC
GCACATCT	GCACTTCT
GCACATTC	GCACTTCT
GANCGATA	GATCGATA
GCAGTTCT	GCACTTCT
GCCATAGT	GCCTTAGT
GCCATCCA	CCCATCCA
GANGTGTT	GAGTGTTC
GCATTAAA	GCTTTAAA
GCATTAGT	GCCTTAGT
GCACCCTG	GTACCCTG
GCACCCTT	GCCCCTTT
GCATTCTA	GCACTTCT
GCATTCTC	GCACTTCT
GCATTCTG	GCACTTCT
GCATTCTT	GCACTTCT
GCATTCTN	GCACTTCT
GCACCTCT	GCACTTCT
GCACCTTC	GCACTTCT
GCACCTTT	GCCCCTTT
GCAAAAGT	GCAAAGTA
GCAAAATA	GCAAAGTA
GCCATTAG	GCCTTAGT
GANCTAAC	GACTAACT
GANCTACT	GACTACTA
GCATTTAA	GCTTTAAA
GCAAACGT	GCAAAGTA
GCAAACTA	GCAAAGTA
GATNCGAT	GATCGATA
GCAAAGAA	GCAAAGTA
GCAAAGAC	GCAAAGTA
GCAAAGAG	GCAAAGTA
GCAAAGAT	GCAAAGTA
GCAAAGAN	GCAAAGTA
GCAAAGCA	GCAAAGTA
GCAAAGCC	CAAAGCCA
GCAAAGCT	GCAAAGTA
GCATTTCT	GCACTTCT
GCAAAGGA	GCAAAGTA
GCAAAGGT	GCAAAGTA
GCAAAGTA	GCAAAGTA
GCAAAGTC	GCAAAGTA
GCAAAGTG	GCAAAGTA
GCAAAGTT	GCAAAGTA
GCAAAGTN	GCAAAGTA
GCACGCCC	GCTCGCCC
GCAAAGNA	GCAAAGTA
GCAAAGNT	GCAAAGTA
GCAAATAA	GCAAAGTA
GCAAATAC	GCAAAGTA
GCAAATAG	GCAAAGTA
GCAAATAT	GCAAAGTA
GCAAATAN	GCAAAGTA
GCAAATGG	CCAAATGG
GCAAATGT	GCAAAGTA
GCAAATTA	GCAAAGTA
GCACGGAT	GTACGGAT
GCACGGCA	CACGGCAT
GCACGGGT	GCCGGGTC
GCAAANGT	GCAAAGTA
GCAAANTA	GCAAAGTA
GCACGTCT	GCACTTCT
GCACGTTC	GCACTTCT
GCATAAGT	GCAAAGTA
GANTAACT	GACTAACT
GCGCGCCC	GCTCGCCC
GATNGATA	GATCGATA
GANTACTA	GACTACTA
GCATAGGT	GCGTAGGT
GCATAGTA	GCAAAGTA
GCACTAAC	GACTAACT
GCACTATC	GCACTTCT
GCACTCCT	GCACTTCT
GCACTCTA	GCACTTCT
GCACTCTC	GCACTTCT
GCACTCTG	GCACTTCT
GCACTCTT	GCACTTCT
GCACTCTN	GCACTTCT
GCGCGGAA	CGCGGAAG
GCANAAGT	GCAAAGTA
GCACTGCT	GCACTTCT
GCGCGGGT	GCCGGGTC
GCACTGTC	GCACTTCT
GCACTTAC	GCACTTCT
GCACTTAG	GCCTTAGT
GCACTTAT	GCACTTCT
GCACTTCA	GCACTTCT
GCACTTCC	GCACTTCT
GCACTTCG	GCACTTCT
GCACTTCT	GCACTTCT
GCACTTCN	GCACTTCT
GCACTTGC	GCACTTCT
GCACTTGT	GCACTTCT
GCACTTTA	GCACTTCT
GCACTTTC	GCACTTCT
GCACTTTG	GCACTTCT
GCACTTTT	GCACTTCT
GCACTTTN	GCACTTCT
GCACTTNC	GCACTTCT
GCACTTNT	GCACTTCT
GCACTNCT	GCACTTCT
GCACTNTC	GCACTTCT
GCANAGTA	GCAAAGTA
GCGTAAGG	GCGTAGGT
GCGCTAGG	GCGTAGGT
GCGTAAGT	GCGTAGGT
GCGCTCCT	ACGCTCCT
GCCTCAGT	GCCTTAGT
GCGTACGG	GCGTAGGT
GCGTACGT	GCGTAGGT
GCGCTTAG	GCCTTAGT
GCGCTTCT	GCACTTCT
GCATCCGA	CATCCGAG
GCGTAGAG	GCGTAGGT
GCGTAGAT	GCGTAGGT
GCATCCTC	GAATCCTC
GCATCGAT	GATCGATA
GCATCGCC	GCTCGCCC
GCATCGTT	ACATCGTT
GCATCTTC	GCACTTCT
GCGTAGCG	GCGTAGGT
GCGTAGCT	GCGTAGGT
GCGTAGGA	GCGTAGGT
GCGTAGGC	GCGTAGGT
GCGTAGGG	GCGTAGGT
GCCTCCTT	GCCCCTTT
GCGTAGGT	GCGTAGGT
GCGTAGGN	GCGTAGGT
GCGTAGTA	GCGTAGGT
GCGTAGTC	GCGTAGGT
GCGTAGTG	GCGTAGGT
GCGTAGTT	GCGTAGGT
GCGTAGTN	GCGTAGGT
GCGTAGNG	GCGTAGGT
GCGTAGNT	GCGTAGGT
GCGTATAC	CGTATACG
GCCTCGAT	CCTCGATT
GCCTCGCC	GCTCGCCC
GCGNTAGG	GCGTAGGT
GCGTATGG	GCGTAGGT
GANTCCTC	GAATCCTC
GCANCTTC	GCACTTCT
GCCTCTAG	GCCTTAGT
GCCCACTG	CCCCACTG
GCCCACTT	GCCCCTTT
GCGTATGT	GCGTAGGT
GCCTCTTT	GCCCCTTT
GANTCGAT	GATCGATA
GCCCAGTT	CCCAGTTA
GCGTANGG	GCGTAGGT
GCGTANGT	GCGTAGGT
GCCCATCC	CCCATCCA
GCCTGAGT	GCCTTAGT
GCCCATTT	GCCCCTTT
GCCTGCAA	CCTGCAAG
GCGTCAGG	GCGTAGGT
GCCCCACT	CCCCACTG
GCCTGGGT	GCCGGGTC
GCCTGGTC	GCCGGGTC
GCCCCATT	GCCCCTTT
GCGGAAGA	CGCGGAAG
GCCTGTAG	GCCTTAGT
GCGGAAGC	CGCGGAAG
GCGGAAGG	CGCGGAAG
GCGGAAGT	CGCGGAAG
GCGGAAGN	CGCGGAAG
GCCTGTCG	CCCTGTCG
GCGGACAA	GTGGACAA
GCCCCCTT	GCCCCTTT
GCGGACTA	TGCGGACT
GCGGACTC	TGCGGACT
GCGGACTG	TGCGGACT
GCGGACTT	TGCGGACT
GCCCCGTT	GCCCCTTT
GCGGACTN	TGCGGACT
GCCCCTAA	CCCCTAAA
GCCCCTAT	GCCCCTTT
GCCCCTCT	GCCCCTTT
GCCCCTGT	GCCCCTTT
GCCCCTTA	GCCCCTTT
GCCCCTTC	GCCCCTTT
GCCCCTTG	GCCCCTTT
GCCCCTTT	GCCCCTTT
GCGGAGGT	GCGTAGGT
GCCCCTTN	GCCCCTTT
GCCCCTNT	GCCCCTTT
GCGTCGCC	GCTCGCCC
GCCTTAAA	GCTTTAAA
GCCTTAAG	GCCTTAGT
GCCTTAAT	GCCTTAGT
GCGTCGGT	GCGTAGGT
GCCTTACG	GCCTTAGT
GCCTTACT	GCCTTAGT
GCCTTAGA	GCCTTAGT
GCCTTAGC	GCCTTAGT
GCCTTAGG	GCCTTAGT
GCCTTAGT	GCCTTAGT
GCCCCNTT	GCCCCTTT
GCCTTAGN	GCCTTAGT
GCCTTATA	GCCTTAGT
GCCTTATC	GCCTTAGT
GCCTTATG	GCCTTAGT
GCCTTATT	GCCTTAGT
GCCTTATN	GCCTTAGT
GCCTTANG	GCCTTAGT
GCCTTANT	GCCTTAGT
GCCTTCAC	TCCTTCAC
GCCTTCAG	GCCTTAGT
GCGGATTC	CGGATTCC
GCANTTCT	GCACTTCT
GCCTTCGT	GCCTTAGT
GCCTTCTA	GCACTTCT
GCCTTCTC	GCACTTCT
GCCTTCTG	GCACTTCT
GCCTTCTT	GCACTTCT
GCCTTCTN	GCACTTCT
GCCCGCCC	GCTCGCCC
GANTGTTC	GAGTGTTC
GCCCGCTT	GCCCCTTT
GCCTTGAG	GCCTTAGT
GCCTTGGT	GCCTTAGT
GCCTTGTA	GCCTTAGT
GCCTTGTC	GCCTTAGT
GCCTTGTG	GCCTTAGT
GCCTTGTT	GCCTTAGT
GCCTTGTN	GCCTTAGT
GCCCGGGT	GCCGGGTC
GCCTTTAA	GCTTTAAA
GCCTTTAG	GCCTTAGT
GCCCGGTC	GCCGGGTC
GCCTTTGT	GCCTTAGT
GCTAAAGT	GCAAAGTA
GCCCGTTT	GCCCCTTT
GCCTTNAG	GCCTTAGT
GCTAACTA	GACTAACT
GCTAACTC	GACTAACT
GCTAACTG	GACTAACT
GCTAACTT	GACTAACT
GCTAACTN	GACTAACT
GCTAAGAA	CTAAGAAC
GCGTGAGG	GCGTAGGT
GANAAGGG	GAGAAGGG
GCCTTNGT	GCCTTAGT
GCTAAGTA	GCAAAGTA
GCCTNAGT	GCCTTAGT
GCGTGGGT	GCGTAGGT
GCGTGGTA	GCGTAGGT
GCGTGGTC	GCGTAGGT
GCGTGGTG	GCGTAGGT
GCGTGGTT	GCGTAGGT
GCGTGGTN	GCGTAGGT
GCTCCCCA	GCTCGCCC
GCTCCCCC	GCTCGCCC
GCTCCCCG	GCTCGCCC
GCTCCCCT	GCTCGCCC
GCTCCCCN	GCTCGCCC
GCGGGGTC	GCCGGGTC
GCTCCCTT	GCCCCTTT
GCTCCGCC	GCTCGCCC
GCGGGTCA	GCCGGGTC
GCGGGTCC	GCCGGGTC
GCGGGTCG	GCCGGGTC
GCGGGTCT	GCCGGGTC
GCGGGTCN	GCCGGGTC
GCTCCGGG	TCTCCGGG
GCGTGTTC	GAGTGTTC
GCTACCCT	GTACCCTG
GCTACGCC	GCTCGCCC
GCGAAAGT	GCAAAGTA
GCCTNTAG	GCCTTAGT
GCTCCTTT	GCCCCTTT
GCTACGGA	GTACGGAT
GCGTTAAA	GCTTTAAA
GCGTTAGG	GCGTAGGT
GCGTTAGT	GCCTTAGT
GCTACTAA	GACTACTA
GCTACTAC	GACTACTA
GCTACTAG	GACTACTA
GCTACTAT	GACTACTA
GCTACTAN	GACTACTA
GCGGTAGG	GCGTAGGT
GCTCGACC	GCTCGCCC
GCGTTGAG	CCGTTGAG
GCTCGATA	GATCGATA
GCGTTGGT	GCGTAGGT
GCTCGATT	CCTCGATT
GCTACTTC	GCACTTCT
GCGAAGGG	GAGAAGGG
GCGAAGGT	GCGTAGGT
GCTCGCAC	GCTCGCCC
GCTCGCCA	GCTCGCCC
GCTCGCCC	GCTCGCCC
GCTCGCCG	GCTCGCCC
GCGAAGTA	GCAAAGTA
GCGTTTAA	GCTTTAAA
GCGTTTCA	AGCGTTTC
GCTCGCCT	GCTCGCCC
GCGTTTCC	AGCGTTTC
GCGTTTCG	AGCGTTTC
GCTCGCCN	GCTCGCCC
GCGTTTCT	AGCGTTTC
GCGTTTCN	AGCGTTTC
GCTCGCGC	GCTCGCCC
GCTCGCTC	GCTCGCCC
GCTCGCNC	GCTCGCCC
GCTAGCAT	CTAGCATT
GCTAGCCC	GCTCGCCC
GCTCGGCC	GCTCGCCC
GCTTAAAA	GCTTTAAA
GCTTAAAC	GCTTTAAA
GCTCGGGT	GCCGGGTC
GCGGTGGT	CGGTGGTT
GCTTAAAG	GCTTTAAA
GCTTAAAT	GCTTTAAA
GCTTAAAN	GCTTTAAA
GCGTNAGG	GCGTAGGT
GCTCGTCC	GCTCGCCC
GCTTAATG	CTTAATGC
GCTAGCTC	CTAGCTCG
GCGTNGGT	GCGTAGGT
GCTCGNCC	GCTCGCCC
GCTTACCA	CTTACCAA
GCTCTAAA	GCTTTAAA
GCTAGGCC	CTAGGCCC
GCTAGGTA	GCGTAGGT
GCTAGGTC	GCGTAGGT
GCTAGGTG	GCGTAGGT
GCTAGGTT	GCGTAGGT
GCTAGGTN	GCGTAGGT
GCGACCCG	CGACCCGG
GCCCTAAA	CCCCTAAA
GCTTAGGT	GCGTAGGT
GCTTAGTA	GCCTTAGT
GCTTAGTC	GCCTTAGT
GCTTAGTG	GCCTTAGT
GCTTAGTT	GCCTTAGT
GCTTAGTN	GCCTTAGT
GCTTATAA	GCTTTAAA
GCTCTCCC	GCTCGCCC
GCCCTAGT	GCCTTAGT
GCGNAGGT	GCGTAGGT
GCTCTGCC	GCTCGCCC
GCCCTCTT	GCCCCTTT
GCTCTTAA	GCTTTAAA
GCGACTTC	GCACTTCT
GCTCTTAG	GCCTTAGT
GCTATAAA	GCTTTAAA
GCTCTTCT	GCACTTCT
GCCCTGTC	CCCTGTCG
GCCCTTAG	GCCTTAGT
GCTTCAAA	GCTTTAAA
GCCNCCTT	GCCCCTTT
GCCCTTCT	GCACTTCT
GCTTCCCG	GTTTCCCG
GCCCTTGG	ACCCTTGG
GCCCTTTA	GCCCCTTT
GCCCTTTC	GCCCCTTT
GCCCTTTG	GCCCCTTT
GCCCTTTT	GCCCCTTT
GCCCTTTN	GCCCCTTT
GCTTCGCC	GCTCGCCC
GCTATTAA	GCTTTAAA
GCTTCTAA	GCTTTAAA
GCGAGAGT	ACGAGAGT
GCTCNCCC	GCTCGCCC
GCTTCTCT	CTTCTCTA
GCCNCTTT	GCCCCTTT
GCTCNGCC	GCTCGCCC
GCGAGCCG	GAGAGCCG
GCTTGAAA	GCTTTAAA
GCTTGCAT	GTTTGCAT
GCTTGCCC	GCTCGCCC
GCCCNCTT	GCCCCTTT
GCTTGGAG	TCTTGGAG
GCGAGGTA	GCGTAGGT
GCGAGGTC	GCGTAGGT
GCGAGGTG	GCGTAGGT
GCGAGGTT	GCGTAGGT
GCGAGGTN	GCGTAGGT
GCCNGGGT	GCCGGGTC
GCCNGGTC	GCCGGGTC
GCTTGTAA	GCTTTAAA
GCCNTAGT	GCCTTAGT
GCCCNTTT	GCCCCTTT
GCTTTAAA	GCTTTAAA
GCTTTAAC	GCTTTAAA
GCTTTAAG	GCTTTAAA
GCTTTAAT	GCTTTAAA
GCTTTAAN	GCTTTAAA
GCTTTACA	GCTTTAAA
GCGATAGG	GCGTAGGT
GCTTTAGA	GCTTTAAA
GCTTTAGT	GCCTTAGT
GCTTTATA	GCTTTAAA
GCTTTANA	GCTTTAAA
GCTTTCAA	GCTTTAAA
GCTTTCCC	GTTTCCCG
GCCNTTAG	GCCTTAGT
GCTCAAGC	GTCAAGCC
GCTTTGAA	GCTTTAAA
GCGATTAT	CGATTATT
GCTCACCC	GCTCGCCC
GCTTTGCA	GTTTGCAT
GCTTTTAA	GCTTTAAA
GCTCAGCC	GCTCGCCC
GCTTTNAA	GCTTTAAA
GCCGAGGT	GCCGGGTC
GCCGAGTC	GCCGGGTC
GCTTNAAA	GCTTTAAA
GCTTNTAA	GCTTTAAA
GCTGCAAG	CCTGCAAG
GCCGCCCA	GCTCGCCC
GCCGCCCC	GCTCGCCC
GCCGCCCG	GCTCGCCC
GCCGCCCT	GCTCGCCC
GCCGCCCN	GCTCGCCC
GCCGCCTT	GCCCCTTT
GCCGCGGT	GCCGGGTC
GCCGCGTC	GCCGGGTC
GCGCAGGT	GCGTAGGT
GCCGCTAG	TCCGCTAG
GCTGCCCA	GCTCGCCC
GCTGCCCC	GCTCGCCC
GCTGCCCG	GCTCGCCC
GCTGCCCT	GCTCGCCC
GCTGCCCN	GCTCGCCC
GCCGCTTT	GCCCCTTT
GCCGGAGT	GCCGGGTC
GCCGGATC	GCCGGGTC
GCTGCGCC	GCTCGCCC
GCCGGCGT	GCCGGGTC
GCCGGCTC	GCCGGGTC
GCCGGGAC	GCCGGGTC
GCCGGGAT	GCCGGGTC
GCCGGGCA	GCCGGGTC
GCCGGGCC	GCCGGGTC
GCCGGGCG	GCCGGGTC
GCCGGGCT	GCCGGGTC
GCCGGGCN	GCCGGGTC
GCCGGGGC	GCCGGGTC
GCNCCCTT	GCCCCTTT
GCCGGGGT	GCCGGGTC
GCCGGGTA	GCCGGGTC
GCGCCCTT	GCCCCTTT
GCCGGGTC	GCCGGGTC
GCCGGGTG	GCCGGGTC
GCCGGGTT	GCCGGGTC
GCCGGGTN	GCCGGGTC
GCCGGGNC	GCCGGGTC
GCCGGGNT	GCCGGGTC
GCCGGTAA	ACCGGTAA
GCCGGTCA	GCCGGGTC
GCCGGTCC	GCCGGGTC
GCCGGTCG	GCCGGGTC
GCCGGTCT	GCCGGGTC
GCCGGTCN	GCCGGGTC
GCCGGTGT	GCCGGGTC
GCCGGTTC	GCCGGGTC
GCTGGACA	GTGGACAA
GCCGGNGT	GCCGGGTC
GCCGGNTC	GCCGGGTC
GCGCCTTT	GCCCCTTT
GCNCCTTT	GCCCCTTT
GCCGTAGG	GCGTAGGT
GCCGTAGT	GCCTTAGT
GCTGGCCC	GCTCGCCC
GCNGTAGG	GCGTAGGT
GGAGTGTT	GAGTGTTC
GCTGGGAT	CTGGGATC
GCTGGGTC	GCCGGGTC
GCCGTGGT	GCCGGGTC
GCCGTGTC	GCCGGGTC
GCCGTTAG	GCCTTAGT
GCNCGCCC	GCTCGCCC
GGACCCGG	CGACCCGG
GCTNCGCC	GCTCGCCC
GGACCCTG	GTACCCTG
GGAAAGTA	GCAAAGTA
GCNCGGGT	GCCGGGTC
GCCGTTGA	CCGTTGAG
GCTGTAAA	GCTTTAAA
GCTGTAGG	GCGTAGGT
GCTGTTAA	GCTTTAAA
GGAACTGT	TGAACTGT
GCCGNGGT	GCCGGGTC
GCCGNGTC	GCCGGGTC
GGACGGAT	GTACGGAT
GGAAGGGA	GAGAAGGG
GGAAGGGC	GAGAAGGG
GGAAGGGG	GAGAAGGG
GCNCTTAG	GCCTTAGT
GGAAGGGT	GAGAAGGG
GGAAGGGN	GAGAAGGG
GCNCTTCT	GCACTTCT
GCNTAGGT	GCGTAGGT
GCCTAACT	GACTAACT
GCCTAAGT	GCCTTAGT
GGAATCCT	GAATCCTC
GCCTACTA	GACTACTA
GGACTAAC	GACTAACT
GCCTAGGT	GCGTAGGT
GCCTAGTA	GCCTTAGT
GCCTAGTC	GCCTTAGT
GGACTACT	GACTACTA
GCCTAGTG	GCCTTAGT
GCCTAGTT	GCCTTAGT
GCCTAGTN	GCCTTAGT
GCCTATAG	GCCTTAGT
GCNTCGCC	GCTCGCCC
GCTNGCCC	GCTCGCCC
GGGGACAA	GTGGACAA
GGATCCCT	TGATCCCT
GGATCCTC	GAATCCTC
GGATCGAT	GATCGATA
GGACTTCT	GCACTTCT
GCTNTAAA	GCTTTAAA
GGGGCCAA	AGGGCCAA
GCTNTTAA	GCTTTAAA
GCNTTAAA	GCTTTAAA
GCNTTAGT	GCCTTAGT
GGAGAAGG	GAGAAGGG
GCNTTTAA	GCTTTAAA
GGATTATT	CGATTATT
GGATTCCA	CGGATTCC
GGATTCCC	CGGATTCC
GGATTCCG	CGGATTCC
GGATTCCT	CGGATTCC
GGATTCCN	CGGATTCC
GGAGAGCC	GAGAGCCG
GGCCCCTT	GCCCCTTT
GCNAAAGT	GCAAAGTA
GGGGTCGG	AGGGTCGG
GGCCCTTT	GCCCCTTT
GGAGCCGA	GAGAGCCG
GGAGCCGC	GAGAGCCG
GGAGCCGG	GAGAGCCG
GGAGCCGT	GAGAGCCG
GGAGCCGN	GAGAGCCG
GCNAAGTA	GCAAAGTA
GCNGGGTC	GCCGGGTC
GGCAAAGT	GCAAAGTA
GGCAAGCC	GTCAAGCC
GCNACTTC	GCACTTCT
GGCCGGGT	GCCGGGTC
GGTACCCT	GTACCCTG
GGCACTTC	GCACTTCT
GGGAGCCG	GAGAGCCG
GGCCTTAG	GCCTTAGT
GGTACGGA	GTACGGAT
GGTAGGTA	GCGTAGGT
GGTAGGTC	GCGTAGGT
GGTAGGTG	GCGTAGGT
GGTAGGTT	GCGTAGGT
GGTAGGTN	GCGTAGGT
GGGTAGGT	GCGTAGGT
GGTATACG	CGTATACG
GGGATTCC	CGGATTCC
GGGTCGGA	AGGGTCGG
GGGTCGGC	AGGGTCGG
GGGTCGGG	AGGGTCGG
GGGTCGGT	AGGGTCGG
GGGTCGGN	AGGGTCGG
GGCGCATA	TGGCGCAT
GGCGCATC	TGGCGCAT
GGCGCATG	TGGCGCAT
GGCGCATT	TGGCGCAT
GGCGCATN	TGGCGCAT
GGGTGGTT	CGGTGGTT
GGGTGTTC	GAGTGTTC
GGTTGCAT	GTTTGCAT
GGTCAAGC	GTCAAGCC
GGGCCAAA	AGGGCCAA
GGGCCAAC	AGGGCCAA
GGGCCAAG	AGGGCCAA
GGGCCAAT	AGGGCCAA
GGGCCAAN	AGGGCCAA
GGCGGAAG	CGCGGAAG
GGCGGACT	TGCGGACT
GGTTTAAA	GCTTTAAA
GGCGGGTC	GCCGGGTC
GGTTTCCC	GTTTCCCG
GTAAAGCC	GTCAAGCC
GTAAAGGA	TAAAGGAT
GTAAAGTA	GCAAAGTA
GGTTTGCA	GTTTGCAT
GGGCGCAT	TGGCGCAT
GGTTTTGA	TGTTTTGA
GTAACCCC	TTAACCCC
GTAACCCT	GTACCCTG
GTAACCTG	GTACCCTG
GGTGGACA	GTGGACAA
GTAACGGA	GTACGGAT
GGCGTAGG	GCGTAGGT
GGTGGGGT	TGTGGGGT
GGTGGTTA	CGGTGGTT
GGTGGTTC	CGGTGGTT
GGTGGTTG	CGGTGGTT
GGCGTTTC	AGCGTTTC
GGTGGTTT	CGGTGGTT
GGTGGTTN	CGGTGGTT
GTAAGAAC	CTAAGAAC
GTAAGCCA	GTCAAGCC
GTAAGCCC	GTCAAGCC
GTAAGCCG	GTCAAGCC
GTAAGCCT	GTCAAGCC
GTAAGCCN	GTCAAGCC
GTAAGGAT	GTACGGAT
GGTCGATA	GATCGATA
GGTCGCCC	GCTCGCCC
GGGAAGGG	GAGAAGGG
GGTGTTCA	GAGTGTTC
GGTGTTCC	GAGTGTTC
GGTGTTCG	GAGTGTTC
GGTGTTCT	GAGTGTTC
GGTGTTCN	GAGTGTTC
GGCTAACT	GACTAACT
GTAATATA	TAATATAT
GGCTACTA	GACTACTA
GTAATCCT	GAATCCTC
GTAATCGA	TAATCGAG
GGGACAAA	GTGGACAA
GGGACAAC	GTGGACAA
GGGACAAG	GTGGACAA
GGGACAAT	GTGGACAA
GGGACAAN	GTGGACAA
GGTCTGAC	TGTCTGAC
GGCTCGCC	GCTCGCCC
GTATAACT	ATATAACT
GTACGAAT	GTACGGAT
GTACGAGA	GTACGGAT
GTACGATA	GTACGGAT
GTATACGA	CGTATACG
GTACGATC	GTACGGAT
GTATACGC	CGTATACG
GTATACGG	CGTATACG
GTATACGT	CGTATACG
GTATACGN	CGTATACG
GTACGATG	GTACGGAT
GTACGATT	GTACGGAT
GTACGATN	GTACGGAT
GTACGCAT	GTACGGAT
GTACGCCT	GTACCCTG
GTACGCGA	GTACGGAT
GTACGCTG	GTACCCTG
GTACGGAA	GTACGGAT
GTACGGAC	GTACGGAT
GTACGGAG	GTACGGAT
GTACGGAT	GTACGGAT
GTACGGAN	GTACGGAT
GTACGGCA	GTACGGAT
GTACGGCT	GTACGGAT
GTACGGGA	GTACGGAT
GTACGGGT	GTACGGAT
GTACGGTA	GTACGGAT
GTACGGTC	GTACGGAT
GTACGGTG	GTACGGAT
GTACGGTT	GTACGGAT
GTACGGTN	GTACGGAT
GTACGGNA	GTACGGAT
GTACGGNT	GTACGGAT
GTACGTAT	GTACGGAT
GTACGTGA	GTACGGAT
GTACGNAT	GTACGGAT
GTACGNGA	GTACGGAT
GTACTAAC	GACTAACT
GGCTTAGT	GCCTTAGT
GTACAAGC	GTCAAGCC
GTACTACT	GACTACTA
GTATCCCG	GTTTCCCG
GTATCCCT	GTACCCTG
GGCTTTAA	GCTTTAAA
GTATCCTC	GAATCCTC
GTATCCTG	GTACCCTG
GTACACCT	GTACCCTG
GTATCGAT	GATCGATA
GTACACTG	GTACCCTG
GTATCGGA	GTACGGAT
GTACTCCT	GTACCCTG
GTACTCTG	GTACCCTG
GTACAGAT	GTACGGAT
GTACAGGA	GTACGGAT
GTACTGAT	GTACGGAT
GTACTGGA	GTACGGAT
GGTTCCCG	GTTTCCCG
GTACTTCT	GCACTTCT
GTACCACC	TACCACCA
GTACCACT	GTACCCTG
GTACCATG	GTACCCTG
GTACCCAG	GTACCCTG
GTACCCAT	GTACCCTG
GTACCCCG	GTACCCTG
GTACCCCT	GTACCCTG
GTACCCGA	GTACCCTG
GTACCCGC	GTACCCTG
GTACCCGG	GTACCCTG
GTACCCGT	GTACCCTG
GTACCCGN	GTACCCTG
GTACCCTA	GTACCCTG
GTACCCTC	GTACCCTG
GTACCCTG	GTACCCTG
GTACCCTT	GTACCCTG
GTACCCTN	GTACCCTG
GTACCCNG	GTACCCTG
GTACCCNT	GTACCCTG
GTATGCAT	GTTTGCAT
GTACCGAT	GTACGGAT
GTACCGCT	GTACCCTG
GTACCGGA	GTACGGAT
GTATGGAT	GTACGGAT
GTACNCCT	GTACCCTG
GTACNCTG	GTACCCTG
GTACCGTG	GTACCCTG
GTACNGAT	GTACGGAT
GTACNGGA	GTACGGAT
GTACCTCT	GTACCCTG
GTACCTGA	GTACCCTG
GTACCTGC	GTACCCTG
GTACCTGG	GTACCCTG
GTACCTGT	GTACCCTG
GTACCTGN	GTACCCTG
GTACCTTG	GTACCCTG
GTACCNCT	GTACCCTG
GTACCNTG	GTACCCTG
GTAGAAGG	GAGAAGGG
GTGGTACA	GTGGACAA
GTAGACAA	GTGGACAA
GTATTCCC	GTTTCCCG
GTGGTCAA	GTGGACAA
GTATTGCA	GTTTGCAT
GTCCCCTG	GTACCCTG
GTCCCCTT	GCCCCTTT
GTAGAGCC	GAGAGCCG
GTCCCTGA	GTACCCTG
GTCCCTGC	GTACCCTG
GTCCCTGG	GTACCCTG
GTATTTCC	ATATTTCC
GTCCCTGT	GTACCCTG
GTCCCTGN	GTACCCTG
GTCCCTTT	GCCCCTTT
GTGGNACA	GTGGACAA
GTCAAACC	GTCAAGCC
GTGGNCAA	GTGGACAA
GTCAAAGC	GTCAAGCC
GTCAAAGT	GCAAAGTA
GTCAACCA	GTCAAGCC
GTCAACCC	GTCAAGCC
GTCAACCG	GTCAAGCC
GTCAACCT	GTCAAGCC
GTCAACCN	GTCAAGCC
GTCAACGC	GTCAAGCC
GTCCGCTA	TCCGCTAG
GTCCGGAT	GTACGGAT
GTCAAGAC	GTCAAGCC
GTCAAGCA	GTCAAGCC
GTCAAGCC	GTCAAGCC
GTCAAGCG	GTCAAGCC
GTCAAGCT	GTCAAGCC
GTCAAGCN	GTCAAGCC
GTCAAGGC	GTCAAGCC
GTCAAGTC	GTCAAGCC
GTCCGGGT	GCCGGGTC
GTCAAGNC	GTCAAGCC
GTCAATCC	GTCAAGCC
GTCAATGC	GTCAAGCC
GTCAANCC	GTCAAGCC
GTCAANGC	GTCAAGCC
GTCACAGC	GTCAAGCC
GTAGCATT	CTAGCATT
GTCACCCT	GTACCCTG
GTCACGCC	GTCAAGCC
GTCACGGA	GTACGGAT
GTAGCCCT	GTACCCTG
GTCACTTC	GCACTTCT
GTAGCCTG	GTACCCTG
GTGTAAGC	TTGTAAGC
GTGTACAA	GTGGACAA
GTAGCGGA	GTACGGAT
GTAGCGTA	TAGCGTAA
GTCAGAAA	TCAGAAAC
GTGTAGGT	GCGTAGGT
GTCAGAGC	GTCAAGCC
GTCCTTAG	GCCTTAGT
GTCCTTCA	TCCTTCAC
GTCAGCCA	GTCAAGCC
GTCAGCCC	GTCAAGCC
GTAGCTCG	CTAGCTCG
GTANCCCT	GTACCCTG
GTCAGCCG	GTCAAGCC
GTANCCTG	GTACCCTG
GTCAGCCT	GTCAAGCC
GTCAGCCN	GTCAAGCC
GTANCGGA	GTACGGAT
GTCAGGCC	GTCAAGCC
GTCAGGTC	TCAGGTCT
GTAGGACA	GTGGACAA
GTAGGATA	GTACGGAT
GTAGGATC	GTACGGAT
GTAGGATG	GTACGGAT
GTAGGATT	GTACGGAT
GTAGGATN	GTACGGAT
GTAGGCCC	CTAGGCCC
GTGTCCCG	GTTTCCCG
GTAGGGAT	GTACGGAT
GTCATAGC	GTCAAGCC
GTGTCGTA	ATGTCGTA
GTCATGCC	GTCAAGCC
GTAGTATG	TAGTATGG
GTGTCTGA	TGTCTGAC
GTANGGAT	GTACGGAT
GTCGAAGC	GTCAAGCC
GTCGACAA	GTGGACAA
GTAGTGTT	GAGTGTTC
GTGTGACA	GTGGACAA
GTGTGCAT	GTTTGCAT
GTCGAGCC	GTCAAGCC
GTCANAGC	GTCAAGCC
GTGCAAGC	GTCAAGCC
GTGTGGGG	TGTGGGGT
GTCGATAA	GATCGATA
GTCGATAC	GATCGATA
GTCGATAG	GATCGATA
GTCGATAT	GATCGATA
GTGCACAA	GTGGACAA
GTCGATAN	GATCGATA
GTGCACGA	TTGCACGA
GTGTGTTC	GAGTGTTC
GTCANGCC	GTCAAGCC
GTCGCCCA	GCTCGCCC
GTCGCCCC	GCTCGCCC
GTCGCCCG	GCTCGCCC
GTCGCCCT	GCTCGCCC
GTCGCCCN	GCTCGCCC
GTGTTCCC	GTTTCCCG
GTGTTGCA	GTTTGCAT
GTGTTTTG	TGTTTTGA
GTGCCCTG	GTACCCTG
GTTCAAGC	GTCAAGCC
GTTCAAGG	ATTCAAGG
GTCCAACG	TCCAACGA
GTCCAAGC	GTCAAGCC
GTCCAGCC	GTCAAGCC
GTCGGACA	GTGGACAA
GTCGGATA	GTACGGAT
GTCGGATC	GTACGGAT
GTCGGATG	GTACGGAT
GTCGGATT	GTACGGAT
GTCGGATN	GTACGGAT
GTCGGCAG	TTCGGCAG
GTGCGACA	GTGGACAA
GTCGGGTC	GCCGGGTC
GTTCCCCG	GTTTCCCG
GTTCCCGA	GTTTCCCG
GTTCCCGC	GTTTCCCG
GTTCCCGG	GTTTCCCG
GTTCCCGT	GTTTCCCG
GTTCCCGN	GTTTCCCG
GTTCCCTG	GTACCCTG
GTTGGACA	GTGGACAA
GTGCGGAC	TGCGGACT
GTGCGGAT	GTACGGAT
GTTGGCAT	GTTTGCAT
GTGNACAA	GTGGACAA
GTCGTAGG	GCGTAGGT
GTGNGACA	GTGGACAA
GTTCCTGC	ATTCCTGC
GTTGTAAG	TTGTAAGC
GTTGTCCC	GTTTCCCG
GTCTAACT	GACTAACT
GTCTAAGC	GTCAAGCC
GTTGTGCA	GTTTGCAT
GTTGTGGC	TTTGTGGC
GTGAACAA	GTGGACAA
GTGAACTG	TGAACTGT
GTCTACAT	TTCTACAT
GTTCGATA	GATCGATA
GTTCGCAT	GTTTGCAT
GTCTACTA	GACTACTA
GTTCGCCC	GCTCGCCC
GTGAAGCC	GTCAAGCC
GTGAAGGG	GAGAAGGG
GTCTAGCC	GTCAAGCC
GTTCGGAT	GTACGGAT
GTTNCCCG	GTTTCCCG
GTTCGGCA	TTCGGCAG
GTTTAAAA	GCTTTAAA
GTTTAAAC	GCTTTAAA
GTTTAAAG	GCTTTAAA
GTTTAAAT	GCTTTAAA
GTGGAAAA	GTGGACAA
GTTTAAAN	GCTTTAAA
GTGGAAAC	GTGGACAA
GTTTACAT	GTTTGCAT
GTTTACCC	GTTTCCCG
GTTTACCG	GTTTCCCG
GTGGAAAG	GTGGACAA
GTGGAAAT	GTGGACAA
GTGGAAAN	GTGGACAA
GTGACAAA	GTGGACAA
GTGGAACA	GTGGACAA
GTGACAAC	GTGGACAA
GTGACAAG	GTGGACAA
GTGACAAT	GTGGACAA
GTGACAAN	GTGGACAA
GTTTAGCA	GTTTGCAT
GTGGACAA	GTGGACAA
GTGGACAC	GTGGACAA
GTGGACAG	GTGGACAA
GTTNGCAT	GTTTGCAT
GTGGACAT	GTGGACAA
GTGGACAN	GTGGACAA
GTGGACCA	GTGGACAA
GTGACCCT	GTACCCTG
GTTCTACA	TTCTACAT
GTGACGGA	GTACGGAT
GTGGACGA	GTGGACAA
GTGGACTA	GTGGACAA
GTCTCCCG	GTTTCCCG
GTCTCCGG	TCTCCGGG
GTGGACNA	GTGGACAA
GTGGAGAA	GTGGACAA
GTGGAGCA	GTGGACAA
GNAATCCT	GAATCCTC
GTTTCACC	GTTTCCCG
GTTTCACG	GTTTCCCG
GTTCTCCC	GTTTCCCG
GTCTCGCC	GCTCGCCC
GTTCTCTA	CTTCTCTA
GTTTCATA	GTTTGCAT
GTTTCATC	GTTTGCAT
GTTTCATG	GTTTGCAT
GTTTCATT	GTTTGCAT
GTTTCATN	GTTTGCAT
GTTCTGCA	GTTTGCAT
GTTTCCAC	GTTTCCCG
GTGGATAA	GTGGACAA
GTTTCCAG	GTTTCCCG
GTTTCCAT	GTTTGCAT
GTTTCCCA	GTTTCCCG
GTTTCCCC	GTTTCCCG
GTTTCCCG	GTTTCCCG
GTTTCCCT	GTTTCCCG
GTTTCCCN	GTTTCCCG
GTTTCCGA	GTTTCCCG
GTTTCCGC	GTTTCCCG
GTGGATCA	GTGGACAA
GTTTCCGG	GTTTCCCG
GTTTCCGT	GTTTCCCG
GTTTCCGN	GTTTCCCG
GTTTCCTC	GTTTCCCG
GTTTCCTG	GTTTCCCG
GTTTCCNC	GTTTCCCG
GTTTCCNG	GTTTCCCG
GTGGANAA	GTGGACAA
GTTTCGCA	GTTTGCAT
GTTTCGCC	GTTTCCCG
GTTTCGCG	GTTTCCCG
GTTTCTCC	GTTTCCCG
GTTTCTCG	GTTTCCCG
GTGAGACA	GTGGACAA
GTTNTCCC	GTTTCCCG
GTGGANCA	GTGGACAA
GTTTCNCC	GTTTCCCG
GTTTCNCG	GTTTCCCG
GTTNTGCA	GTTTGCAT
GTCTGACA	TGTCTGAC
GTCTGACG	TGTCTGAC
GTCTGACT	TGTCTGAC
GTGGCAAA	GTGGACAA
GTTTGAAT	GTTTGCAT
GTGGCAAC	GTGGACAA
GTGGCAAG	GTGGACAA
GTGGCAAT	GTGGACAA
GTTTGACA	GTTTGCAT
GTGGCAAN	GTGGACAA
GTCTGACN	TGTCTGAC
GTTTGATA	GTTTGCAT
GTTTGATC	GTTTGCAT
GTTTGATG	GTTTGCAT
GTTTGATT	GTTTGCAT
GTTTGATN	GTTTGCAT
GTGAGCCG	GAGAGCCG
GTGGCACA	GTGGACAA
GTTTGCAA	GTTTGCAT
GTCTGCAT	GTTTGCAT
GTTTGCAC	GTTTGCAT
GTTTGCAG	GTTTGCAT
GTTTGCAT	GTTTGCAT
GTTTGCAN	GTTTGCAT
GTTTGCCA	GTTTGCAT
GTTTGCCC	GTTTCCCG
GTTTGCCG	GTTTCCCG
GTTTGCCT	GTTTGCAT
GTTTGCGA	GTTTGCAT
GTTTGCGT	GTTTGCAT
GTTTGCTA	GTTTGCAT
GTTTGCTC	GTTTGCAT
GTTTGCTG	GTTTGCAT
GTTTGCTT	GTTTGCAT
GTTTGCTN	GTTTGCAT
GTTTGCNA	GTTTGCAT
GTTTGCNT	GTTTGCAT
GTTTGGAT	GTTTGCAT
GTTTGGCA	GTTTGCAT
GTGGCCAA	GTGGACAA
GTTTGTAT	GTTTGCAT
GTTTGTCA	GTTTGCAT
GTTTGTGG	TTTGTGGC
GTTTGNAT	GTTTGCAT
GTTTGNCA	GTTTGCAT
GTTTTAAA	GCTTTAAA
GTGAGTTA	TTGAGTTA
GTTTTCAT	GTTTGCAT
GTTTTCCC	GTTTCCCG
GTTTTCCG	GTTTCCCG
GTTTTGAA	TGTTTTGA
GTTTTGAC	TGTTTTGA
GTTTTGAG	TGTTTTGA
GTTTTGAT	TGTTTTGA
GTTTTGAN	TGTTTTGA
GTTTTGCA	GTTTGCAT
GTCTTAGT	GCCTTAGT
GTCTTCCC	GTTTCCCG
GTGATCCC	TGATCCCT
GTGGCGCA	TGGCGCAT
GTTAACCC	TTAACCCC
GTCTTGCA	GTTTGCAT
GTCTTGGA	TCTTGGAG
GTTGACAA	GTGGACAA
GTTAAGCC	GTCAAGCC
GTCTTTAA	GCTTTAAA
GTNAAGCC	GTCAAGCC
GTTAATGC	CTTAATGC
GTTTNCAT	GTTTGCAT
GTTTNCCC	GTTTCCCG
GTTTNCCG	GTTTCCCG
GTTGAGTT	TTGAGTTA
GTGGGACA	GTGGACAA
GTTTNGCA	GTTTGCAT
GTNACCCT	GTACCCTG
GTNACGGA	GTACGGAT
GTGGGATC	CTGGGATC
GTGGGCAA	GTGGACAA
GTTACCAA	CTTACCAA
GTTACCCG	GTTTCCCG
GTTACCCT	GTACCCTG
GTTGCACG	TTGCACGA
GTTGCATA	GTTTGCAT
GTGGGGTA	TGTGGGGT
GNACCCTG	GTACCCTG
GTGGGGTC	TGTGGGGT
GTGGGGTG	TGTGGGGT
GTGGGGTT	TGTGGGGT
GTTGCATC	GTTTGCAT
GTGGGGTN	TGTGGGGT
GTTGCATG	GTTTGCAT
GTTGCATT	GTTTGCAT
GTTGCATN	GTTTGCAT
GTTGCCCG	GTTTCCCG
GTTACGGA	GTACGGAT
GTCNAAGC	GTCAAGCC
GTCNAGCC	GTCAAGCC
GTTAGCAT	GTTTGCAT
GNACGGAT	GTACGGAT
GNCACTTC	GCACTTCT
GTNGGACA	GTGGACAA
GNACTAAC	GACTAACT
GNACTACT	GACTACTA
GTTATCCC	GTTTCCCG
GTTATGCA	GTTTGCAT
GNACTTCT	GCACTTCT
GNAGAAGG	GAGAAGGG
GNAGAGCC	GAGAGCCG
GTNTCCCG	GTTTCCCG
GTNCAAGC	GTCAAGCC
GNCGGGTC	GCCGGGTC
GNCGTAGG	GCGTAGGT
GNCCCCTT	GCCCCTTT
GNGTGTTC	GAGTGTTC
GNCCCTTT	GCCCCTTT
GTNTGCAT	GTTTGCAT
GTNCCCTG	GTACCCTG
GNCTAACT	GACTAACT
GNAAAGTA	GCAAAGTA
GNCTACTA	GACTACTA
GNAGTGTT	GAGTGTTC
GNCCGGGT	GCCGGGTC
GNCTCGCC	GCTCGCCC
GTNTTCCC	GTTTCCCG
GTNCGGAT	GTACGGAT
GTNTTGCA	GTTTGCAT
GNCCTTAG	GCCTTAGT
GNGAAGGG	GAGAAGGG
GNATCCTC	GAATCCTC
GNATCGAT	GATCGATA
GNGGACAA	GTGGACAA
GNTTCCCG	GTTTCCCG
GNCAAAGT	GCAAAGTA
GNCAAGCC	GTCAAGCC
GTNGACAA	GTGGACAA
GNTTGCAT	GTTTGCAT
GNGAGCCG	GAGAGCCG
GNTCGATA	GATCGATA
GNTCGCCC	GCTCGCCC
GNTTTAAA	GCTTTAAA
GNTTTCCC	GTTTCCCG
GNTTTGCA	GTTTGCAT
TAACAAGT	AAACAAGT
TAACACCA	TACCACCA
GNTACCCT	GTACCCTG
GNTACGGA	GTACGGAT
TAACAGGA	TAAAGGAT
GNCTTAGT	GCCTTAGT
TAACATAT	TAATATAT
GNGTAGGT	GCGTAGGT
GNCTTTAA	GCTTTAAA
TAACCACC	TACCACCA
TAACCCCA	TTAACCCC
TAACCCCC	TTAACCCC
TAACCCCG	TTAACCCC
TAACCCCT	TTAACCCC
TAACCCCN	TTAACCCC
TAACCCGC	AACCCGCG
TAACCGAG	TAATCGAG
TAACCTTT	AAACCTTT
TAACGAGA	TAATCGAG
TAACGAGC	TAATCGAG
TAACGAGG	TAATCGAG
TAACGAGT	TAATCGAG
TAACGAGN	TAATCGAG
GNTCAAGC	GTCAAGCC
TACGGACT	TGCGGACT
TACGGATA	GTACGGAT
TACGGATC	GTACGGAT
TACGGATG	GTACGGAT
TAACGGAT	TAAAGGAT
TACGGATT	GTACGGAT
TACGGATN	GTACGGAT
TACGGCAG	TTCGGCAG
TACGGCAT	CACGGCAT
TAACGTAA	TAGCGTAA
GNTGGACA	GTGGACAA
TAACTATA	TAATATAT
TAACTCGA	TAATCGAG
TACGTAAA	TAGCGTAA
TACGTAAC	TAGCGTAA
TACGTAAG	TAGCGTAA
TACGTAAT	TAGCGTAA
TACGTAAN	TAGCGTAA
TAACTGTA	TGAACTGT
TAACTGTC	TGAACTGT
TAACTGTG	TGAACTGT
TAACTGTT	TGAACTGT
TAACTGTN	TGAACTGT
TACGTATG	TAGTATGG
TAACTTGT	AACTTGTA
TAAAAGAT	TAAAGGAT
TAAAAGGA	TAAAGGAT
TAAAATAT	TAATATAT
TACCAACA	TACCACCA
TACCAACC	TACCACCA
TACCAACG	TCCAACGA
TACCACAA	TACCACCA
TACCACAC	TACCACCA
TACCACAG	TACCACCA
TACCACAT	TACCACCA
TACCACAN	TACCACCA
TACCACCA	TACCACCA
TACCACCC	TACCACCA
TACCACCG	TACCACCA
TAAACAAG	AAACAAGT
TACCACCT	TACCACCA
TACCACCN	TACCACCA
TAAGAAAC	TCAGAAAC
TACCACGA	TACCACCA
TACCACGC	TACCACCA
TAAGAAAT	AAGAAATC
TAAGAACA	CTAAGAAC
TAAGAACC	CTAAGAAC
TACCACTA	TACCACCA
TAAGAACG	CTAAGAAC
TACCACTC	TACCACCA
TAAGAACT	CTAAGAAC
TAAGAACN	CTAAGAAC
TACCACNA	TACCACCA
TACCACNC	TACCACCA
TACCAGCA	TACCACCA
TACCAGCC	TACCACCA
TAAACCCC	TTAACCCC
TAAGTATA	TAATATAT
TAAGTATG	TAGTATGG
TAAGTCGA	TAATCGAG
TAAGAGGA	TAAAGGAT
TAAACCTT	AAACCTTT
TACCATCA	TACCACCA
TACCATCC	TACCACCA
TAAACGAG	TAATCGAG
TAAACGAT	TAAAGGAT
TAAGATAT	TAATATAT
TAAACGGA	TAAAGGAT
TACCANCA	TACCACCA
TACCANCC	TACCACCA
TAAACTGT	TGAACTGT
TAAGCAGG	AAGCAGGC
TACTAACT	GACTAACT
TAAGTTGC	AAGTTGCC
TACTACAT	TTCTACAT
TACTACCA	TACCACCA
TACTACTA	GACTACTA
TAAGCGAG	TAATCGAG
TACCCACC	TACCACCA
TACTATAT	TAATATAT
TACTATGG	TAGTATGG
TAAAGAAT	TAAAGGAT
TAAGCGTA	TAGCGTAA
TAAAGAGA	TAAAGGAT
TAAAGATA	TAAAGGAT
TACCCCAA	TACCACCA
TACTCACC	TACCACCA
TACCCCAC	TACCACCA
TACCCCAG	TACCACCA
TACCCCAT	TACCACCA
TACCCCAN	TACCACCA
TACCCCCA	TACCACCA
TAANCGAG	TAATCGAG
TAAAGATC	TAAAGGAT
TAAAGATG	TAAAGGAT
TAAAGATT	TAAAGGAT
TAAAGATN	TAAAGGAT
TACTCCGG	TCTCCGGG
TAAAGCAT	TAAAGGAT
TACCCGCG	AACCCGCG
TAAAGCCA	CAAAGCCA
TACTCGAG	TAATCGAG
TAAAGCGA	TAAAGGAT
TACCCTGA	GTACCCTG
TACCCTGC	GTACCCTG
TACCCTGG	GTACCCTG
TACCCTGT	GTACCCTG
TACCCTGN	GTACCCTG
TACCCTTG	ACCCTTGG
TAAAGGAA	TAAAGGAT
TAAAGGAC	TAAAGGAT
TAAAGGAG	TAAAGGAT
TAAAGGAT	TAAAGGAT
TAAAGGAN	TAAAGGAT
TAAAGGCA	TAAAGGAT
TAAAGGCT	TAAAGGAT
TAAAGGGA	TAAAGGAT
TAAGGATA	TAAAGGAT
TAATAAAT	TAATATAT
TAAGGATC	TAAAGGAT
TAAAGGGT	TAAAGGAT
TAAGGATG	TAAAGGAT
TAAGGATT	TAAAGGAT
TAAAGGTA	TAAAGGAT
TAAGGATN	TAAAGGAT
TAAAGGTC	TAAAGGAT
TAAAGGTG	TAAAGGAT
TAAAGGTT	TAAAGGAT
TAATAATA	TAATATAT
TAATAATC	TAATATAT
TAATAATG	TAATATAT
TAATAATT	TAATATAT
TAATAATN	TAATATAT
TAATACAT	TAATATAT
TAAAGGTN	TAAAGGAT
TAAAGGNA	TAAAGGAT
TAATACGA	TAATCGAG
TAAAGGNT	TAAAGGAT
TAATACTA	TAATATAT
TAAAGTAT	TAAAGGAT
TAATAGAG	TAATCGAG
TAATAGAT	TAATATAT
TACCGACC	TACCACCA
TAATAGGA	TAAAGGAT
TAATAGTA	TAATATAT
TAAAGTGA	TAAAGGAT
TAATATAA	TAATATAT
TAATATAC	TAATATAT
TAATATAG	TAATATAT
TAATATAT	TAATATAT
TAATATAN	TAATATAT
TAATATCA	TAATATAT
TAATATCT	TAATATAT
TACCGCCA	TACCACCA
TAATATGA	TAATATAT
TAATATGG	TAGTATGG
TAATATGT	TAATATAT
TAATATTA	TAATATAT
TAAGGGAG	AAGGGAGT
TAATATTC	TAATATAT
TAAGGGAT	TAAAGGAT
TAATATTG	TAATATAT
TAATATTT	TAATATAT
TAANGGAT	TAAAGGAT
TAATATTN	TAATATAT
TAATATNA	TAATATAT
TAATATNT	TAATATAT
TAATANAT	TAATATAT
TAAAGNAT	TAAAGGAT
TAAAGNGA	TAAAGGAT
TAATANTA	TAATATAT
TAATCAAG	TAATCGAG
TAATCAGA	TAATCGAG
TAATCAGC	TAATCGAG
TAATCAGG	TAATCGAG
TAATCAGT	TAATCGAG
TAATCAGN	TAATCGAG
TAATCATA	TAATATAT
TACCGCTA	TCCGCTAG
TAATCCAG	TAATCGAG
TAATCCCT	TGATCCCT
TAATCCGA	TAATCGAG
TAATCCTC	GAATCCTC
TAAATATA	TAATATAT
TAAATATC	TAATATAT
TAAATATG	TAATATAT
TAAATATT	TAATATAT
TAAATATN	TAATATAT
TACCGGTA	ACCGGTAA
TACTTCAC	TCCTTCAC
TAATCGAA	TAATCGAG
TAATCGAC	TAATCGAG
TAATCGAG	TAATCGAG
TAATCGAT	TAATCGAG
TAATCGAN	TAATCGAG
TAATCGCA	TAATCGAG
TAATCGCG	TAATCGAG
TAAGGTCT	TCAGGTCT
TAAATCGA	TAATCGAG
TACCGTAA	TAGCGTAA
TAATCGGA	TAATCGAG
TAATCGGC	TAATCGAG
TAATCGGG	TAATCGAG
TAATCGGT	TAATCGAG
TAATCGGN	TAATCGAG
TAATCGTA	TAATCGAG
TAATCGTG	TAATCGAG
TAATCGNA	TAATCGAG
TAATCGNG	TAATCGAG
TAATCTAG	TAATCGAG
TAATCTAT	TAATATAT
TAATCTGA	TAATCGAG
TAANTATA	TAATATAT
TAAATGAT	TAAAGGAT
TAATCNAG	TAATCGAG
TACTTGGA	TCTTGGAG
TAATCNGA	TAATCGAG
TACTTGTA	AACTTGTA
TAGTNATG	TAGTATGG
TAANTCGA	TAATCGAG
TAAATGGA	TAAAGGAT
TAATGAGA	TAATCGAG
TAATGAGC	TAATCGAG
TAATGAGG	TAATCGAG
TAATGAGT	TAATCGAG
TAATGAGN	TAATCGAG
TAATGATA	TAATATAT
TACCTACC	TACCACCA
TAGTNTGG	TAGTATGG
TAATGCGA	TAATCGAG
TAATGGAG	TAATCGAG
TAATGGAT	TAAAGGAT
TAATGGTC	AATGGTCA
TAATGTAT	TAATATAT
TACCTCCA	TACCACCA
TAATTATA	TAATATAT
TAATTATC	TAATATAT
TAATTATG	TAATATAT
TAATTATT	TAATATAT
TAATTATN	TAATATAT
TAATTCGA	TAATCGAG
TAATTGAG	TAATCGAG
TACCTTCA	TCCTTCAC
TAGNATGG	TAGTATGG
TAATTTAT	TAATATAT
TAAANGAT	TAAAGGAT
TACAACCA	TACCACCA
TACAACGA	TCCAACGA
TACAACGC	ACAACGCG
TAAANGGA	TAAAGGAT
TACAAGGA	TAAAGGAT
TACAATTA	ACAATTAG
TACCNACC	TACCACCA
TAATNATA	TAATATAT
TACCNCCA	TACCACCA
TAGNCGTA	TAGCGTAA
TACACACC	TACCACCA
TAATNCGA	TAATCGAG
TAATNGAG	TAATCGAG
TACACCAA	TACCACCA
TACACCAC	TACCACCA
TACACCAG	TACCACCA
TACACCAT	TACCACCA
TACACCAN	TACCACCA
TAATNTAT	TAATATAT
TACGACCA	TACCACCA
TAGNGTAA	TAGCGTAA
TACAGAAA	TCAGAAAC
TACGAGAG	ACGAGAGT
TAGGCCCA	CTAGGCCC
TAGGCCCC	CTAGGCCC
TAGGCCCG	CTAGGCCC
TAGGCCCT	CTAGGCCC
TAGGCCCN	CTAGGCCC
TACAGGAT	TAAAGGAT
TAANAGGA	TAAAGGAT
TACAGGTC	TCAGGTCT
TAGNTATG	TAGTATGG
TAANATAT	TAATATAT
TACGCACC	TACCACCA
TAGGCGCA	TGGCGCAT
TAGGCGTA	TAGCGTAA
TANAGGAT	TAAAGGAT
TACGCGTA	TAGCGTAA
TACATATA	TAATATAT
TACGCTAG	TCCGCTAG
TACGCTCC	ACGCTCCT
TACATCGA	TAATCGAG
TACATCGT	ACATCGTT
TATAGGAT	TAAAGGAT
TATTTCCA	ATATTTCC
TATTTCCC	ATATTTCC
TATTTCCG	ATATTTCC
TATTTCCT	ATATTTCC
TATTTCCN	ATATTTCC
TATATAAC	ATATAACT
TATATATA	TAATATAT
TATATATC	TAATATAT
TATATATG	TAATATAT
TATATATT	TAATATAT
TATATATN	TAATATAT
TATTTTGA	TGTTTTGA
TATATCGA	TAATCGAG
TATATGGA	TAGTATGG
TATATGGC	TAGTATGG
TATATGGG	TAGTATGG
TATATGGT	TAGTATGG
TATATGGN	TAGTATGG
TAGGGAGT	AAGGGAGT
TANATATA	TAATATAT
TATATTTC	ATATTTCC
TAGGGCCA	AGGGCCAA
TANATCGA	TAATCGAG
TATGAGTT	TTGAGTTA
TATAACCC	TTAACCCC
TATAACTA	ATATAACT
TATAACTC	ATATAACT
TATAACTG	ATATAACT
TATAACTT	ATATAACT
TATAACTN	ATATAACT
TATAAGGA	TAAAGGAT
TATGCACG	TTGCACGA
TAGGGTAA	TAGCGTAA
TAGGGTCG	AGGGTCGG
TAGATATA	TAATATAT
TAGATATG	TAGTATGG
TAGATCCC	TGATCCCT
TAGATCGA	TAATCGAG
TATCACCA	TACCACCA
TAGGTAAA	TAGCGTAA
TAGGTAAC	TAGCGTAA
TAGGTAAG	TAGCGTAA
TAGGTAAT	TAGCGTAA
TAGGTAAN	TAGCGTAA
TAGATGGA	TAGTATGG
TAGATGGC	TAGTATGG
TAGATGGG	TAGTATGG
TAGATGGT	TAGTATGG
TAGATGGN	TAGTATGG
TAGGTATG	TAGTATGG
TANCACCA	TACCACCA
TATGCGTA	TAGCGTAA
TAGGTCTA	TCAGGTCT
TAGGTCTC	TCAGGTCT
TAGGTCTG	TCAGGTCT
TAGGTCTT	TCAGGTCT
TAGGTCTN	TCAGGTCT
TATCCACC	TACCACCA
TCACTTCA	TCCTTCAC
TANCCACC	TACCACCA
TCACTTCT	GCACTTCT
TATCCCTA	TGATCCCT
TATCCCTC	TGATCCCT
TATCCCTG	TGATCCCT
TATCCCTT	TGATCCCT
TATCCCTN	TGATCCCT
TATCCGAG	CATCCGAG
TATCCGGG	TCTCCGGG
TATGGGGT	TGTGGGGT
TATGGTCA	AATGGTCA
TAGCACCA	TACCACCA
TAGCACGA	TTGCACGA
TATCGAGA	TAATCGAG
TATCGAGC	TAATCGAG
TATCGAGG	TAATCGAG
TATCGAGT	TAATCGAG
TATCGAGN	TAATCGAG
TATCGATA	GATCGATA
TAGCAGGC	AAGCAGGC
TATGTAAG	TTGTAAGC
TAGCAGTA	TAGCGTAA
TAGTAAGC	TTGTAAGC
TAGTAAGG	TAGTATGG
TATGTATG	TAGTATGG
TAGCATAA	TAGCGTAA
TAGTAATG	TAGTATGG
TATCGGCA	TTCGGCAG
TAGCATGG	TAGTATGG
TAGCATTA	CTAGCATT
TAGCATTC	CTAGCATT
TATGTCGT	ATGTCGTA
TAGCATTG	CTAGCATT
TAGCATTT	CTAGCATT
TAGCATTN	CTAGCATT
TAGTACGG	TAGTATGG
TAGTACTG	TAGTATGG
TATCGTAA	TAGCGTAA
TATGTGGC	TTTGTGGC
TAGTAGGA	TAGTATGG
TAGTAGGC	TAGTATGG
TAGTAGGG	TAGTATGG
TAGTAGGT	TAGTATGG
TAGTAGGN	TAGTATGG
TAGTAGTG	TAGTATGG
TAGTATAG	TAGTATGG
TAGTATAT	TAATATAT
TAGTATCG	TAGTATGG
TAGTATGA	TAGTATGG
TAGTATGC	TAGTATGG
TAGTATGG	TAGTATGG
TAGTATGT	TAGTATGG
TAGTATGN	TAGTATGG
TAGTATTG	TAGTATGG
TANCGTAA	TAGCGTAA
TAGTATNG	TAGTATGG
TAGCCACC	TACCACCA
TAGTANGG	TAGTATGG
TATCTACA	TTCTACAT
TAGTANTG	TAGTATGG
TAGTCATG	TAGTATGG
TAGTCGAG	TAATCGAG
TAGTCGTA	TAGCGTAA
TAGTCTGA	TGTCTGAC
TAGTCTGG	TAGTATGG
TAGCCGTA	TAGCGTAA
TCAGAAAA	TCAGAAAC
TCAGAAAC	TCAGAAAC
TCAGAAAG	TCAGAAAC
TAGCCTAA	TAGCGTAA
TCAGAAAT	TCAGAAAC
TCAGAAAN	TCAGAAAC
TCAGAACA	TCAGAAAC
TCAGAACC	TCAGAAAC
TCAGAACG	TCAGAAAC
TCAGAACT	TCAGAAAC
TAGTGATG	TAGTATGG
TCAGAACN	TCAGAAAC
TCAGAAGA	TCAGAAAC
TCAGAAGC	TCAGAAAC
TCAGAATA	TCAGAAAC
TCAGAATC	TCAGAAAC
TAGCGAAA	TAGCGTAA
TAGCGAAC	TAGCGTAA
TAGCGAAG	TAGCGTAA
TAGCGAAT	TAGCGTAA
TAGCGAAN	TAGCGTAA
TAGCGATA	TAGCGTAA
TCAGAANA	TCAGAAAC
TCAGAANC	TCAGAAAC
TCAGACAA	TCAGAAAC
TCAGACAC	TCAGAAAC
TAGCGCAA	TAGCGTAA
TAGCGCAT	TGGCGCAT
TAGCGCTA	TAGCGTAA
TCAGAGAA	TCAGAAAC
TCAGAGAC	TCAGAAAC
TAGTGGGG	TGTGGGGT
TAGTGTAA	TAGCGTAA
TAGTGTGG	TAGTATGG
TAGTGTTC	GAGTGTTC
TACNACCA	TACCACCA
TAGCGGAA	TAGCGTAA
TAGCGGAC	TGCGGACT
TCCTAACG	TCCAACGA
TCAGAGTC	TCAGGTCT
TCAGATAA	TCAGAAAC
TCAGATAC	TCAGAAAC
TAGCGGTA	TAGCGTAA
TAGCGTAA	TAGCGTAA
TAGCGTAC	TAGCGTAA
TAGCGTAG	TAGCGTAA
TCAGATCT	TCAGGTCT
TAGCGTAT	TAGCGTAA
TAGCGTAN	TAGCGTAA
TAGCGTCA	TAGCGTAA
TCCTACAC	TCCTTCAC
TCCTACAT	TTCTACAT
TCCTACGA	TCCAACGA
TAGCGTGA	TAGCGTAA
TAGTTATG	TAGTATGG
TAGCGTTA	TAGCGTAA
TAGCGTTT	AGCGTTTC
TAGCGTNA	TAGCGTAA
TAGCGNAA	TAGCGTAA
TCAGANAA	TCAGAAAC
TCAGANAC	TCAGAAAC
TATTATAT	TAATATAT
TATTATGG	TAGTATGG
TAGTTGCC	AAGTTGCC
TAGTTGGA	TAGTATGG
TAGTTGGC	TAGTATGG
TAGCGNTA	TAGCGTAA
TAGTTGGG	TAGTATGG
TAGTTGGT	TAGTATGG
TAGTTGGN	TAGTATGG
TCAGCAAA	TCAGAAAC
TAGCTAAA	TAGCGTAA
TCAGCAAC	TCAGAAAC
TAGCTAAC	TAGCGTAA
TAGCTAAG	TAGCGTAA
TAGCTAAT	TAGCGTAA
TAGCTAAN	TAGCGTAA
TAGCTATG	TAGTATGG
TATTCAAG	ATTCAAGG
TAGCTCAG	CAGCTCAG
TCCTATCA	TCCTTCAC
TAGCTCGA	CTAGCTCG
TAGCTCGC	CTAGCTCG
TAGCTCGG	CTAGCTCG
TAGCTCGT	CTAGCTCG
TAGCTCGN	CTAGCTCG
TAGTTTGG	TAGTATGG
TAGTTTTG	TGTTTTGA
TCAGCGTA	TAGCGTAA
TCATCCCT	TGATCCCT
TCATCCGA	CATCCGAG
TCATCCGG	TCTCCGGG
TATTCCTG	ATTCCTGC
TCAGCGTC	TCAGGTCT
TAGCTGTA	TAGCGTAA
TATTCGAG	TAATCGAG
TCATCGAG	TAATCGAG
TACNCACC	TACCACCA
TCAGCTAG	TCCGCTAG
TCAGCTCA	CAGCTCAG
TCAGCTCT	TCAGGTCT
TAGCTTAA	TAGCGTAA
TCATCGTT	ACATCGTT
TCAAAAAC	TCAGAAAC
TCAAAACA	TCAGAAAC
TCAAAACC	TCAGAAAC
TCCTCACA	TCCTTCAC
TCCTCACC	TCCTTCAC
TCAAAACG	TCAGAAAC
TCCTCACG	TCCTTCAC
TCAAAACT	TCAGAAAC
TCCTCACT	TCCTTCAC
TCAAAACN	TCAGAAAC
TCCTCACN	TCCTTCAC
TCCTCCAC	TCCTTCAC
TCAAACGA	TCCAACGA
TCCTCCGG	TCTCCGGG
TCAGGAAA	TCAGAAAC
TCAGGAAC	TCAGAAAC
TCCTCGAT	CCTCGATT
TCAAAGCC	CAAAGCCA
TCAAAGGA	TAAAGGAT
TCAGGACT	TCAGGTCT
TCAAAGTA	GCAAAGTA
TCAGGATC	TCAGGTCT
TCCTCTAG	TCCGCTAG
TCCTCTCA	TCCTTCAC
TCATGAAA	TCAGAAAC
TCAGGCCT	TCAGGTCT
TCAGGCTA	TCAGGTCT
TCAGGCTC	TCAGGTCT
TCAGGCTG	TCAGGTCT
TCAGGCTT	TCAGGTCT
TCAGGCTN	TCAGGTCT
TCAGGGCT	TCAGGTCT
TCAGGGTC	TCAGGTCT
TCAAATGG	CCAAATGG
TCATGGAG	TCTTGGAG
TCAGGTAC	TCAGGTCT
TCAGGTAT	TCAGGTCT
TCAGGTCA	TCAGGTCT
TCAGGTCC	TCAGGTCT
TCAGGTCG	TCAGGTCT
TCAGGTCT	TCAGGTCT
TCAGGTCN	TCAGGTCT
TCAGGTGC	TCAGGTCT
TAGCNGTA	TAGCGTAA
TCAGGTGT	TCAGGTCT
TATTGGAG	TCTTGGAG
TCAGGTTA	TCAGGTCT
TCAGGTTC	TCAGGTCT
TCAGGTTG	TCAGGTCT
TCAGGTTT	TCAGGTCT
TCAGGTTN	TCAGGTCT
TCAGGTNC	TCAGGTCT
TCAGGTNT	TCAGGTCT
TAGCNTAA	TAGCGTAA
TCATGGTC	TCAGGTCT
TCAGGNCT	TCAGGTCT
TCCTGCAA	CCTGCAAG
TCCTGCAC	TCCTTCAC
TCAGGNTC	TCAGGTCT
TANAAGGA	TAAAGGAT
TCAGTAAA	TCAGAAAC
TCAGTAAC	TCAGAAAC
TCATGTCT	TCAGGTCT
TCAGTATG	TAGTATGG
TATTGTGG	TTTGTGGC
TCCTGCTA	TCCGCTAG
TCCTGGAG	TCTTGGAG
TCAGTCTA	TCAGGTCT
TCAGTCTC	TCAGGTCT
TCAGTCTG	TCAGGTCT
TCAGTCTT	TCAGGTCT
TCAGTCTN	TCAGGTCT
TCAACCCC	TTAACCCC
TCAGTGTC	TCAGGTCT
TCCTGTCA	TCCTTCAC
TCCTGTCG	CCCTGTCG
TCATTCAC	TCCTTCAC
TCCCGCTA	TCCGCTAG
TCAACGAA	TCCAACGA
TCAACGAC	TCCAACGA
TCAACGAG	TCCAACGA
TCAACGAT	TCCAACGA
TCAACGAN	TCCAACGA
TCAGTTCT	TCAGGTCT
TCCCGGGA	TCTCCGGG
TCCCGGGC	TCTCCGGG
TCCCGGGG	TCTCCGGG
TCCCGGGT	TCTCCGGG
TCCCGGGN	TCTCCGGG
TCAACGCG	ACAACGCG
TCCTTAAC	TCCTTCAC
TCCTTACA	TCCTTCAC
TCCTTACC	TCCTTCAC
TCCTTACG	TCCTTCAC
TCCTTACT	TCCTTCAC
TCCTTACN	TCCTTCAC
TCATTGGA	TCTTGGAG
TCAGNAAA	TCAGAAAC
TCAGNAAC	TCAGAAAC
TAGGATGG	TAGTATGG
TCCTTAGT	GCCTTAGT
TCCCTAAA	CCCCTAAA
TCAACTGT	TGAACTGT
TCCTTCAA	TCCTTCAC
TCCCTAGA	TCCGCTAG
TCCTTCAC	TCCTTCAC
TCCCTAGC	TCCGCTAG
TCCTTCAG	TCCTTCAC
TCCTTCAT	TCCTTCAC
TCCTTCAN	TCCTTCAC
TCCTTCCA	TCCTTCAC
TCCTTCCC	TCCTTCAC
TCCCTAGG	TCCGCTAG
TCCCTAGT	TCCGCTAG
TCCCTAGN	TCCGCTAG
TCCTTCCG	TCCTTCAC
TCCTTCCT	TCCTTCAC
TCCCTCAC	TCCTTCAC
TCCTTCCN	TCCTTCAC
TCCTTCGA	TCCTTCAC
TCCTTCGC	TCCTTCAC
TCCTTCTA	TCCTTCAC
TCCTTCTC	TCCTTCAC
TCAAGAAA	TCAGAAAC
TCCTTCNA	TCCTTCAC
TCCTTCNC	TCCTTCAC
TCCTTGAC	TCCTTCAC
TCCTTGCA	TCCTTCAC
TCCCTGTC	CCCTGTCG
TCAAGCCA	GTCAAGCC
TCCCTTCA	TCCTTCAC
TCCTTGGA	TCTTGGAG
TCCCTTGG	ACCCTTGG
TCAAGCCC	GTCAAGCC
TCCTTTAC	TCCTTCAC
TCAAGCCG	GTCAAGCC
TCAAGCCT	GTCAAGCC
TCAAGCCN	GTCAAGCC
TCAGNGTC	TCAGGTCT
TCAAGGAT	TAAAGGAT
TCCTTTCA	TCCTTCAC
TCAGNTCT	TCAGGTCT
TCAAGGTC	TCAGGTCT
TCCAAACG	TCCAACGA
TCCAAAGA	TCCAACGA
TCAAGTCT	TCAGGTCT
TCCAAATG	CCAAATGG
TCCTTNAC	TCCTTCAC
TCCTTNCA	TCCTTCAC
TAGAAACA	TCAGAAAC
TAGAAACC	TCAGAAAC
TAGAAACG	TCAGAAAC
TAGAAACT	TCAGAAAC
TAGAAACN	TCAGAAAC
TCCAACAA	TCCAACGA
TCCAACAC	TCCAACGA
TCCAACAG	TCCAACGA
TAGAAATC	AAGAAATC
TCCAACAT	TCCAACGA
TCCAACAN	TCCAACGA
TCCAACCA	TCCAACGA
TCCAACCG	TCCAACGA
TCCAACGA	TCCAACGA
TCCAACGC	TCCAACGA
TCCAACGG	TCCAACGA
TCATAAAC	TCAGAAAC
TCCAACGT	TCCAACGA
TCANAAAC	TCAGAAAC
TCCAACGN	TCCAACGA
TCAATATA	TAATATAT
TAGAACTG	TGAACTGT
TCCTNCAC	TCCTTCAC
TCCAACTA	TCCAACGA
TCCAACTG	TCCAACGA
TCCAACNA	TCCAACGA
TCAATCGA	TAATCGAG
TCCAACNG	TCCAACGA
TCCAAGAA	TCCAACGA
TCCAAGAC	TCCAACGA
TCCAAGAG	TCCAACGA
TCCAAGAT	TCCAACGA
TCCAAGAN	TCCAACGA
TAGAAGGA	TAAAGGAT
TCCAAGCG	TCCAACGA
TAGAAGGG	GAGAAGGG
TCCAAGGA	TCCAACGA
TCCGAAAC	TCAGAAAC
TCCGAACG	TCCAACGA
TAGAATGG	TAGTATGG
TCAATTAG	ACAATTAG
TCCAATCG	TCCAACGA
TCCAATGA	TCCAACGA
TCCAANCG	TCCAACGA
TCCAANGA	TCCAACGA
TCCGACGA	TCCAACGA
TCCTNTCA	TCCTTCAC
TCCGACTA	TCCGCTAG
TCCACACG	TCCAACGA
TCCACCAA	TACCACCA
TCCACCAC	TACCACCA
TCCACCAG	TACCACCA
TCATATAT	TAATATAT
TCCACCAT	TACCACCA
TCCACCAN	TACCACCA
TCCACCGA	TCCAACGA
TCCNAACG	TCCAACGA
TCCACGAA	TCCAACGA
TCCACGAC	TCCAACGA
TCCNACGA	TCCAACGA
TCCACGAG	TCCAACGA
TCCACGAT	TCCAACGA
TCCACGAN	TCCAACGA
TCCGATAG	TCCGCTAG
TCCACTAG	TCCGCTAG
TCANGAAA	TCAGAAAC
TCCGCAAG	TCCGCTAG
TAGACGTA	TAGCGTAA
TCCAGAAA	TCAGAAAC
TCACAAAC	TCAGAAAC
TCCGCAGA	TCCGCTAG
TCCAGACG	TCCAACGA
TCCGCAGC	TCCGCTAG
TCCGCAGG	TCCGCTAG
TCCGCAGT	TCCGCTAG
TCCGCAGN	TCCGCTAG
TCCGCATA	TCCGCTAG
TCACAACG	TCCAACGA
TCCGCCAG	TCCGCTAG
TCCGCCTA	TCCGCTAG
TCCGCGAG	TCCGCTAG
TCCGCGTA	TCCGCTAG
TCCAGCGA	TCCAACGA
TCCGCTAA	TCCGCTAG
TCCGCTAC	TCCGCTAG
TCCGCTAG	TCCGCTAG
TCCAGCTA	TCCGCTAG
TCCGCTAT	TCCGCTAG
TCCGCTAN	TCCGCTAG
TCCGCTCA	TCCGCTAG
TCCGCTCG	TCCGCTAG
TCCGCTGA	TCCGCTAG
TCCGCTGC	TCCGCTAG
TCCGCTGG	TCCGCTAG
TCCGCTGT	TCCGCTAG
TCCGCTGN	TCCGCTAG
TCCGCTTA	TCCGCTAG
TCCGCTTG	TCCGCTAG
TCCGCTNA	TCCGCTAG
TCCGCTNG	TCCGCTAG
TCCGCNAG	TCCGCTAG
TCANGGTC	TCAGGTCT
TCCAGGTC	TCAGGTCT
TCANGTCT	TCAGGTCT
TCCGCNTA	TCCGCTAG
TCACCACC	TACCACCA
TCCGGACT	TGCGGACT
TCCAGTTA	CCCAGTTA
TAGAGCCG	GAGAGCCG
TCCGGCAG	TTCGGCAG
TAGAGGAT	TAAAGGAT
TCCGGCTA	TCCGCTAG
TCACCGGG	TCTCCGGG
TAGAGTAA	TAGCGTAA
TAGAGTTA	TTGAGTTA
TCACGAAA	TCAGAAAC
TCCATACG	TCCAACGA
TCACGCTA	TCCGCTAG
TCCATCAC	TCCTTCAC
TCACGGCA	CACGGCAT
TCCGGGTC	GCCGGGTC
TCCATCCA	CCCATCCA
TCCATCGA	TCCAACGA
TCCGGTAA	ACCGGTAA
TCCGGTAG	TCCGCTAG
TCACGGTC	TCAGGTCT
TCCGGTCT	TCAGGTCT
TCACGTCT	TCAGGTCT
TCCATTCA	TCCTTCAC
TCCNCTAG	TCCGCTAG
TCCANACG	TCCAACGA
TCCANCGA	TCCAACGA
TCCGTAGA	TCCGCTAG
TCCGTAGC	TCCGCTAG
TCCGTAGG	TCCGCTAG
TCCGTAGT	TCCGCTAG
TCCGTAGN	TCCGCTAG
TCCGTCAC	TCCTTCAC
TCCGTCTA	TCCGCTAG
TCCCAACG	TCCAACGA
TCCGTTAG	TCCGCTAG
TCTCAACG	TCCAACGA
TCCGTTCA	TCCTTCAC
TCCCACCA	TACCACCA
TCCCACGA	TCCAACGA
TCCGTTGA	CCGTTGAG
TCCCACTG	CCCCACTG
TCCNGCTA	TCCGCTAG
TCCCAGTT	CCCAGTTA
TCCCATCC	CCCATCCA
TCTCACGG	TCTCCGGG
TCGTAAGC	TTGTAAGC
TCTCAGGG	TCTCCGGG
TCCCCACT	CCCCACTG
TCGTAGGT	GCGTAGGT
TCCGNCTA	TCCGCTAG
TCGTATAC	CGTATACG
TCGTATGG	TAGTATGG
TCTAACCC	TTAACCCC
TCTAACGA	TCCAACGA
TCTAAGAA	CTAAGAAC
TCCCCGGG	TCTCCGGG
TCGTCCGG	TCTCCGGG
TCCCCTAA	CCCCTAAA
TCCGNTAG	TCCGCTAG
TCCCCTAG	TCCGCTAG
TCCCCTTT	GCCCCTTT
TCTCCAGG	TCTCCGGG
TCTACATA	TTCTACAT
TCTACATC	TTCTACAT
TCTACATG	TTCTACAT
TCTACATT	TTCTACAT
TCTACATN	TTCTACAT
TANGCGTA	TAGCGTAA
TCTACCGG	TCTCCGGG
TCTCCCGG	TCTCCGGG
TCTACGGG	TCTCCGGG
TCTGTAAG	TTGTAAGC
TCGTCTGA	TGTCTGAC
TCTCCGAG	TCTCCGGG
TCTCCGCG	TCTCCGGG
TCTCCGGA	TCTCCGGG
TCTCCGGC	TCTCCGGG
TCTCCGGG	TCTCCGGG
TCTCCGGT	TCTCCGGG
TCTCCGGN	TCTCCGGG
TCTCCGTG	TCTCCGGG
TCTCCGNG	TCTCCGGG
TCTAGAAA	TCAGAAAC
TCTCCTGG	TCTCCGGG
TCTGTGGA	TCTTGGAG
TCTGTGGC	TTTGTGGC
TCTNCCGG	TCTCCGGG
TCTAGCAT	CTAGCATT
TCTCCNGG	TCTCCGGG
TCTNCGGG	TCTCCGGG
TCTAGCTC	CTAGCTCG
TCTAGGAG	TCTTGGAG
TCTAGGCC	CTAGGCCC
TCTCGATT	CCTCGATT
TANGTATG	TAGTATGG
TCTAGGTC	TCAGGTCT
TCNCAACG	TCCAACGA
TCGTGGAG	TCTTGGAG
TCTCGCCC	GCTCGCCC
TCTCGCGG	TCTCCGGG
TCTCGCTA	TCCGCTAG
TCTCGGAG	TCTTGGAG
TCTCGGCA	TTCGGCAG
TCGTGGGG	TGTGGGGT
TCTCGGGA	TCTCCGGG
TCTCGGGC	TCTCCGGG
TCTCGGGG	TCTCCGGG
TCTCGGGT	TCTCCGGG
TCTCGGGN	TCTCCGGG
TCTNGGAG	TCTTGGAG
TCTATGGA	TCTTGGAG
TCGTTCAC	TCCTTCAC
TCTCTACA	TTCTACAT
TCGTTGAG	CCGTTGAG
TCGTTGGA	TCTTGGAG
TCTTAATG	CTTAATGC
TCTCTCGG	TCTCCGGG
TCTTACCA	CTTACCAA
TCTTAGAG	TCTTGGAG
TCTTAGGA	TCTTGGAG
TCGTTTTG	TGTTTTGA
TCGCCGGG	TCTCCGGG
TCTCTGAC	TGTCTGAC
TCTCTGGA	TCTTGGAG
TCTCTGGG	TCTCCGGG
TCTTCACA	TCCTTCAC
TCTTCACC	TCCTTCAC
TCTCTTCA	TCCTTCAC
TCTTCACG	TCCTTCAC
TCTTCACT	TCCTTCAC
TCTTCACN	TCCTTCAC
TCTNTGGA	TCTTGGAG
TCTTCCGG	TCTCCGGG
TCNCCGGG	TCTCCGGG
TANTATAT	TAATATAT
TCGCGCAT	TGGCGCAT
TANTATGG	TAGTATGG
TCGCGCTA	TCCGCTAG
TCGCGGAA	CGCGGAAG
TCTTCGAG	TCTTGGAG
TCGCGGAC	TGCGGACT
TCTTCGGA	TCTTGGAG
TCTTCGGG	TCTCCGGG
TGAGCCCT	TGATCCCT
TCTTCTCT	CTTCTCTA
TGAGCGCA	TGGCGCAT
TGAGCGTA	TAGCGTAA
TCGCGTAA	TAGCGTAA
TCTTGAAG	TCTTGGAG
TGAGCTGT	TGAACTGT
TCTTGAGA	TCTTGGAG
TCTTGAGC	TCTTGGAG
TCTTGAGG	TCTTGGAG
TCTTGAGT	TCTTGGAG
TCTTGAGN	TCTTGGAG
TCTCNCGG	TCTCCGGG
TCTTGCAG	TCTTGGAG
TCTTGCGA	TCTTGGAG
TCNCGCTA	TCCGCTAG
TGAGGACT	TGCGGACT
TANTCGAG	TAATCGAG
TCTCNGGG	TCTCCGGG
TCTTGGAA	TCTTGGAG
TCGCTAGA	TCCGCTAG
TCGCTAGC	TCCGCTAG
TCTTGGAC	TCTTGGAG
TCGCTAGG	TCCGCTAG
TCTTGGAG	TCTTGGAG
TCGCTAGT	TCCGCTAG
TCTTGGAT	TCTTGGAG
TCGCTAGN	TCCGCTAG
TCTTGGAN	TCTTGGAG
TCTTGGCA	TCTTGGAG
TCTTGGCG	TCTTGGAG
TCTTGGGA	TCTTGGAG
TCTTGGGC	TCTTGGAG
TGAGGGGT	TGTGGGGT
TCTTGGGG	TCTTGGAG
TCTTGGGT	TCTTGGAG
TCTTGGGN	TCTTGGAG
TCTTGGTA	TCTTGGAG
TCTTGGTG	TCTTGGAG
TCTTGGNA	TCTTGGAG
TCTTGGNG	TCTTGGAG
TCTTGTAG	TCTTGGAG
TGAGGTCT	TCAGGTCT
TCTTGTGA	TCTTGGAG
TCTTGTGG	TTTGTGGC
TCTTGNAG	TCTTGGAG
TCCNTCAC	TCCTTCAC
TCTTGNGA	TCTTGGAG
TCGCTCCT	ACGCTCCT
TCTGAAAC	TCAGAAAC
TCNAACGA	TCCAACGA
TCTTTAAA	GCTTTAAA
TCTTTCAC	TCCTTCAC
TCTGACCA	ATCTGACC
TCTGACCC	ATCTGACC
TCTGACCG	ATCTGACC
TCTGACCT	ATCTGACC
TCTGACCN	ATCTGACC
TCGCTTCA	TCCTTCAC
TCTTTGAG	TCTTGGAG
TCCNTTCA	TCCTTCAC
TCTGAGTT	TTGAGTTA
TCTTTGGA	TCTTGGAG
TCNCTTCA	TCCTTCAC
TGAGTATG	TAGTATGG
TCTTTTGA	TGTTTTGA
TGAGTCCC	TGATCCCT
TCTGCAAG	CCTGCAAG
TCTGCACG	TTGCACGA
TGAATATA	TAATATAT
TCTGCCGG	TCTCCGGG
TGAGTGTT	GAGTGTTC
TCTGCGGG	TCTCCGGG
TGAGTTAA	TTGAGTTA
TGAGTTAC	TTGAGTTA
TGAGTTAG	TTGAGTTA
TGAGTTAT	TTGAGTTA
TGAGTTAN	TTGAGTTA
TGAATCCC	TGATCCCT
TGAATCCT	GAATCCTC
TGAATCGA	TAATCGAG
TCTGCTAG	TCCGCTAG
TGAATCTG	TGAACTGT
TGAATGTA	TGAACTGT
TGAATGTC	TGAACTGT
TGAATGTG	TGAACTGT
TGAATGTT	TGAACTGT
TGAATGTN	TGAACTGT
TCTGGAGA	TCTTGGAG
TCTGGAGC	TCTTGGAG
TCTGGAGG	TCTTGGAG
TCTGGAGT	TCTTGGAG
TCTGGAGN	TCTTGGAG
TCTTNGAG	TCTTGGAG
TCGGAAAC	TCAGAAAC
TCTTNGGA	TCTTGGAG
TGAATTGT	TGAACTGT
TCGGACTA	TGCGGACT
TCGGACTC	TGCGGACT
TCGGACTG	TGCGGACT
TCGGACTT	TGCGGACT
TCGGACTN	TGCGGACT
TCTGGGAG	TCTTGGAG
TCTGGGAT	CTGGGATC
TCTGGGGT	TGTGGGGT
TCNGAAAC	TCAGAAAC
TCTGGTCT	TCAGGTCT
TGAANCTG	TGAACTGT
TCNAGAAA	TCAGAAAC
TCGGATTC	CGGATTCC
TCGAAACA	TCAGAAAC
TCGAAACC	TCAGAAAC
TCGAAACG	TCAGAAAC
TCGAAACT	TCAGAAAC
TCGAAACN	TCAGAAAC
TGAANTGT	TGAACTGT
TCNAGGTC	TCAGGTCT
TCGGCAGA	TTCGGCAG
TCGGCAGC	TTCGGCAG
TCGAACGA	TCCAACGA
TCGGCAGG	TTCGGCAG
TCGGCAGT	TTCGGCAG
TCGGCAGN	TTCGGCAG
TCGAACTG	TGAACTGT
TGATNCCC	TGATCCCT
TGATNCCT	TGATCCCT
TCGGCGCA	TGGCGCAT
TGATACCC	TGATCCCT
TGATACCT	TGATCCCT
TCGACCCG	CGACCCGG
TGCAGAAA	TCAGAAAC
TGACACTG	TGAACTGT
TGATACTG	TGAACTGT
TGCAGACT	TGCGGACT
TCGGCTAG	TCCGCTAG
TGCAGGAC	TGCGGACT
TGATATAT	TAATATAT
TGACCACC	TACCACCA
TCNGCTAG	TCCGCTAG
TGCAGGTC	TCAGGTCT
TGANACTG	TGAACTGT
TGACCCCT	TGATCCCT
TGACCCGG	CGACCCGG
TGCGAACT	TGCGGACT
TGACCCTA	TGATCCCT
TGACCCTC	TGATCCCT
TCGAGAAA	TCAGAAAC
TGACCCTG	TGATCCCT
TGACCCTT	TGATCCCT
TGACCCTN	TGATCCCT
TCGAGAGT	ACGAGAGT
TGCGACTA	TGCGGACT
TGCGACTC	TGCGGACT
TGCGACTG	TGCGGACT
TGCGACTT	TGCGGACT
TGCGACTN	TGCGGACT
TGCGAGAC	TGCGGACT
TGACCTGT	TGAACTGT
TCGAGGTC	TCAGGTCT
TGCTTCAC	TCCTTCAC
TCGGGTCT	TCAGGTCT
TGATCACC	TGATCCCT
TGATCACT	TGATCCCT
TCGAGTTA	TTGAGTTA
TGCATCCC	TGATCCCT
TGANCCCT	TGATCCCT
TGATCCAC	TGATCCCT
TGATCCAT	TGATCCCT
TGATCCCA	TGATCCCT
TGATCCCC	TGATCCCT
TGATCCCG	TGATCCCT
TGATCCCT	TGATCCCT
TGATCCCN	TGATCCCT
TGATCCGC	TGATCCCT
TGATCCGT	TGATCCCT
TGATCCTA	TGATCCCT
TGATCCTC	TGATCCCT
TGATCCTG	TGATCCCT
TGATCCTT	TGATCCCT
TGATCCTN	TGATCCCT
TGCGCACT	TGCGGACT
TGATCCNC	TGATCCCT
TGATCCNT	TGATCCCT
TGCGCATA	TGGCGCAT
TGATCGAG	TAATCGAG
TGCGCATC	TGGCGCAT
TGATCGAT	GATCGATA
TGCGCATG	TGGCGCAT
TGCGCATT	TGGCGCAT
TGCGCATN	TGGCGCAT
TGCTTGGA	TCTTGGAG
TCGATCCC	TGATCCCT
TGATCGCC	TGATCCCT
TGATCGCT	TGATCCCT
TGACGCAT	TGGCGCAT
TGCTTTAA	GCTTTAAA
TGCGCGAC	TGCGGACT
TCGGTCTA	TCAGGTCT
TCGGTCTC	TCAGGTCT
TCGGTCTG	TCAGGTCT
TCGGTCTT	TCAGGTCT
TGATCTCC	TGATCCCT
TGCGCGCA	TGGCGCAT
TCGGTCTN	TCAGGTCT
TGANCTGT	TGAACTGT
TGATCTCT	TGATCCCT
TGATCTGA	TGTCTGAC
TCGATTAT	CGATTATT
TGATCTGT	TGAACTGT
TGACGGAC	TGCGGACT
TGCTTTGA	TGTTTTGA
TCGGTGGT	CGGTGGTT
TGCTTTTG	TGTTTTGA
TGCGCTAG	TCCGCTAG
TGATCNCC	TGATCCCT
TGATCNCT	TGATCCCT
TGCGGAAC	TGCGGACT
TGCGGAAG	CGCGGAAG
TGCGGAAT	TGCGGACT
TGCGGACA	TGCGGACT
TGCGGACC	TGCGGACT
TGCGGACG	TGCGGACT
TGCGGACT	TGCGGACT
TGCGGACN	TGCGGACT
TGCGGAGC	TGCGGACT
TGATGCCC	TGATCCCT
TGCGGAGT	TGCGGACT
TGATGCCT	TGATCCCT
TGCGGATA	TGCGGACT
TGCGGATC	TGCGGACT
TGCGGATG	TGCGGACT
TGACTAAC	GACTAACT
TGCGGATT	TGCGGACT
TGCGGATN	TGCGGACT
TGCGGANC	TGCGGACT
TGCGGANT	TGCGGACT
TGACTACT	GACTACTA
TGCGGCAC	TGCGGACT
TGCGGCAG	TTCGGCAG
TGCGGCCT	TGCGGACT
TGCGGCTA	TGCGGACT
TGCGGCTC	TGCGGACT
TGCGGCTG	TGCGGACT
TGCGGCTT	TGCGGACT
TGCGGCTN	TGCGGACT
TGACTCCC	TGATCCCT
TGCGGGAC	TGCGGACT
TGCGGGCT	TGCGGACT
TGCGGGGT	TGTGGGGT
TGACTGAC	TGTCTGAC
TGCGGTAC	TGCGGACT
TGATGGGG	TGTGGGGT
TGCGGTCT	TGCGGACT
TGACTGTA	TGAACTGT
TGACTGTC	TGAACTGT
TGACTGTG	TGAACTGT
TGACTGTT	TGAACTGT
TGACTGTN	TGAACTGT
TGCGGNAC	TGCGGACT
TGCGGNCT	TGCGGACT
TGCCAACG	TCCAACGA
TGCGTAAA	TAGCGTAA
TGCGTAAC	TAGCGTAA
TGCGTAAG	TAGCGTAA
TGCGTAAT	TAGCGTAA
TGCGTAAN	TAGCGTAA
TGCGTACT	TGCGGACT
TGCGTAGG	GCGTAGGT
TGCCACCA	TACCACCA
TCGCAACG	TCCAACGA
TGCGTGAC	TGCGGACT
TCGCACGA	TTGCACGA
TGATTATT	CGATTATT
TGATTCCC	TGATCCCT
TGATTCCT	TGATCCCT
TGCGTTTC	AGCGTTTC
TGCGNACT	TGCGGACT
TGATTTGA	TGTTTTGA
TGATTTTG	TGTTTTGA
TGCGNGAC	TGCGGACT
TGCCCCTT	GCCCCTTT
TGANTCCC	TGATCCCT
TGAGAAAC	TCAGAAAC
TGAGAAGG	GAGAAGGG
TCNGGTCT	TCAGGTCT
TGAGACTG	TGAACTGT
TGTAACCC	TTAACCCC
TGAGAGCC	GAGAGCCG
TGCTACAT	TTCTACAT
TGTAACTG	TGAACTGT
TGCCGACT	TGCGGACT
TGTAAGCA	TTGTAAGC
TGTAAGCC	TTGTAAGC
TGTAAGCG	TTGTAAGC
TGTAAGCT	TTGTAAGC
TGTAAGCN	TTGTAAGC
TGCCGCAT	TGGCGCAT
TGCCGCTA	TCCGCTAG
TGCCGGAC	TGCGGACT
TGCCGGGT	GCCGGGTC
TGCTCCCT	TGATCCCT
TGCTCCGG	TCTCCGGG
TGGTGCAT	TGGCGCAT
TGCTCGCC	GCTCGCCC
TGCAAAGT	GCAAAGTA
TGCTCTGA	TGTCTGAC
TGCAACGA	TCCAACGA
TGCAACTG	TGAACTGT
TGCTGACA	TGTCTGAC
TGCTGACC	TGTCTGAC
TGGTGGGG	TGTGGGGT
TGCTGACG	TGTCTGAC
TGCCTGAC	TGTCTGAC
TGCTGACN	TGTCTGAC
TGGTGGTT	CGGTGGTT
TGTACCCT	GTACCCTG
TGCCTTAG	GCCTTAGT
TGCCTTCA	TCCTTCAC
TGCTGGAC	TGCGGACT
TGCTGGGG	TGTGGGGT
TGTACGGA	GTACGGAT
TGCACGAA	TTGCACGA
TGCACGAC	TTGCACGA
TGCACGAG	TTGCACGA
TGCACGAT	TTGCACGA
TGCACGAN	TTGCACGA
TGTACTGA	TGTCTGAC
TGTACTGT	TGAACTGT
TGCACTGT	TGAACTGT
TGCACTTC	GCACTTCT
TGCNGACT	TGCGGACT
TGTCTAAC	TGTCTGAC
TGTCTACC	TGTCTGAC
TGTCTACG	TGTCTGAC
TGTCTACT	TGTCTGAC
TGTCTACN	TGTCTGAC
TGTCTAGA	TGTCTGAC
TGTCTCAC	TGTCTGAC
TGTCTCGA	TGTCTGAC
TGTCTGAA	TGTCTGAC
TGTCTGAC	TGTCTGAC
TGTCTGAG	TGTCTGAC
TGTCTGAT	TGTCTGAC
TGTCTGAN	TGTCTGAC
TGTCTGCA	TGTCTGAC
TGTCTGCC	TGTCTGAC
TGTCTGCG	TGTCTGAC
TGTCTGCT	TGTCTGAC
TGTCTGCN	TGTCTGAC
TGTCTGGA	TGTCTGAC
TGTCTGGC	TGTCTGAC
TGTCTGTA	TGTCTGAC
TGTCTGTC	TGTCTGAC
TGTCTGNA	TGTCTGAC
TGTCTGNC	TGTCTGAC
TGGTTTGA	TGTTTTGA
TGTCTTAC	TGTCTGAC
TGGTTTTG	TGTTTTGA
TCNTCCGG	TCTCCGGG
TGTCTTTG	TGTTTTGA
TGTAGGGG	TGTGGGGT
TGTAGGGT	TGTGGGGT
TGNAACTG	TGAACTGT
TGTCTNAC	TGTCTGAC
TGCNGGAC	TGCGGACT
TGTCTNGA	TGTCTGAC
TGTTCCCT	TGATCCCT
TGTATACG	CGTATACG
TGTCNGAC	TGTCTGAC
TGTATCCC	TGATCCCT
TGNACTGT	TGAACTGT
TCNTGGAG	TCTTGGAG
TGTTCTTG	TGTTTTGA
TGTATGAC	TGTCTGAC
TGTATGGA	TAGTATGG
TGTATGGC	TAGTATGG
TGTATGGG	TAGTATGG
TGTTGACA	TGTCTGAC
TGTATGGT	TAGTATGG
TGTATGGN	TAGTATGG
TGTTGACC	TGTCTGAC
TGTCNTGA	TGTCTGAC
TGTTGACG	TGTCTGAC
TGTTGACT	TGTCTGAC
TGTTGACN	TGTCTGAC
TGTATTGA	TGTTTTGA
TGTATTTG	TGTTTTGA
TGTTGGAG	TCTTGGAG
TGTTGGGG	TGTGGGGT
TGTTGGGT	TGTGGGGT
TCNTTCAC	TCCTTCAC
TGTTGTGA	TGTTTTGA
TGTTGTGG	TTTGTGGC
TGTTGTTG	TGTTTTGA
TGAAACTG	TGAACTGT
TGAAAGGA	TAAAGGAT
TCNTTGGA	TCTTGGAG
TGAAATGT	TGAACTGT
TGTTTAGA	TGTTTTGA
TGTTTATG	TGTTTTGA
TGNATCCC	TGATCCCT
TGTGAGGG	TGTGGGGT
TGTGAGGT	TGTGGGGT
TGTGAGTT	TTGAGTTA
TGTTTCCC	GTTTCCCG
TGAACAGT	TGAACTGT
TGTTTCGA	TGTTTTGA
TGAACATG	TGAACTGT
TGTTTCTG	TGTTTTGA
TGAACCCC	TTAACCCC
TGAACCCT	TGATCCCT
TGAACCGT	TGAACTGT
TGAACCTG	TGAACTGT
TGTTTGAA	TGTTTTGA
TGTTTGAG	TGTTTTGA
TGTTTGAT	TGTTTTGA
TGTTTGAN	TGTTTTGA
TGAACGGT	TGAACTGT
TGTTTGCA	GTTTGCAT
TGAACGTA	TGAACTGT
TGAACGTC	TGAACTGT
TGAACGTG	TGAACTGT
TGAACGTT	TGAACTGT
TGTTTGGA	TGTTTTGA
TGTTTGTG	TGTTTTGA
TGAACGTN	TGAACTGT
TGAACTAG	TGAACTGT
TGAACTAT	TGAACTGT
TGAACTCG	TGAACTGT
TGAACTCT	TGAACTGT
TGTTTTAA	TGTTTTGA
TGTTTTAC	TGTTTTGA
TGTTTTAG	TGTTTTGA
TGAACTGA	TGAACTGT
TGTTTTAT	TGTTTTGA
TGAACTGC	TGAACTGT
TGTTTTAN	TGTTTTGA
TGAACTGG	TGAACTGT
TGAACTGT	TGAACTGT
TGAACTGN	TGAACTGT
TGAACTTA	TGAACTGT
TGTTTTCA	TGTTTTGA
TGAACTTC	TGAACTGT
TGAACTTG	TGAACTGT
TGAACTTT	TGAACTGT
TGAACTTN	TGAACTGT
TGTTTTCG	TGTTTTGA
TGTTTTGA	TGTTTTGA
TGTTTTGC	TGTTTTGA
TGTTTTGG	TGTTTTGA
TGTTTTGT	TGTTTTGA
TGTTTTGN	TGTTTTGA
TGTTTTTA	TGTTTTGA
TGTTTTTG	TGTTTTGA
TGTGCACG	TTGCACGA
TGTTTTNA	TGTTTTGA
TGAACTNG	TGAACTGT
TGAACTNT	TGAACTGT
TGTTTTNG	TGTTTTGA
TGGNCGCA	TGGCGCAT
TGAACNGT	TGAACTGT
TGAACNTG	TGAACTGT
TGTCAAGC	GTCAAGCC
TGTTTNGA	TGTTTTGA
TGTTTNTG	TGTTTTGA
TGGACAAA	GTGGACAA
TGGACAAC	GTGGACAA
TGGACAAG	GTGGACAA
TGGACAAT	GTGGACAA
TGGACAAN	GTGGACAA
TGGAACTG	TGAACTGT
TGGACGCA	TGGCGCAT
TGAAGCTG	TGAACTGT
TGTGCGCA	TGGCGCAT
TGTGCGGG	TGTGGGGT
TGTGCGGT	TGTGGGGT
TGAAGGAT	TAAAGGAT
TGTGCTGA	TGTCTGAC
TGTCAGAC	TGTCTGAC
TGGACTGT	TGAACTGT
TGGNGCAT	TGGCGCAT
TGAAGTGT	TGAACTGT
TGTCATGA	TGTCTGAC
TGTGGACA	GTGGACAA
TGTGGACT	TGCGGACT
TGTGGAGG	TGTGGGGT
TGTGGAGT	TGTGGGGT
TGNCGCAT	TGGCGCAT
TGTGGCGG	TGTGGGGT
TGTTNTGA	TGTTTTGA
TGTGGCGT	TGTGGGGT
TGGCNCAT	TGGCGCAT
TGTTNTTG	TGTTTTGA
TGGAGCAT	TGGCGCAT
TGNCGGAC	TGCGGACT
TGTGGGAG	TGTGGGGT
TGTGGGAT	TGTGGGGT
TGTGGGCG	TGTGGGGT
TGTGGGCT	TGTGGGGT
TGTGGGGA	TGTGGGGT
TGTGGGGC	TGTGGGGT
TGTGGGGG	TGTGGGGT
TGTGGGGT	TGTGGGGT
TGTGGGGN	TGTGGGGT
TGTGGGTA	TGTGGGGT
TGTGGGTC	TGTGGGGT
TGTGGGTG	TGTGGGGT
TGTGGGTT	TGTGGGGT
TGTCCCTA	TGATCCCT
TGTGGGTN	TGTGGGGT
TGTCCCTC	TGATCCCT
TGTCCCTG	TGATCCCT
TGTGGGNG	TGTGGGGT
TGTCCCTT	TGATCCCT
TGGCNGCA	TGGCGCAT
TGTGGGNT	TGTGGGGT
TGTCCCTN	TGATCCCT
TGTCCGAC	TGTCTGAC
TGTGGTGG	TGTGGGGT
TGTGGTGT	TGTGGGGT
TGTCCGGG	TCTCCGGG
TGGAGTTA	TTGAGTTA
TGTCCTGA	TGTCTGAC
TGTGGNGG	TGTGGGGT
TGTGGNGT	TGTGGGGT
TGTGTAAG	TTGTAAGC
TGGGACTA	TGCGGACT
TGGGACTC	TGCGGACT
TGGGACTG	TGCGGACT
TGGGACTT	TGCGGACT
TGGGACTN	TGCGGACT
TGTCGACA	TGTCTGAC
TGGATCCC	TGATCCCT
TGTCGACC	TGTCTGAC
TGTCGACG	TGTCTGAC
TGTCGACT	TGTCTGAC
TGTCGACN	TGTCTGAC
TGTGTGAC	TGTCTGAC
TGNCTGAC	TGTCTGAC
TGGGATCA	CTGGGATC
TGTCGCAT	TGGCGCAT
TGGGATCC	CTGGGATC
TGTGTGGC	TTTGTGGC
TGGGATCG	CTGGGATC
TGTGTGGG	TGTGGGGT
TGGGATCT	CTGGGATC
TGTGTGGT	TGTGGGGT
TGGGATCN	CTGGGATC
TGGATTCC	CGGATTCC
TGTGTTGA	TGTTTTGA
TGTGTTTG	TGTTTTGA
TGTCGGCA	TTCGGCAG
TTCGTAAG	TTGTAAGC
TTCGTACA	TTCTACAT
TGTCGGGG	TGTGGGGT
TGTCGGGT	TGTGGGGT
TGGGCATA	TGGCGCAT
TGGGCATC	TGGCGCAT
TGGGCATG	TGGCGCAT
TGGGCATT	TGGCGCAT
TGGGCATN	TGGCGCAT
TGGGCCAA	AGGGCCAA
TGTCGTAA	ATGTCGTA
TTCGTCAG	TTCGGCAG
TGTCGTAC	ATGTCGTA
TGTCGTAG	ATGTCGTA
TGTCGTAT	ATGTCGTA
TGTCGTAN	ATGTCGTA
TGTCGTGA	TGTCTGAC
TGGGCGCA	TGGCGCAT
TTCGTGCA	TTCGGCAG
TTCGTGGC	TTTGTGGC
TGTGNGGG	TGTGGGGT
TGTGNGGT	TGTGGGGT
TGTNCTGA	TGTCTGAC
TTCGNCAG	TTCGGCAG
TGGGGACT	TGCGGACT
TGGCACAT	TGGCGCAT
TGGCACGA	TTGCACGA
TGGGGCAT	TGGCGCAT
TTCGNGCA	TTCGGCAG
TGTTATGA	TGTTTTGA
TGGCAGCA	TGGCGCAT
TGTTATTG	TGTTTTGA
TGGGGGGT	TGTGGGGT
TGGGGGTA	TGTGGGGT
TGGGGGTC	TGTGGGGT
TGGGGGTG	TGTGGGGT
TGGGGGTT	TGTGGGGT
TGGGGGTN	TGTGGGGT
TTACCAAA	CTTACCAA
TTACCAAC	CTTACCAA
TTACCAAG	CTTACCAA
TTACCAAT	CTTACCAA
TTACCAAN	CTTACCAA
TTACCACC	TACCACCA
TTCTAAAT	TTCTACAT
TTCTAACA	TTCTACAT
TTCTAAGC	TTGTAAGC
TGTNGGGG	TGTGGGGT
TGTNGGGT	TGTGGGGT
TTCTAATA	TTCTACAT
TTCTAATC	TTCTACAT
TTCTAATG	TTCTACAT
TGGCCATA	TGGCGCAT
TTCTAATT	TTCTACAT
TGGCCATC	TGGCGCAT
TTCTAATN	TTCTACAT
TGGCCATG	TGGCGCAT
TGGCCATT	TGGCGCAT
TGGCCATN	TGGCGCAT
TTCTACAA	TTCTACAT
TTCTACAC	TTCTACAT
TTCTACAG	TTCTACAT
TTATAACT	ATATAACT
TTCTACAT	TTCTACAT
TGGCCCAT	TGGCGCAT
TTCTACAN	TTCTACAT
TTCTACCA	TTCTACAT
TTATAAGC	TTGTAAGC
TTCTACCT	TTCTACAT
TTCTACGA	TTCTACAT
TTCTACGT	TTCTACAT
TTCTACTA	TTCTACAT
TTCTACTC	TTCTACAT
TTACCCCA	TTAACCCC
TTCTACTG	TTCTACAT
TTACCCCC	TTAACCCC
TTCTACTT	TTCTACAT
TTACCCCG	TTAACCCC
TTCTACTN	TTCTACAT
TTACCCCT	TTAACCCC
TTCTACNA	TTCTACAT
TTACCCCN	TTAACCCC
TTCTACNT	TTCTACAT
TTCTAGAT	TTCTACAT
TTACCCTG	GTACCCTG
TTCTAGCA	TTCTACAT
TGGCCGCA	TGGCGCAT
TTATACAT	TTCTACAT
TGGGTCGG	AGGGTCGG
TTATACCC	TTAACCCC
TTCTATAT	TTCTACAT
TTCTATCA	TTCTACAT
TGNGCGCA	TGGCGCAT
TGGCGAAT	TGGCGCAT
TGGCGACA	TGGCGCAT
TGGCGATA	TGGCGCAT
TGGCGATC	TGGCGCAT
TGGCGATG	TGGCGCAT
TGGCGATT	TGGCGCAT
TGGCGATN	TGGCGCAT
TGTNTGAC	TGTCTGAC
TGGCGCAA	TGGCGCAT
TGGCGCAC	TGGCGCAT
TGGCGCAG	TGGCGCAT
TGGCGCAT	TGGCGCAT
TGGCGCAN	TGGCGCAT
TGGCGCCA	TGGCGCAT
TGGCGCCT	TGGCGCAT
TTCTANAT	TTCTACAT
TGGCGCGA	TGGCGCAT
TTCTANCA	TTCTACAT
TGGCGCGT	TGGCGCAT
TGGCGCTA	TGGCGCAT
TGGCGCTC	TGGCGCAT
TGGCGCTG	TGGCGCAT
TGGCGCTT	TGGCGCAT
TGGCGCTN	TGGCGCAT
TGGCGCNA	TGGCGCAT
TGGCGCNT	TGGCGCAT
TGGCGGAC	TGCGGACT
TGGCGGAT	TGGCGCAT
TGGCGGCA	TGGCGCAT
TTACGGAT	GTACGGAT
TTACGGCA	TTCGGCAG
TTATATAT	TAATATAT
TGTNTTGA	TGTTTTGA
TTCTCACA	TTCTACAT
TGTNTTTG	TGTTTTGA
TTCTCATA	TTCTACAT
TTCTCATC	TTCTACAT
TTCTCATG	TTCTACAT
TTCTCATT	TTCTACAT
TTCTCATN	TTCTACAT
TGGCGTAA	TAGCGTAA
TGNGGACT	TGCGGACT
TGGCGTAT	TGGCGCAT
TGGCGTCA	TGGCGCAT
TTCTCCAT	TTCTACAT
TGGCGNAT	TGGCGCAT
TGGCGNCA	TGGCGCAT
TTCTCCGG	TCTCCGGG
TTATCCCC	TTAACCCC
TTATCCCT	TGATCCCT
TTCTCTAA	CTTCTCTA
TTATCGAG	TAATCGAG
TTCTCTAC	CTTCTCTA
TTCTCTAG	CTTCTCTA
TTCTCTAT	CTTCTCTA
TTCTCTAN	CTTCTCTA
TGNGGGGT	TGTGGGGT
TTCCAACG	TCCAACGA
TTACTACA	TTCTACAT
TGGCTCAT	TGGCGCAT
TTCCACAT	TTCTACAT
TTCTGACG	TGTCTGAC
TTCTGACT	TGTCTGAC
TTCTGACN	TGTCTGAC
TGGCTGAC	TGTCTGAC
TTCTGCAG	TTCGGCAG
TTCCACCA	TACCACCA
TTCTGCAT	TTCTACAT
TGGCTGCA	TGGCGCAT
TTCCACGA	TTGCACGA
TTCTGGCA	TTCGGCAG
TGGTAAGC	TTGTAAGC
TTCTGTGG	TTTGTGGC
TTATGTGG	TTTGTGGC
TTCTTACA	TTCTACAT
TGGTATGG	TAGTATGG
TTCTTCAC	TCCTTCAC
TTCTTCAT	TTCTACAT
TTCAACAT	TTCTACAT
TTCAACCC	TTAACCCC
TTCAACGA	TCCAACGA
TTCAAGCC	GTCAAGCC
TTCAAGGA	ATTCAAGG
TTCAAGGC	ATTCAAGG
TTCAAGGG	ATTCAAGG
TGGTCCCT	TGATCCCT
TTCAAGGT	ATTCAAGG
TTCAAGGN	ATTCAAGG
TTCTTGGA	TCTTGGAG
TGGTCGCA	TGGCGCAT
TGGTCTGA	TGTCTGAC
TTCCGCAG	TTCGGCAG
TTCCGCTA	TCCGCTAG
TTCACATA	TTCTACAT
TTCACATC	TTCTACAT
TTCACATG	TTCTACAT
TTCACATT	TTCTACAT
TGNTCCCT	TGATCCCT
TTCACATN	TTCTACAT
TTCACCCC	TTAACCCC
TTAGAAAC	TCAGAAAC
TTCCGGCA	TTCGGCAG
TTCACGAA	TTGCACGA
TTCACGAC	TTGCACGA
TTCACGAG	TTGCACGA
TTCACGAT	TTGCACGA
TTCACGAN	TTGCACGA
TTCCGGGA	TCTCCGGG
TTCCGGGC	TCTCCGGG
TTCCGGGG	TCTCCGGG
TTCCGGGT	TCTCCGGG
TTCCGGGN	TCTCCGGG
TTATTTCC	ATATTTCC
TTCTNACA	TTCTACAT
TTAGACCC	TTAACCCC
TGNTCTGA	TGTCTGAC
TTAGAGTT	TTGAGTTA
TTCNGCAG	TTCGGCAG
TTCTNCAT	TTCTACAT
TTCAGAAA	TCAGAAAC
TTCAGCAG	TTCGGCAG
TTCNGGCA	TTCGGCAG
TTCAGGCA	TTCGGCAG
TTCAGGTC	TCAGGTCT
TGNTGGGG	TGTGGGGT
TTCCTACA	TTCTACAT
TTCAGTTA	TTGAGTTA
TTAGCACG	TTGCACGA
TTANACCC	TTAACCCC
TTAGCATT	CTAGCATT
TTCNTACA	TTCTACAT
TTCCTGCA	ATTCCTGC
TTAGCCCC	TTAACCCC
TTCATACA	TTCTACAT
TTCNACAT	TTCTACAT
TTCCTGCC	ATTCCTGC
TTCCTGCG	ATTCCTGC
TTCCTGCT	ATTCCTGC
TTCCTGCN	ATTCCTGC
TTCCTTCA	TCCTTCAC
TGNTTTGA	TGTTTTGA
TGNTTTTG	TGTTTTGA
TTANCCCC	TTAACCCC
TTAGCGTA	TAGCGTAA
TTAGCTCG	CTAGCTCG
TTAGGCAG	TTCGGCAG
TTAGGCCC	CTAGGCCC
TTAAACCC	TTAACCCC
TTAAAGGA	TAAAGGAT
TTAGGTCT	TCAGGTCT
TTNAGTTA	TTGAGTTA
TTCGACAG	TTCGGCAG
TTCGACAT	TTCTACAT
TTAGTAAG	TTGTAAGC
TTAGTATG	TAGTATGG
TTTATGGC	TTTGTGGC
TTCGAGCA	TTCGGCAG
TTCGAGTT	TTGAGTTA
TTAACACC	TTAACCCC
TTAGTGGC	TTTGTGGC
TTAGTTAA	TTGAGTTA
TTAGTTAC	TTGAGTTA
TTAGTTAG	TTGAGTTA
TTAGTTAT	TTGAGTTA
TTAGTTAN	TTGAGTTA
TTAACCAC	TTAACCCC
TTAACCCA	TTAACCCC
TTAACCCC	TTAACCCC
TTAACCCG	TTAACCCC
TTAACCCT	TTAACCCC
TTAACCCN	TTAACCCC
TTAACCGC	TTAACCCC
TTAACCTC	TTAACCCC
TTAACCNC	TTAACCCC
TTTGCACG	TTGCACGA
TTGNAAGC	TTGTAAGC
TTGAAAGC	TTGTAAGC
TTTGCATA	GTTTGCAT
TTTGCATC	GTTTGCAT
TTTGCATG	GTTTGCAT
TTTGCATT	GTTTGCAT
TTTGCATN	GTTTGCAT
TTCGCACG	TTGCACGA
TTAACGCC	TTAACCCC
TTCGCAGA	TTCGGCAG
TTCGCAGC	TTCGGCAG
TTCGCAGG	TTCGGCAG
TTCGCAGT	TTCGGCAG
TTCGCAGN	TTCGGCAG
TTGNACGA	TTGCACGA
TTCGCCAG	TTCGGCAG
TTGAACCC	TTAACCCC
TTGAACGA	TTGCACGA
TTGAACTG	TGAACTGT
TTGNAGTT	TTGAGTTA
TTCGCGCA	TTCGGCAG
TTAACTCC	TTAACCCC
TTAACTGT	TGAACTGT
TTGAAGCA	TTGTAAGC
TTGAAGCC	TTGTAAGC
TTGAAGCG	TTGTAAGC
TTGAAGCT	TTGTAAGC
TTCGCTAG	TCCGCTAG
TTGAAGCN	TTGTAAGC
TTTGCGGC	TTTGTGGC
TTGAAGTT	TTGAGTTA
TTGNCACG	TTGCACGA
TTTGCTGG	TTTGTGGC
TTAACNCC	TTAACCCC
TTGAATTA	TTGAGTTA
TTTCAAGG	ATTCAAGG
TTAAGAAC	CTAAGAAC
TTCGGAAG	TTCGGCAG
TTCGGACA	TTCGGCAG
TTTGGAGA	TCTTGGAG
TTCGGACT	TGCGGACT
TTTGGAGC	TCTTGGAG
TTTGGAGG	TCTTGGAG
TTCGGAGA	TTCGGCAG
TTTGGAGT	TCTTGGAG
TTCGGAGC	TTCGGCAG
TTTGGAGN	TCTTGGAG
TTCGGAGG	TTCGGCAG
TTCGGAGT	TTCGGCAG
TTCGGAGN	TTCGGCAG
TTGACACG	TTGCACGA
TTTGGCAG	TTCGGCAG
TTAAGCCC	TTAACCCC
TTCGGCAA	TTCGGCAG
TTCGGCAC	TTCGGCAG
TTCGGCAG	TTCGGCAG
TTCGGCAT	TTCGGCAG
TTCGGCAN	TTCGGCAG
TTTCACGA	TTGCACGA
TTGACCCC	TTAACCCC
TTTGGGCA	TTTGTGGC
TTTGGGCC	TTTGTGGC
TTCGGCCA	TTCGGCAG
TTTGGGCG	TTTGTGGC
TTTGGGCT	TTTGTGGC
TTCGGCCG	TTCGGCAG
TTTGGGCN	TTTGTGGC
TTTGGGGC	TTTGTGGC
TTCGGCGA	TTCGGCAG
TTCGGCGC	TTCGGCAG
TTTGGGGT	TGTGGGGT
TTCGGCGG	TTCGGCAG
TTCGGCGT	TTCGGCAG
TTCGGCGN	TTCGGCAG
TTCGGCTA	TTCGGCAG
TTNCACGA	TTGCACGA
TTAAGGAT	TAAAGGAT
TTCGGCTG	TTCGGCAG
TTCGGCNA	TTCGGCAG
TTCGGCNG	TTCGGCAG
TTCGGGAG	TTCGGCAG
TTCGGGCA	TTCGGCAG
TTTGGTGG	TTTGTGGC
TTCGGTAG	TTCGGCAG
TTCGGTCA	TTCGGCAG
TTCGGNAG	TTCGGCAG
TTGACGAA	TTGCACGA
TTGACGAC	TTGCACGA
TTCGGNCA	TTCGGCAG
TTGACGAG	TTGCACGA
TTGACGAT	TTGCACGA
TTGACGAN	TTGCACGA
TTTGTAAG	TTGTAAGC
TTGNGTTA	TTGAGTTA
TTTGTAGC	TTTGTGGC
TTTGTAGG	TTTGTGGC
TTGACGTT	TTGAGTTA
TTTCCCGA	GTTTCCCG
TTTCCCGC	GTTTCCCG
TTTCCCGG	GTTTCCCG
TTTCCCGT	GTTTCCCG
TTTCCCGN	GTTTCCCG
TTGACTTA	TTGAGTTA
TTAAGTTA	TTGAGTTA
TTGNTAAG	TTGTAAGC
TTTCCGGG	TCTCCGGG
TTTGTCGC	TTTGTGGC
TTGAGATA	TTGAGTTA
TTTCCTGC	ATTCCTGC
TTGAGATT	TTGAGTTA
TTTGTCGG	TTTGTGGC
TTTGTGAC	TTTGTGGC
TTTGTGAG	TTTGTGGC
TTTGTGCA	TTTGTGGC
TTTGTGCC	TTTGTGGC
TTTGTGCG	TTTGTGGC
TTTGTGCT	TTTGTGGC
TTTGTGCN	TTTGTGGC
TTTGTGGA	TTTGTGGC
TTTGTGGC	TTTGTGGC
TTAATATA	TAATATAT
TTGAGCTA	TTGAGTTA
TTGAGCTT	TTGAGTTA
TTTGTGGG	TTTGTGGC
TTTGTGGT	TTTGTGGC
TTTGTGGN	TTTGTGGC
TTTGTGTC	TTTGTGGC
TTTGTGTG	TTTGTGGC
TTTGTGNC	TTTGTGGC
TTTGTGNG	TTTGTGGC
TTAATCCC	TTAACCCC
TTAATCGA	TAATCGAG
TTTGTTGC	TTTGTGGC
TTTGTTGG	TTTGTGGC
TTTCGGCA	TTCGGCAG
TTGAGGTA	TTGAGTTA
TTGAGGTT	TTGAGTTA
TTGAGTAA	TTGAGTTA
TTTGTNGC	TTTGTGGC
TTTGTNGG	TTTGTGGC
TTGANGTT	TTGAGTTA
TTAATGCA	CTTAATGC
TTGAGTAC	TTGAGTTA
TTAATGCC	CTTAATGC
TTGAGTAG	TTGAGTTA
TTAATGCG	CTTAATGC
TTGAGTAT	TTGAGTTA
TTAATGCT	CTTAATGC
TTGAGTAN	TTGAGTTA
TTAATGCN	CTTAATGC
TTGAGTCA	TTGAGTTA
TTGAGTCT	TTGAGTTA
TTGAGTGA	TTGAGTTA
TTGANTTA	TTGAGTTA
TTGAGTGT	TTGAGTTA
TTGAGTTA	TTGAGTTA
TTGAGTTC	TTGAGTTA
TTGAGTTG	TTGAGTTA
TTGAGTTT	TTGAGTTA
TTGAGTTN	TTGAGTTA
TTGAGTNA	TTGAGTTA
TTGAGTNT	TTGAGTTA
TTTCGTGG	TTTGTGGC
TTGAGNTA	TTGAGTTA
TTTCTACA	TTCTACAT
TTGAGNTT	TTGAGTTA
TTGCAACG	TTGCACGA
TTGCAAGA	TTGCACGA
TTGCAAGC	TTGTAAGC
TTGATAAG	TTGTAAGC
TTTGNGGC	TTTGTGGC
TTTCTCTA	CTTCTCTA
TTGCACAA	TTGCACGA
TTGCACAC	TTGCACGA
TTGCACAG	TTGCACGA
TTGCACAT	TTGCACGA
TTGCACAN	TTGCACGA
TTGCACCA	TTGCACGA
TTGCACCG	TTGCACGA
TTTCTGAC	TGTCTGAC
TTGCACGA	TTGCACGA
TTGCACGC	TTGCACGA
TTGCACGG	TTGCACGA
TTGCACGT	TTGCACGA
TTGCACGN	TTGCACGA
TTGCACTA	TTGCACGA
TTGCACTG	TTGCACGA
TTNCGGCA	TTCGGCAG
TTGCACNA	TTGCACGA
TTGATCCC	TGATCCCT
TTGCACNG	TTGCACGA
TTGCAGAA	TTGCACGA
TTGCAGAC	TTGCACGA
TTGCAGAG	TTGCACGA
TTGCAGAT	TTGCACGA
TTGCAGAN	TTGCACGA
TTGCAGCG	TTGCACGA
TTGCAGGA	TTGCACGA
TTTGNTGG	TTTGTGGC
TTTCTGGC	TTTGTGGC
TTGCAGTT	TTGAGTTA
TTGATGTT	TTGAGTTA
TTAANCCC	TTAACCCC
TTGATTAA	TTGAGTTA
TTGCATCG	TTGCACGA
TTGATTAC	TTGAGTTA
TTGATTAG	TTGAGTTA
TTGCATGA	TTGCACGA
TTGATTAT	TTGAGTTA
TTGATTAN	TTGAGTTA
TTGCANCG	TTGCACGA
TTNCTACA	TTCTACAT
TTGCANGA	TTGCACGA
TTGATTTA	TTGAGTTA
TTTTAAGC	TTGTAAGC
TTTAACCC	TTAACCCC
TTGCCACG	TTGCACGA
TTTTACAT	TTCTACAT
TTGCCCGA	TTGCACGA
TTTAAGCA	TTGTAAGC
TTTAAGCC	TTGTAAGC
TTTAAGCG	TTGTAAGC
TTTNGTGG	TTTGTGGC
TTTAAGCT	TTGTAAGC
TTTAAGCN	TTGTAAGC
TTGCCGAA	TTGCACGA
TTGCCGAC	TTGCACGA
TTGCCGAG	TTGCACGA
TTGCCGAT	TTGCACGA
TTGCCGAN	TTGCACGA
TTNGAGTT	TTGAGTTA
TTACACCC	TTAACCCC
TTACACGA	TTGCACGA
TTTAATGC	CTTAATGC
TTTNTGGC	TTTGTGGC
TTNGCACG	TTGCACGA
TTGCGACG	TTGCACGA
TTTTCCCG	GTTTCCCG
TTTACATA	TTCTACAT
TTTACATC	TTCTACAT
TTTACATG	TTCTACAT
TTTACATT	TTCTACAT
TTTACATN	TTCTACAT
TTGCGCAT	TGGCGCAT
TTTACCAA	CTTACCAA
TTTACCCC	TTAACCCC
TTGCGCGA	TTGCACGA
TTTGAGGC	TTTGTGGC
TTTGAGTT	TTGAGTTA
TTGGGATC	CTGGGATC
TTGCGGAC	TGCGGACT
TTGCGGCA	TTCGGCAG
TTGGGCAG	TTCGGCAG
TTTGATGG	TTTGTGGC
TTGCGTAA	TAGCGTAA
TTGCGTTA	TTGAGTTA
TTGGGGTA	TGTGGGGT
TTGGGGTC	TGTGGGGT
TTNGGCAG	TTCGGCAG
TTGGGGTG	TGTGGGGT
TTGGGGTT	TGTGGGGT
TTGGGGTN	TGTGGGGT
TTGCTAAG	TTGTAAGC
TTGCTACA	TTCTACAT
TTGCTACG	TTGCACGA
TTGGGTTA	TTGAGTTA
TTTTGCAT	GTTTGCAT
TTGCTCGA	TTGCACGA
TTTTGGAG	TCTTGGAG
TNCTCCGG	TCTCCGGG
TTTTGGCA	TTTGTGGC
TTTTGGCC	TTTGTGGC
TTTTGGCG	TTTGTGGC
TTTTGGCT	TTTGTGGC
TTTTGGCN	TTTGTGGC
TTTTGTGG	TTTGTGGC
TTTAGTGG	TTTGTGGC
TTGGTAAG	TTGTAAGC
TTTAGTTA	TTGAGTTA
TTNAACCC	TTAACCCC
TTNGTAAG	TTGTAAGC
TTGGTGGC	TTTGTGGC
TTTTTGAA	TGTTTTGA
TTTTTGAC	TGTTTTGA
TTTTTGAG	TGTTTTGA
TTTTTGAT	TGTTTTGA
TTTTTGAN	TGTTTTGA
TTGGTTAA	TTGAGTTA
TTGGTTAC	TTGAGTTA
TTGGTTAG	TTGAGTTA
TTGGTTAT	TTGAGTTA
TTTTTGGC	TTTGTGGC
TTGGTTAN	TTGAGTTA
TTTTTTGA	TGTTTTGA
TTNGTGGC	TTTGTGGC
TNAGAAAC	TCAGAAAC
TNCAACGA	TCCAACGA
TTGCNACG	TTGCACGA
TTNACCCC	TTAACCCC
TTGTAAAC	TTGTAAGC
TTGTAAAG	TTGTAAGC
TTGTAACA	TTGTAAGC
TTGTAACC	TTGTAAGC
TTGTAACG	TTGTAAGC
TTGTAACT	TTGTAAGC
TTGCNCGA	TTGCACGA
TTGTAACN	TTGTAAGC
TTGTAAGA	TTGTAAGC
TTGTAAGC	TTGTAAGC
TTGTAAGG	TTGTAAGC
TTGTAAGT	TTGTAAGC
TTGTAAGN	TTGTAAGC
TTGTAATC	TTGTAAGC
TTGTAATG	TTGTAAGC
TTGTAANC	TTGTAAGC
TTGTAANG	TTGTAAGC
TTGTACAG	TTGTAAGC
TTGTACAT	TTCTACAT
TTGTACGA	TTGCACGA
TTGTACGC	TTGTAAGC
TTGTAGAG	TTGTAAGC
TTGTAGCA	TTGTAAGC
TTGTAGCC	TTGTAAGC
TTGTAGCG	TTGTAAGC
TTGTAGCT	TTGTAAGC
TTGTAGCN	TTGTAAGC
TTGTAGGC	TTGTAAGC
TNAGCGTA	TAGCGTAA
TTGTAGTT	TTGAGTTA
TTGTATAG	TTGTAAGC
TTGTATGC	TTGTAAGC
TTGTATGG	TAGTATGG
TTNTAAGC	TTGTAAGC
TNCAGAAA	TCAGAAAC
TTGTANAG	TTGTAAGC
TTGTANGC	TTGTAAGC
TTNTACAT	TTCTACAT
TTGGAAGC	TTGTAAGC
TTGTCAAG	TTGTAAGC
TTGTCACG	TTGCACGA
TTGTCAGC	TTGTAAGC
TNCTTCAC	TCCTTCAC
TTGGACAA	GTGGACAA
TTGGACGA	TTGCACGA
TNCTTGGA	TCTTGGAG
TNCAGGTC	TCAGGTCT
TTGGAGTT	TTGAGTTA
TNAGGTCT	TCAGGTCT
TTGTCGTA	ATGTCGTA
TNCCTTCA	TCCTTCAC
TTGTCTGA	TGTCTGAC
TNAGTATG	TAGTATGG
TTGTGAAG	TTGTAAGC
TTGTGAGC	TTGTAAGC
TTGGCACG	TTGCACGA
TTGGCAGA	TTCGGCAG
TTGGCAGC	TTCGGCAG
TTGGCAGG	TTCGGCAG
TTGGCAGT	TTCGGCAG
TTGGCAGN	TTCGGCAG
TTGTGGCA	TTTGTGGC
TTGTGGCC	TTTGTGGC
TTGTGGCG	TTTGTGGC
TTGTGGCT	TTTGTGGC
TTGTGGCN	TTTGTGGC
TTGTGGGG	TGTGGGGT
TTGGCGCA	TGGCGCAT
TTGTGTGG	TTTGTGGC
TTGTGTTA	TTGAGTTA
TTGTTAAG	TTGTAAGC
TTGTTAGC	TTGTAAGC
TTGTTTTG	TGTTTTGA
TTGTNAAG	TTGTAAGC
TTGTNAGC	TTGTAAGC
TTNTGTGG	TTTGTGGC
TNATATAT	TAATATAT
TNATCCCT	TGATCCCT
TNAACCCC	TTAACCCC
TNATCGAG	TAATCGAG
TNCCAACG	TCCAACGA
TNAACTGT	TGAACTGT
TNCCACCA	TACCACCA
TNCGCTAG	TCCGCTAG
TNAAGGAT	TAAAGGAT
TNCGGACT	TGCGGACT
TNAATATA	TAATATAT
TNGAACTG	TGAACTGT
TNCGGCAG	TTCGGCAG
TNAATCGA	TAATCGAG
TNTCCGGG	TCTCCGGG
TNCCGCTA	TCCGCTAG
TNTAACCC	TTAACCCC
TNTCGGCA	TTCGGCAG
TNCTACAT	TTCTACAT
TNGAGTTA	TTGAGTTA
TNAAAGGA	TAAAGGAT
TNACCACC	TACCACCA
TNTCTACA	TTCTACAT
TNGCGCAT	TGGCGCAT
TNTCTGAC	TGTCTGAC
TNGCGGAC	TGCGGACT
TNGATCCC	TGATCCCT
TNGCGTAA	TAGCGTAA
TNTGAGTT	TTGAGTTA
TNTGCACG	TTGCACGA
TNGCACGA	TTGCACGA
TNTGGGGT	TGTGGGGT
TNTTGGAG	TCTTGGAG
TNGGCGCA	TGGCGCAT
TNTGTAAG	TTGTAAGC
TNTTGTGG	TTTGTGGC
TNGTAAGC	TTGTAAGC
TNTGTGGC	TTTGTGGC
TNGTATGG	TAGTATGG
TNTTTTGA	TGTTTTGA
NAAGGGAG	AAGGGAGT
TNGTCTGA	TGTCTGAC
TNGTGGGG	TGTGGGGT
NAAGTTGC	AAGTTGCC
TNGTTTTG	TGTTTTGA
NACGCTCC	ACGCTCCT
NACAACGC	ACAACGCG
NACAATTA	ACAATTAG
NACATCGT	ACATCGTT
NACGGCAT	CACGGCAT
NAATATAT	TAATATAT
NAATCCTC	GAATCCTC
NAATCGAG	TAATCGAG
NACCACCA	TACCACCA
NAGAAATC	AAGAAATC
NAATGGTC	AATGGTCA
NACTAACT	GACTAACT
NAGAAGGG	GAGAAGGG
NACTACTA	GACTACTA
NAAACAAG	AAACAAGT
NACCCGCG	AACCCGCG
NAAACCTT	AAACCTTT
NACCCTTG	ACCCTTGG
NAGAGCCG	GAGAGCCG
NAAAGCCA	CAAAGCCA
NAAAGGAT	TAAAGGAT
NACCGGTA	ACCGGTAA
NAACAAGT	AAACAAGT
NATGGTCA	AATGGTCA
NATGTCGT	ATGTCGTA
NAACCCGC	AACCCGCG
NAACCTTT	AAACCTTT
NATATAAC	ATATAACT
NACTTGTA	AACTTGTA
NACGAGAG	ACGAGAGT
NATATTTC	ATATTTCC
NAGCAGGC	AAGCAGGC
NAGGGAGT	AAGGGAGT
NATTCAAG	ATTCAAGG
NAGGGCCA	AGGGCCAA
NATTCCTG	ATTCCTGC
NAACTTGT	AACTTGTA
NAGGGTCG	AGGGTCGG
NAGCGTAA	TAGCGTAA
NAGCGTTT	AGCGTTTC
NAGCTCAG	CAGCTCAG
NAAGAAAT	AAGAAATC
NATCCGAG	CATCCGAG
NCCAAATG	CCAAATGG
NCCAACGA	TCCAACGA
NAAGCAGG	AAGCAGGC
NATCGATA	GATCGATA
NAGTTGCC	AAGTTGCC
NAGTATGG	TAGTATGG
NCCAGTTA	CCCAGTTA
NCCATCCA	CCCATCCA
NATCTGAC	ATCTGACC
NAGTGTTC	GAGTGTTC
NCCCACTG	CCCCACTG
NCCCAGTT	CCCAGTTA
NCCCATCC	CCCATCCA
NCTGGGAT	CTGGGATC
NCATCCGA	CATCCGAG
NCATCGTT	ACATCGTT
NCCCCACT	CCCCACTG
NCAAAGCC	CAAAGCCA
NCAAAGTA	GCAAAGTA
NCAAATGG	CCAAATGG
NCCCCTAA	CCCCTAAA
NCCCCTTT	GCCCCTTT
NCAACGCG	ACAACGCG
NCTTAATG	CTTAATGC
NCTTACCA	CTTACCAA
NCCTCGAT	CCTCGATT
NCCCTAAA	CCCCTAAA
NCCCTGTC	CCCTGTCG
NCCCTTGG	ACCCTTGG
NCCTGCAA	CCTGCAAG
NCTTCTCT	CTTCTCTA
NCGACCCG	CGACCCGG
NCAATTAG	ACAATTAG
NCCTGTCG	CCCTGTCG
NCACGGCA	CACGGCAT
NCTTGGAG	TCTTGGAG
NCGAGAGT	ACGAGAGT
NCCTTAGT	GCCTTAGT
NCCTTCAC	TCCTTCAC
NCTTTAAA	GCTTTAAA
NCACTTCT	GCACTTCT
NCGATTAT	CGATTATT
NCGCGGAA	CGCGGAAG
NCCGCTAG	TCCGCTAG
NCGCTCCT	ACGCTCCT
NCAGAAAC	TCAGAAAC
NCGGTGGT	CGGTGGTT
NGCACTTC	GCACTTCT
NCCGGGTC	GCCGGGTC
NCCGGTAA	ACCGGTAA
NCAGCTCA	CAGCTCAG
NCGGATTC	CGGATTCC
NCCGTTGA	CCGTTGAG
NCAGGTCT	TCAGGTCT
NCGTAGGT	GCGTAGGT
NCGTATAC	CGTATACG
NCTCCGGG	TCTCCGGG
NCTCGATT	CCTCGATT
NCTCGCCC	GCTCGCCC
NGCCCCTT	GCCCCTTT
NCGTTGAG	CCGTTGAG
NGCCGGGT	GCCGGGTC
NGCCTTAG	GCCTTAGT
NCTGCAAG	CCTGCAAG
NGATTATT	CGATTATT
NGAATCCT	GAATCCTC
NCTAAGAA	CTAAGAAC
NGCTTTAA	GCTTTAAA
NGGATTCC	CGGATTCC
NGTTTCCC	GTTTCCCG
NGAACTGT	TGAACTGT
NGTTTGCA	GTTTGCAT
NGTTTTGA	TGTTTTGA
NCTAGCAT	CTAGCATT
NGACCCGG	CGACCCGG
NCTAGCTC	CTAGCTCG
NCTAGGCC	CTAGGCCC
NGCGGAAG	CGCGGAAG
NGCGGACT	TGCGGACT
NGGCGCAT	TGGCGCAT
NGCGTAGG	GCGTAGGT
NGGGCCAA	AGGGCCAA
NGAGAAGG	GAGAAGGG
NGACTAAC	GACTAACT
NGACTACT	GACTACTA
NGCGTTTC	AGCGTTTC
NGCAAAGT	GCAAAGTA
NGAGAGCC	GAGAGCCG
NGGGTCGG	AGGGTCGG
NGCTCGCC	GCTCGCCC
NGTCTGAC	TGTCTGAC
NTCCAACG	TCCAACGA
NGAGTGTT	GAGTGTTC
NGGTGGTT	CGGTGGTT
NTCCGCTA	TCCGCTAG
NGTGGACA	GTGGACAA
NGATCCCT	TGATCCCT
NGATCGAT	GATCGATA
NTCCTTCA	TCCTTCAC
NGTGGGGT	TGTGGGGT
NTAAAGGA	TAAAGGAT
NTGATCCC	TGATCCCT
NGTACCCT	GTACCCTG
NGTACGGA	GTACGGAT
NTAACCCC	TTAACCCC
NTAAGAAC	CTAAGAAC
NTCGGCAG	TTCGGCAG
NGTATACG	CGTATACG
NTACCACC	TACCACCA
NTGCACGA	TTGCACGA
NTACCCTG	GTACCCTG
NTAATATA	TAATATAT
NTAATCGA	TAATCGAG
NTACGGAT	GTACGGAT
NTCAAGCC	GTCAAGCC
NGTCAAGC	GTCAAGCC
NTCTACAT	TTCTACAT
NTGCGGAC	TGCGGACT
NTCAGAAA	TCAGAAAC
NTCAGGTC	TCAGGTCT
NTCTCCGG	TCTCCGGG
NTGGCGCA	TGGCGCAT
NTGGGATC	CTGGGATC
NTCTGACC	ATCTGACC
NTGAACTG	TGAACTGT
NTGGACAA	GTGGACAA
NTCTTGGA	TCTTGGAG
NTAGCATT	CTAGCATT
NTAGTATG	TAGTATGG
NTAGCGTA	TAGCGTAA
NTAGCTCG	CTAGCTCG
NTAGGCCC	CTAGGCCC
NTTGAGTT	TTGAGTTA
NTGAGTTA	TTGAGTTA
NTGTAAGC	TTGTAAGC
NTTGCACG	TTGCACGA
NTATAACT	ATATAACT
NTGTCGTA	ATGTCGTA
NTGTCTGA	TGTCTGAC
NTGTGGGG	TGTGGGGT
NTTGTAAG	TTGTAAGC
NTATTTCC	ATATTTCC
NTTGTGGC	TTTGTGGC
NTGTTTTG	TGTTTTGA
NTTTCCCG	GTTTCCCG
NTTAACCC	TTAACCCC
NTTAATGC	CTTAATGC
NTTTGCAT	GTTTGCAT
NTTACCAA	CTTACCAA
NTTTGTGG	TTTGTGGC
NTTCAAGG	ATTCAAGG
NTTCCTGC	ATTCCTGC
NTTCGGCA	TTCGGCAG
NTTCTACA	TTCTACAT
NTTCTCTA	CTTCTCTA
